#HEADER:ProvinceCode,ProvinceName,KabupatenCode,KabupatenName,KecamatanCode,KecamatanName,PrabowoHattaVotes,JokowiKallaVotes,TotalVotes
1,ACEH,2,ACEH SELATAN,236,LABUHAN HAJI TIMUR,0,0,0
1,ACEH,2,ACEH SELATAN,248,KOTA BAHAGIA,1172,1389,2561
1,ACEH,2,ACEH SELATAN,222,LABUHAN HAJI BARAT,3584,3200,6784
1,ACEH,2,ACEH SELATAN,3,BAKONGAN,0,0,0
1,ACEH,2,ACEH SELATAN,204,KLUET TIMUR,2552,1689,4241
1,ACEH,2,ACEH SELATAN,132,TAPAKTUAN,7752,3401,11153
1,ACEH,2,ACEH SELATAN,148,TRUMON,950,1174,2124
1,ACEH,2,ACEH SELATAN,212,TRUMON TIMUR,0,0,0
1,ACEH,2,ACEH SELATAN,182,BAKONGAN TIMUR,1027,1230,2257
1,ACEH,2,ACEH SELATAN,161,PASIE RAJA,3470,2925,6395
1,ACEH,2,ACEH SELATAN,116,SAWANG,4676,2743,7419
1,ACEH,2,ACEH SELATAN,87,SAMADUA,6333,2476,8809
1,ACEH,269,ACEH TENGGARA,632,TANOH ALAS,1398,881,2279
1,ACEH,2,ACEH SELATAN,190,KLUET TENGAH,0,0,0
1,ACEH,2,ACEH SELATAN,29,KLUET SELATAN,2779,3259,6038
1,ACEH,269,ACEH TENGGARA,613,LAWE SUMUR,0,0,0
1,ACEH,269,ACEH TENGGARA,590,DELENG POKHKISEN,0,0,0
1,ACEH,2,ACEH SELATAN,47,LABUHAN HAJI,0,0,0
1,ACEH,269,ACEH TENGGARA,270,LAWE ALAS,7473,2030,9503
1,ACEH,2,ACEH SELATAN,64,MEUKEK,5016,3676,8692
1,ACEH,2,ACEH SELATAN,259,TRUMON TENGAH,0,0,0
1,ACEH,2,ACEH SELATAN,9,KLUET UTARA,5194,5108,10302
1,ACEH,269,ACEH TENGGARA,492,BUKIT TUSAM,0,0,0
1,ACEH,269,ACEH TENGGARA,564,KETAMBE,3705,2347,6052
1,ACEH,269,ACEH TENGGARA,416,BABUL MAKMUR,0,0,0
1,ACEH,269,ACEH TENGGARA,467,LAWE BULAN,6165,2590,8755
1,ACEH,269,ACEH TENGGARA,536,BABUL RAHMAH,0,0,0
1,ACEH,269,ACEH TENGGARA,647,LEUSER,0,0,0
1,ACEH,269,ACEH TENGGARA,335,BAMBEL,7774,2528,10302
1,ACEH,269,ACEH TENGGARA,516,SEMADAM,0,0,0
1,ACEH,269,ACEH TENGGARA,369,BABUSSALAM,0,0,0
1,ACEH,269,ACEH TENGGARA,438,DARUL HASANAH,0,0,0
1,ACEH,671,ACEH TIMUR,1119,PEUREULAK BARAT,2282,2048,4330
1,ACEH,269,ACEH TENGGARA,397,BADAR,0,0,0
1,ACEH,671,ACEH TIMUR,1158,DARUL IHSAN,1155,1195,2350
1,ACEH,671,ACEH TIMUR,672,DARUL AMAN,2354,3297,5651
1,ACEH,671,ACEH TIMUR,1098,PEUREULAK TIMUR,1391,2678,4069
1,ACEH,671,ACEH TIMUR,1080,PEUDAWA,1637,1673,3310
1,ACEH,671,ACEH TIMUR,718,JULOK,3589,4736,8325
1,ACEH,671,ACEH TIMUR,996,MADAT,3393,3941,7334
1,ACEH,671,ACEH TIMUR,1063,BANDA ALAM,960,1731,2691
1,ACEH,671,ACEH TIMUR,1037,IDI TUNONG,1746,1748,3494
1,ACEH,671,ACEH TIMUR,1149,SIMPANG JERNIH,1300,544,1844
1,ACEH,671,ACEH TIMUR,1135,SUNGAI RAYA,1477,1872,3349
1,ACEH,671,ACEH TIMUR,1175,DARUL FALAH,442,1084,1526
1,ACEH,671,ACEH TIMUR,948,RANTAU PEUREULAK,5339,3238,8577
1,ACEH,671,ACEH TIMUR,838,NURUSSALAM,2570,3702,6272
1,ACEH,671,ACEH TIMUR,870,PEUREULAK,4870,6850,11720
1,ACEH,671,ACEH TIMUR,820,SERBAJADI,1893,1267,3160
1,ACEH,671,ACEH TIMUR,1187,IDI TIMUR,824,1153,1977
1,ACEH,671,ACEH TIMUR,756,IDI RAYEUK,5577,5106,10683
1,ACEH,1207,ACEH TENGAH,1362,BINTANG,1225,4038,5263
1,ACEH,671,ACEH TIMUR,792,BIREM BAYEUN,8471,3382,11853
1,ACEH,671,ACEH TIMUR,1023,INDRA MAKMU,4063,1733,5796
1,ACEH,1207,ACEH TENGAH,1459,CELALA,1747,3106,4853
1,ACEH,1207,ACEH TENGAH,1440,KUTE PANANG,1463,2745,4208
1,ACEH,671,ACEH TIMUR,909,RANTAU SELAMAT,1835,1942,3777
1,ACEH,671,ACEH TIMUR,924,SIMPANG ULIM,2492,2775,5267
1,ACEH,1207,ACEH TENGAH,1322,ATU LINTANG,1972,1413,3385
1,ACEH,1207,ACEH TENGAH,1208,LINGE,2239,3127,5366
1,ACEH,1207,ACEH TENGAH,1420,KEBAYAKAN,3047,4750,7797
1,ACEH,1207,ACEH TENGAH,1394,KETOL,3311,3819,7130
1,ACEH,1207,ACEH TENGAH,1332,PEGASING,3528,6690,10218
1,ACEH,1492,ACEH BARAT,1726,MEUREUBO,5705,5686,11391
1,ACEH,1207,ACEH TENGAH,1295,BIES,1865,2243,4108
1,ACEH,1207,ACEH TENGAH,1307,RUSIP ANTARA,1525,2194,3719
1,ACEH,1207,ACEH TENGAH,1233,SILIH NARA,4403,7420,11823
1,ACEH,671,ACEH TIMUR,1201,PEUNARON,2315,1801,4116
1,ACEH,671,ACEH TIMUR,972,PANTE BIDARI,2626,4052,6678
1,ACEH,1207,ACEH TENGAH,1386,JAGONG JEGET,3274,1968,5242
1,ACEH,1492,ACEH BARAT,1672,ARONGAN LAMBALEK,2261,3316,5577
1,ACEH,1492,ACEH BARAT,1559,SUNGAI MAS,1218,845,2063
1,ACEH,1207,ACEH TENGAH,1267,BEBESEN,6936,9334,16270
1,ACEH,1492,ACEH BARAT,1515,KAWAY XVI,5921,4506,10427
1,ACEH,1824,ACEH BESAR,1825,LHOONG,2779,2419,5198
1,ACEH,1207,ACEH TENGAH,1476,LAUT TAWAR,3987,5035,9022
1,ACEH,1492,ACEH BARAT,1621,SAMATIGA,3904,4284,8188
1,ACEH,1492,ACEH BARAT,1804,PANTON REU,1930,1100,3030
1,ACEH,1492,ACEH BARAT,1493,JOHAN PAHWALAN,13649,10052,23701
1,ACEH,1492,ACEH BARAT,1700,PANTE CEUREUMEN,3245,2270,5515
1,ACEH,1824,ACEH BESAR,2294,KOTA JANTHO,1967,2018,3985
1,ACEH,1492,ACEH BARAT,1778,WOYLA TIMUR,1345,1281,2626
1,ACEH,1824,ACEH BESAR,2341,KUTA MALAKA,2158,1042,3200
1,ACEH,1492,ACEH BARAT,1753,WOYLA BARAT,2425,1714,4139
1,ACEH,1492,ACEH BARAT,1577,WOYLA,4000,3208,7208
1,ACEH,1824,ACEH BESAR,2185,KUTA BARO,6132,5241,11373
1,ACEH,1824,ACEH BESAR,1854,LHOKNGA,4580,3111,7691
1,ACEH,1824,ACEH BESAR,2024,SUKAMAKMUR,4189,3170,7359
1,ACEH,1824,ACEH BESAR,2308,KOTA COT GLIE,3272,3379,6651
1,ACEH,1824,ACEH BESAR,2418,LEUPUNG,631,763,1394
1,ACEH,1824,ACEH BESAR,2376,DARUL KAMAL,1819,1599,3418
1,ACEH,1492,ACEH BARAT,1654,BUBON,1732,1800,3532
1,ACEH,1824,ACEH BESAR,2391,BAITUSSALAM,3779,3160,6939
1,ACEH,1824,ACEH BESAR,2060,DARUL IMARAH,11484,7981,19465
1,ACEH,1824,ACEH BESAR,2233,DARUSSALAM,5537,3722,9259
1,ACEH,1824,ACEH BESAR,2357,SIMPANG TIGA,1857,1176,3033
1,ACEH,1824,ACEH BESAR,2093,PEUKAN BADA,3778,3662,7440
1,ACEH,2452,PIDIE,3099,MUTIARA TIMUR,4938,8418,13356
1,ACEH,1824,ACEH BESAR,1883,INDRAPURI,6377,3906,10283
1,ACEH,2452,PIDIE,2929,SAKTI,0,0,0
1,ACEH,2452,PIDIE,2453,BATEE,0,0,0
1,ACEH,1824,ACEH BESAR,2263,PULO ACEH,1127,1301,2428
1,ACEH,2452,PIDIE,2527,GEUMPANG,785,1158,1943
1,ACEH,1824,ACEH BESAR,1936,SEULIMEUM,4693,5158,9851
1,ACEH,2452,PIDIE,2864,PIDIE,0,0,0
1,ACEH,2452,PIDIE,3164,MANE,976,1397,2373
1,ACEH,1824,ACEH BESAR,1984,MONTASIK,6373,3074,9447
1,ACEH,2452,PIDIE,2815,PEUKAN BARO,0,0,0
1,ACEH,2452,PIDIE,2568,INDRA JAYA,3618,5734,9352
1,ACEH,2452,PIDIE,2533,GEULUMPANG TIGA,0,0,0
1,ACEH,2452,PIDIE,2979,SIMPANG TIGA,4660,5611,10271
1,ACEH,2452,PIDIE,2720,MUTIARA,3270,4973,8243
1,ACEH,2452,PIDIE,3081,KEUMALA,1032,2969,4001
1,ACEH,1824,ACEH BESAR,2425,BLANG BINTANG,3053,2148,5201
1,ACEH,1824,ACEH BESAR,2120,MESJID RAYA,3001,3257,6258
1,ACEH,2452,PIDIE,3032,TANGSE,5198,6186,11384
1,ACEH,1824,ACEH BESAR,2134,INGIN JAYA,8026,6351,14377
1,ACEH,2452,PIDIE,3191,TITEUE,1110,1353,2463
1,ACEH,2452,PIDIE,3169,GLUMPANG BARO,1565,2941,4506
1,ACEH,2452,PIDIE,2750,PADANG TIJI,4002,5167,9169
1,ACEH,3205,ACEH UTARA,3916,BAKTIYA BARAT,2948,3224,6172
1,ACEH,3205,ACEH UTARA,4033,PIRAK TIMUR,1775,1507,3282
1,ACEH,3205,ACEH UTARA,3943,PAYA BAKONG,2984,2449,5433
1,ACEH,2452,PIDIE,2482,DELIMA,0,0,0
1,ACEH,3205,ACEH UTARA,3867,COT GIREK,6352,2450,8802
1,ACEH,3205,ACEH UTARA,3797,SAWANG,7866,3931,11797
1,ACEH,2452,PIDIE,2618,KEMBANG TANJONG,3411,5241,8652
1,ACEH,3205,ACEH UTARA,4021,LAPANG,1181,1280,2461
1,ACEH,3205,ACEH UTARA,3837,NISAM,4535,1928,6463
1,ACEH,3205,ACEH UTARA,3730,TANAH PASIR,1867,1427,3294
1,ACEH,2452,PIDIE,2664,KOTA SIGLI,3518,3742,7260
1,ACEH,3205,ACEH UTARA,4069,BANDA BARO,1705,695,2400
1,ACEH,2452,PIDIE,2701,MUARA TIGA,4865,1867,6732
1,ACEH,3205,ACEH UTARA,3983,NIBONG,2514,1675,4189
1,ACEH,2452,PIDIE,2680,MILA,1760,1958,3718
1,ACEH,3205,ACEH UTARA,3397,MATANGKULI,3872,3445,7317
1,ACEH,3205,ACEH UTARA,3598,SYAMTALIRA ARON,4374,3121,7495
1,ACEH,3205,ACEH UTARA,3264,DEWANTARA,8254,4449,12703
1,ACEH,3205,ACEH UTARA,4079,NISAM ANTARA,1611,937,2548
1,ACEH,3205,ACEH UTARA,3633,SYAMTALIRA BAYU,4800,2801,7601
1,ACEH,4086,SIMEULUE,4087,SIMEULUE TENGAH,0,0,0
1,ACEH,3205,ACEH UTARA,4004,SIMPANG KRAMAT,2801,1284,4085
1,ACEH,3205,ACEH UTARA,3892,LANGKAHAN,4194,3819,8013
1,ACEH,4086,SIMEULUE,4224,ALAPAN,0,0,0
1,ACEH,3205,ACEH UTARA,3564,SEUNUDDON,6338,2800,9138
1,ACEH,4086,SIMEULUE,4148,SIMEULUE TIMUR,0,0,0
1,ACEH,3205,ACEH UTARA,3320,LHOKSUKON,9549,7667,17216
1,ACEH,3205,ACEH UTARA,3523,SAMUDERA,6294,3771,10065
1,ACEH,3205,ACEH UTARA,4057,GEUREDONG PASE,1563,533,2096
1,ACEH,3205,ACEH UTARA,3447,MUARA BATU,5837,2986,8823
1,ACEH,3205,ACEH UTARA,3206,BAKTIYA,7176,6433,13609
1,ACEH,4086,SIMEULUE,4189,SIMEULUE BARAT,0,0,0
1,ACEH,4233,ACEH SINGKIL,4348,SINGKOHOR,1795,1135,2930
1,ACEH,4086,SIMEULUE,4112,SALANG,0,0,0
1,ACEH,4086,SIMEULUE,4129,TEUPAH BARAT,0,0,0
1,ACEH,4086,SIMEULUE,83455,TEUPAH TENGAH,0,0,0
1,ACEH,4086,SIMEULUE,4204,TEUPAH SELATAN,0,0,0
1,ACEH,4086,SIMEULUE,4178,TELUK DALAM,0,0,0
1,ACEH,4086,SIMEULUE,83456,SIMEULUE CUT,0,0,0
1,ACEH,3205,ACEH UTARA,3672,TANAH LUAS,6213,4120,10333
1,ACEH,4233,ACEH SINGKIL,4321,SINGKIL UTARA,2008,1810,3818
1,ACEH,3205,ACEH UTARA,3280,KUTA MAKMUR,6314,3703,10017
1,ACEH,3205,ACEH UTARA,3472,MEURAH MULIA,3965,3782,7747
1,ACEH,4233,ACEH SINGKIL,4268,SINGKIL,4907,2480,7387
1,ACEH,4233,ACEH SINGKIL,4285,GUNUNG MERIAH,9059,5549,14608
1,ACEH,4233,ACEH SINGKIL,4336,SURO MAKMUR,1233,1698,2931
1,ACEH,4233,ACEH SINGKIL,4242,SIMPANG KANAN,3821,2613,6434
1,ACEH,4233,ACEH SINGKIL,4311,KOTA BAHARU,1627,1031,2658
1,ACEH,4233,ACEH SINGKIL,4234,PULAU BANYAK,838,574,1412
1,ACEH,4362,BIREUEN,4363,SAMALANGA,6185,3652,9837
1,ACEH,4362,BIREUEN,4507,JEUMPA,7113,4486,11599
1,ACEH,4362,BIREUEN,4648,GANDAPURA,6515,2592,9107
1,ACEH,4362,BIREUEN,4925,PEUSANGAN SELATAN,3085,2060,5145
1,ACEH,4362,BIREUEN,4550,PEUSANGAN,11179,7392,18571
1,ACEH,4233,ACEH SINGKIL,4355,KUALA BARU,569,413,982
1,ACEH,4362,BIREUEN,4793,SIMPANG MAMPLAM,4639,4356,8995
1,ACEH,4362,BIREUEN,4620,MAKMUR,3523,2013,5536
1,ACEH,4362,BIREUEN,4858,KOTA JUANG,10759,5952,16711
1,ACEH,4362,BIREUEN,4835,PEULIMBANG,2180,2342,4522
1,ACEH,4233,ACEH SINGKIL,4360,PULAU BANYAK BARAT,370,654,1024
1,ACEH,4362,BIREUEN,4709,JULI,7180,4581,11761
1,ACEH,4233,ACEH SINGKIL,4329,DANAU PARIS,1054,1273,2327
1,ACEH,4362,BIREUEN,4882,KUALA,4215,2235,6450
1,ACEH,4362,BIREUEN,4903,PEUSANGAN SIBLAH KRUENG,2839,1838,4677
1,ACEH,4362,BIREUEN,4689,PANDRAH,2018,1335,3353
1,ACEH,4362,BIREUEN,4410,JEUNIEB,7878,3096,10974
1,ACEH,4989,ACEH BARAT DAYA,5127,JEUMPA,2860,1536,4396
1,ACEH,4989,ACEH BARAT DAYA,5118,SETIA,1239,1627,2866
1,ACEH,5138,GAYO LUES,5254,BLANGJERANGO,1201,2483,3684
1,ACEH,4362,BIREUEN,4746,JANGKA,5432,4381,9813
1,ACEH,4989,ACEH BARAT DAYA,5045,SUSOH,4895,5305,10200
1,ACEH,4362,BIREUEN,4454,PEUDADA,5264,5031,10295
1,ACEH,4989,ACEH BARAT DAYA,5074,KUALA BATEE,3972,3536,7508
1,ACEH,5138,GAYO LUES,5139,KUTAPANJANG,1536,2498,4034
1,ACEH,4989,ACEH BARAT DAYA,5104,LEMBAH SABIL,0,0,0
1,ACEH,5138,GAYO LUES,5152,BLANGKEJEREN,0,0,0
1,ACEH,4989,ACEH BARAT DAYA,4990,BLANG PIDIE,4780,3709,8489
1,ACEH,5138,GAYO LUES,5275,TERIPE JAYA,0,0,0
1,ACEH,5138,GAYO LUES,5187,TERANGUN,2187,2268,4455
1,ACEH,5138,GAYO LUES,5231,BLANGPEGAYON,1155,1465,2620
1,ACEH,4989,ACEH BARAT DAYA,5027,MANGGENG,3479,2648,6127
1,ACEH,5286,ACEH JAYA,5287,TEUNOM,3345,3199,6544
1,ACEH,4989,ACEH BARAT DAYA,5093,BABAH ROT,2284,3615,5899
1,ACEH,5138,GAYO LUES,5221,DABUN GELANG,1233,1499,2732
1,ACEH,4362,BIREUEN,4947,KUTA BLANG,5773,2745,8518
1,ACEH,5286,ACEH JAYA,5356,SAMPOINIET,1453,1618,3071
1,ACEH,5138,GAYO LUES,5265,PANTAN CUACA,714,1561,2275
1,ACEH,5138,GAYO LUES,5244,PUTERI BETUNG,1259,2673,3932
1,ACEH,5138,GAYO LUES,5211,PINING,680,1444,2124
1,ACEH,5138,GAYO LUES,5173,RIKIT GAIB,0,0,0
1,ACEH,5286,ACEH JAYA,83452,DARUL HIKMAH,1779,1271,3050
1,ACEH,5286,ACEH JAYA,83453,PASIE RAYA,0,0,0
1,ACEH,5286,ACEH JAYA,5342,SETIA BAKTI,1729,1593,3322
1,ACEH,5463,NAGAN RAYA,5581,DARUL MAKMUR,10555,9416,19971
1,ACEH,5286,ACEH JAYA,5394,JAYA,5321,2147,7468
1,ACEH,5463,NAGAN RAYA,5671,TADU RAYA,3129,3235,6364
1,ACEH,5463,NAGAN RAYA,5482,SEUNAGAN,3480,4764,8244
1,ACEH,5286,ACEH JAYA,83451,INDRA JAYA,2307,1233,3540
1,ACEH,5463,NAGAN RAYA,5552,BEUTONG,2308,4007,6315
1,ACEH,5286,ACEH JAYA,5443,PANGA,1458,1992,3450
1,ACEH,5286,ACEH JAYA,5324,KRUENG SABEE,0,0,0
1,ACEH,5463,NAGAN RAYA,5634,SUKA MAKMUE,2077,2852,4929
1,ACEH,5694,ACEH TAMIANG,5899,TENGGULUN,3867,2994,6861
1,ACEH,5463,NAGAN RAYA,83454,TRIPA MAKMUR,1932,1612,3544
1,ACEH,5463,NAGAN RAYA,5654,KUALA PESISIR,4204,3819,8023
1,ACEH,5694,ACEH TAMIANG,5845,TAMIANG HULU,5532,2790,8322
1,ACEH,5463,NAGAN RAYA,5517,SEUNAGAN TIMUR,3125,4321,7446
1,ACEH,5694,ACEH TAMIANG,5829,KEJURUAN MUDA,9005,5757,14762
1,ACEH,5463,NAGAN RAYA,5464,KUALA,4447,4269,8716
1,ACEH,5694,ACEH TAMIANG,5766,KARANG BARU,12432,5320,17752
1,ACEH,5694,ACEH TAMIANG,5872,BANDA MULIA,3180,1373,4553
1,ACEH,5920,BENER MERIAH,6126,BENER KELIPAH,759,1531,2290
1,ACEH,5463,NAGAN RAYA,83457,BEUTONG ATEUH BANGGALANG,308,553,861
1,ACEH,5694,ACEH TAMIANG,5823,KOTA KUALASIMPANG,4391,2982,7373
1,ACEH,5694,ACEH TAMIANG,5883,BANDAR PUSAKA,3303,2136,5439
1,ACEH,5694,ACEH TAMIANG,5732,BENDAHARA,5617,2931,8548
1,ACEH,5694,ACEH TAMIANG,5695,MANYAK PAYED,7261,4187,11448
1,ACEH,5920,BENER MERIAH,5921,TIMANG GAJAH,0,0,0
1,ACEH,5694,ACEH TAMIANG,5905,SEKERAK,1990,1106,3096
1,ACEH,5694,ACEH TAMIANG,5798,SERUWAY,6817,4801,11618
1,ACEH,5694,ACEH TAMIANG,5855,RANTAU,10874,4766,15640
1,ACEH,5920,BENER MERIAH,5952,PINTU RIME GAYO,1965,3742,5707
1,ACEH,6166,PIDIE JAYA,6167,MEUREUDU,3636,4771,8407
1,ACEH,5920,BENER MERIAH,6017,WIH PESAM,5304,5670,10974
1,ACEH,5920,BENER MERIAH,6045,BANDAR,0,0,0
1,ACEH,6166,PIDIE JAYA,6248,BANDAR DUA,3590,4847,8437
1,ACEH,6397,KOTA BANDA ACEH,6409,KUTA ALAM,8282,6568,14850
1,ACEH,5920,BENER MERIAH,6139,MESIDAH,635,1445,2080
1,ACEH,6166,PIDIE JAYA,6358,PANTERAJA,1521,1300,2821
1,ACEH,5920,BENER MERIAH,6098,PERMATA,0,0,0
1,ACEH,6397,KOTA BANDA ACEH,6449,LUENG BATA,4387,3644,8031
1,ACEH,5920,BENER MERIAH,5976,BUKIT,0,0,0
1,ACEH,6166,PIDIE JAYA,6314,BANDAR BARU,6010,6710,12720
1,ACEH,6166,PIDIE JAYA,6229,JANGKA BUYA,1195,2071,3266
1,ACEH,5920,BENER MERIAH,6081,SYIAH UTAMA,300,653,953
1,ACEH,6166,PIDIE JAYA,6369,TRIENGGADENG,3869,4105,7974
1,ACEH,6397,KOTA BANDA ACEH,6487,ULEE KARENG,5028,3950,8978
1,ACEH,5920,BENER MERIAH,6155,GAJAH PUTIH,0,0,0
1,ACEH,6497,KOTA SABANG,6507,SUKAJAYA,3746,2619,6365
1,ACEH,6397,KOTA BANDA ACEH,6459,KUTA RAJA,1716,1702,3418
1,ACEH,6518,KOTA LHOKSEUMAWE,6556,BLANG MANGAT,4426,3013,7439
1,ACEH,6397,KOTA BANDA ACEH,6438,SYIAH KUALA,6280,4618,10898
1,ACEH,6166,PIDIE JAYA,6198,ULIM,1917,3794,5711
1,ACEH,6591,KOTA LANGSA,6607,LANGSA BARAT,6976,3235,10211
1,ACEH,6166,PIDIE JAYA,6294,MEURAH DUA,2344,2740,5084
1,ACEH,6397,KOTA BANDA ACEH,6398,BAITURRAHMAN,6679,5261,11940
1,ACEH,6397,KOTA BANDA ACEH,6466,BANDA RAYA,5642,3709,9351
1,ACEH,6397,KOTA BANDA ACEH,6421,MEURAXA,3215,3080,6295
1,ACEH,6518,KOTA LHOKSEUMAWE,6537,BANDA SAKTI,14892,8317,23209
1,ACEH,6397,KOTA BANDA ACEH,6477,JAYA BARU,4594,3471,8065
6728,SUMATERA UTARA,7240,TAPANULI TENGAH,7241,BARUS,3972,2833,6805
1,ACEH,6591,KOTA LANGSA,6628,LANGSA LAMA,9313,3508,12821
1,ACEH,6518,KOTA LHOKSEUMAWE,6579,MUARA SATU,5999,3257,9256
1,ACEH,6497,KOTA SABANG,6498,SUKAKARYA,3555,2918,6473
6728,SUMATERA UTARA,7240,TAPANULI TENGAH,7392,BADIRI,2631,6471,9102
1,ACEH,6591,KOTA LANGSA,6638,LANGSA BARO,14232,5092,19324
1,ACEH,6518,KOTA LHOKSEUMAWE,6519,MUARA DUA,9299,4709,14008
1,ACEH,6591,KOTA LANGSA,6592,LANGSA TIMUR,3639,1838,5477
1,ACEH,6648,KOTA SUBULUSSALAM,6699,SULTAN DAULAT,3649,2204,5853
6728,SUMATERA UTARA,7240,TAPANULI TENGAH,7376,SITAHUIS,0,0,0
6728,SUMATERA UTARA,7240,TAPANULI TENGAH,7340,SORKAM BARAT,2183,4574,6757
1,ACEH,6648,KOTA SUBULUSSALAM,6675,RUNDENG,3764,1685,5449
1,ACEH,6591,KOTA LANGSA,6617,LANGSA KOTA,8533,4667,13200
1,ACEH,6648,KOTA SUBULUSSALAM,6649,SIMPANG KIRI,7966,4310,12276
6728,SUMATERA UTARA,7240,TAPANULI TENGAH,7289,MANDUAMAS,1828,5877,7705
6728,SUMATERA UTARA,7240,TAPANULI TENGAH,7383,TUKKA,1587,3496,5083
6728,SUMATERA UTARA,7240,TAPANULI TENGAH,7271,PANDAN,0,0,0
6728,SUMATERA UTARA,7240,TAPANULI TENGAH,7402,PASARIBU TOBING,0,0,0
1,ACEH,6648,KOTA SUBULUSSALAM,6664,PENANGGALAN,3299,2038,5337
1,ACEH,6648,KOTA SUBULUSSALAM,6717,LONGKIB,1494,1039,2533
6728,SUMATERA UTARA,7240,TAPANULI TENGAH,7411,BARUS UTARA,240,2040,2280
6728,SUMATERA UTARA,7240,TAPANULI TENGAH,7255,SORKAM,0,0,0
6728,SUMATERA UTARA,7240,TAPANULI TENGAH,7330,SOSOR GADONG,0,0,0
6728,SUMATERA UTARA,7240,TAPANULI TENGAH,7299,KOLANG,1291,6367,7658
6728,SUMATERA UTARA,7240,TAPANULI TENGAH,7418,SUKA BANGUN,340,1114,1454
6728,SUMATERA UTARA,7240,TAPANULI TENGAH,7425,LUMUT,992,3857,4849
6728,SUMATERA UTARA,7240,TAPANULI TENGAH,7361,ANDAM DEWI,1407,4863,6270
6728,SUMATERA UTARA,7438,TAPANULI UTARA,7439,TARUTUNG,2140,16837,18977
6728,SUMATERA UTARA,7438,TAPANULI UTARA,7645,PANGARIBUAN,929,11370,12299
6728,SUMATERA UTARA,7438,TAPANULI UTARA,7557,PURBA TUA,482,2920,3402
6728,SUMATERA UTARA,7240,TAPANULI TENGAH,7352,SIRANDORUNG,1010,4761,5771
6728,SUMATERA UTARA,7240,TAPANULI TENGAH,7281,PINANGSORI,2315,6550,8865
6728,SUMATERA UTARA,7438,TAPANULI UTARA,7668,GAROGA,914,6395,7309
6728,SUMATERA UTARA,7438,TAPANULI UTARA,7514,PAHAE JULU,586,5306,5892
6728,SUMATERA UTARA,7438,TAPANULI UTARA,7591,PAGARAN,308,7648,7956
6728,SUMATERA UTARA,7240,TAPANULI TENGAH,7312,TAPIAN NAULI,2000,6211,8211
6728,SUMATERA UTARA,7697,TAPANULI SELATAN,7931,TANO TOMBANGAN ANGKOLA,1431,6247,7678
6728,SUMATERA UTARA,7438,TAPANULI UTARA,7548,SIMANGUMBAN,677,2716,3393
6728,SUMATERA UTARA,7438,TAPANULI UTARA,7621,SIPAHUTAR,706,10962,11668
6728,SUMATERA UTARA,7240,TAPANULI TENGAH,7322,SIBABANGUN,2050,5479,7529
6728,SUMATERA UTARA,7240,TAPANULI TENGAH,7432,SARUDIK,0,0,0
6728,SUMATERA UTARA,7438,TAPANULI UTARA,7606,PARMONANGAN,303,6447,6750
6728,SUMATERA UTARA,7697,TAPANULI SELATAN,7921,MUARA BATANG TORU,2141,2946,5087
6728,SUMATERA UTARA,7438,TAPANULI UTARA,7534,PAHAE JAE,821,4304,5125
6728,SUMATERA UTARA,7697,TAPANULI SELATAN,7794,SAIPAR DOLOK HOLE,4687,2178,6865
6728,SUMATERA UTARA,7438,TAPANULI UTARA,7681,MUARA,229,6506,6735
6728,SUMATERA UTARA,7697,TAPANULI SELATAN,7737,ANGKOLA TIMUR,8052,1963,10015
6728,SUMATERA UTARA,7438,TAPANULI UTARA,7499,SIPOHOLON,936,9178,10114
6728,SUMATERA UTARA,7438,TAPANULI UTARA,7471,SIATAS BARITA,664,5661,6325
6728,SUMATERA UTARA,7438,TAPANULI UTARA,7484,ADIAN KOTING,518,5878,6396
6728,SUMATERA UTARA,7697,TAPANULI SELATAN,7753,SIPIROK,11369,4333,15702
6728,SUMATERA UTARA,7697,TAPANULI SELATAN,7888,SAYUR MATINGGI,7994,3401,11395
6728,SUMATERA UTARA,7697,TAPANULI SELATAN,7908,AEK BILAH,2908,975,3883
6728,SUMATERA UTARA,7697,TAPANULI SELATAN,7827,BATANG ANGKOLA,11997,3672,15669
6728,SUMATERA UTARA,7960,NIAS,7961,HILIDUHO,222,4117,4339
6728,SUMATERA UTARA,7697,TAPANULI SELATAN,7809,ANGKOLA SELATAN,5712,6129,11841
6728,SUMATERA UTARA,7697,TAPANULI SELATAN,7698,ANGKOLA BARAT,8823,2362,11185
6728,SUMATERA UTARA,7697,TAPANULI SELATAN,7875,MARANCAR,3491,1451,4942
6728,SUMATERA UTARA,7960,NIAS,8056,HILISERANGKAI,427,5891,6318
6728,SUMATERA UTARA,8094,LANGKAT,8302,BABALAN,12053,12274,24327
6728,SUMATERA UTARA,7697,TAPANULI SELATAN,7864,ARSE,2975,1570,4545
6728,SUMATERA UTARA,7960,NIAS,8069,BOTOMUZOI,387,3819,4206
6728,SUMATERA UTARA,8094,LANGKAT,8350,BRANDAN BARAT,0,0,0
6728,SUMATERA UTARA,7960,NIAS,8001,IDANO GAWO,2099,9244,11343
6728,SUMATERA UTARA,8094,LANGKAT,8289,GEBANG,10299,9860,20159
6728,SUMATERA UTARA,8094,LANGKAT,8334,SEI LEPAN,9688,12619,22307
6728,SUMATERA UTARA,7960,NIAS,8082,ULUGAWO,486,4785,5271
6728,SUMATERA UTARA,7697,TAPANULI SELATAN,7949,ANGKOLA SANGKUNUR,3871,5876,9747
6728,SUMATERA UTARA,8094,LANGKAT,8274,PADANG TUALANG,11242,12489,23731
6728,SUMATERA UTARA,8094,LANGKAT,8387,KUTAMBARU,2173,4877,7050
6728,SUMATERA UTARA,7697,TAPANULI SELATAN,7713,BATANG TORU,7160,7530,14690
6728,SUMATERA UTARA,8094,LANGKAT,8254,TANJUNG PURA,0,0,0
6728,SUMATERA UTARA,7960,NIAS,7975,GIDO,517,8501,9018
6728,SUMATERA UTARA,8094,LANGKAT,8191,STABAT,0,0,0
6728,SUMATERA UTARA,7960,NIAS,8020,BAWOLATO,1524,7707,9231
6728,SUMATERA UTARA,8094,LANGKAT,8095,BAHOROK,0,0,0
6728,SUMATERA UTARA,8094,LANGKAT,8168,BINJAI,13548,8475,22023
6728,SUMATERA UTARA,8094,LANGKAT,8358,BATANG SERANGAN,0,0,0
6728,SUMATERA UTARA,8094,LANGKAT,8311,PANGKALAN SUSU,0,0,0
6728,SUMATERA UTARA,8094,LANGKAT,8323,BESITANG,0,0,0
6728,SUMATERA UTARA,8094,LANGKAT,8220,SECANGGANG,17900,14641,32541
6728,SUMATERA UTARA,8094,LANGKAT,8368,SAWIT SEBERANG,5258,7260,12518
6728,SUMATERA UTARA,8408,KARO,8637,DOLAT RAYAT,483,3606,4089
6728,SUMATERA UTARA,8094,LANGKAT,8376,SIRAPIT,4312,4443,8755
6728,SUMATERA UTARA,8408,KARO,8593,PAYUNG,667,4816,5483
6728,SUMATERA UTARA,8408,KARO,8593,PAYUNG,667,4816,5483
6728,SUMATERA UTARA,8094,LANGKAT,8151,SEI BINGEI,8473,14775,23248
6728,SUMATERA UTARA,8408,KARO,8593,PAYUNG,667,4816,5483
6728,SUMATERA UTARA,8094,LANGKAT,8151,SEI BINGEI,8473,14775,23248
6728,SUMATERA UTARA,8408,KARO,8564,LAUBALENG,929,7498,8427
6728,SUMATERA UTARA,8408,KARO,8593,PAYUNG,667,4816,5483
6728,SUMATERA UTARA,8094,LANGKAT,8151,SEI BINGEI,8473,14775,23248
6728,SUMATERA UTARA,8408,KARO,8564,LAUBALENG,929,7498,8427
6728,SUMATERA UTARA,8408,KARO,8645,MERDEKA,1105,5109,6214
6728,SUMATERA UTARA,8408,KARO,8593,PAYUNG,667,4816,5483
6728,SUMATERA UTARA,8094,LANGKAT,8151,SEI BINGEI,8473,14775,23248
6728,SUMATERA UTARA,8408,KARO,8564,LAUBALENG,929,7498,8427
6728,SUMATERA UTARA,8408,KARO,8645,MERDEKA,1105,5109,6214
6728,SUMATERA UTARA,8094,LANGKAT,8133,KUALA,11025,9508,20533
6728,SUMATERA UTARA,8408,KARO,8593,PAYUNG,667,4816,5483
6728,SUMATERA UTARA,8094,LANGKAT,8151,SEI BINGEI,8473,14775,23248
6728,SUMATERA UTARA,8408,KARO,8564,LAUBALENG,929,7498,8427
6728,SUMATERA UTARA,8408,KARO,8645,MERDEKA,1105,5109,6214
6728,SUMATERA UTARA,8094,LANGKAT,8133,KUALA,11025,9508,20533
6728,SUMATERA UTARA,8094,LANGKAT,8204,WAMPU,11793,9067,20860
6728,SUMATERA UTARA,8094,LANGKAT,8115,SALAPIAN,5536,8311,13847
6728,SUMATERA UTARA,8094,LANGKAT,8176,SELESAI,0,0,0
6728,SUMATERA UTARA,8408,KARO,8433,BARUSJAHE,1115,10680,11795
6728,SUMATERA UTARA,8408,KARO,8476,MEREK,854,8271,9125
6728,SUMATERA UTARA,8408,KARO,8423,BERASTAGI,4211,14167,18378
6728,SUMATERA UTARA,8408,KARO,8496,MUNTE,1389,8829,10218
6728,SUMATERA UTARA,8408,KARO,8453,TIGAPANAH,1593,13036,14629
6728,SUMATERA UTARA,8094,LANGKAT,8240,HINAI,0,0,0
6728,SUMATERA UTARA,8408,KARO,8580,MARDINGDING,735,7003,7738
6728,SUMATERA UTARA,8408,KARO,8519,JUHAR,651,6993,7644
6728,SUMATERA UTARA,8688,DELI SERDANG,8973,SUNGGAL,0,0,0
6728,SUMATERA UTARA,8094,LANGKAT,8398,PEMATANG JAYA,0,0,0
6728,SUMATERA UTARA,8408,KARO,8670,TIGANDERKET,1097,5880,6977
6728,SUMATERA UTARA,8408,KARO,8655,NAMAN TERAN,986,4123,5109
6728,SUMATERA UTARA,8408,KARO,8409,KABANJAHE,5367,21660,27027
6728,SUMATERA UTARA,8688,DELI SERDANG,8966,DELI TUA,0,0,0
6728,SUMATERA UTARA,8688,DELI SERDANG,8991,HAMPARAN PERAK,44699,23338,68037
6728,SUMATERA UTARA,8688,DELI SERDANG,9082,PANTAI LABU,10445,8143,18588
6728,SUMATERA UTARA,8688,DELI SERDANG,9065,PAGAR MERBAU,10146,7753,17899
6728,SUMATERA UTARA,8408,KARO,8620,KUTABULUH,1330,5130,6460
6728,SUMATERA UTARA,8408,KARO,8602,SIMPANG EMPAT,1356,8141,9497
6728,SUMATERA UTARA,8688,DELI SERDANG,8729,SIBOLANGIT,0,0,0
6728,SUMATERA UTARA,8688,DELI SERDANG,8957,PATUMBAK,0,0,0
6728,SUMATERA UTARA,8688,DELI SERDANG,9012,LABUHAN DELI,0,0,0
6728,SUMATERA UTARA,8688,DELI SERDANG,8689,GUNUNG MERIAH,0,0,0
6728,SUMATERA UTARA,8688,DELI SERDANG,9102,BERINGIN,12254,13808,26062
6728,SUMATERA UTARA,8408,KARO,8544,TIGABINANGA,1594,8804,10398
6728,SUMATERA UTARA,8688,DELI SERDANG,8936,STM HULU,1225,5003,6228
6728,SUMATERA UTARA,8688,DELI SERDANG,8856,STM HILIR,4465,10386,14851
6728,SUMATERA UTARA,8688,DELI SERDANG,8872,BANGUN PURBA,4991,6222,11213
6728,SUMATERA UTARA,9114,SIMALUNGUN,9349,DOLOK PARDAMEAN,515,7822,8337
6728,SUMATERA UTARA,9114,SIMALUNGUN,9360,PEMATANG BANDAR,6474,9134,15608
6728,SUMATERA UTARA,9114,SIMALUNGUN,9340,JAWA MARAJA BAH JAMBI,4883,5400,10283
6728,SUMATERA UTARA,8688,DELI SERDANG,8702,TANJUNG MORAWA,0,0,0
6728,SUMATERA UTARA,8688,DELI SERDANG,9051,LUBUK PAKAM,0,0,0
6728,SUMATERA UTARA,8688,DELI SERDANG,9018,PERCUT SEI TUAN,91428,62678,154106
6728,SUMATERA UTARA,8688,DELI SERDANG,8775,PANCUR BATU,14120,24919,39039
6728,SUMATERA UTARA,9114,SIMALUNGUN,9414,DOLOK SILAU,850,6301,7151
6728,SUMATERA UTARA,8688,DELI SERDANG,9039,BATANG KUIS,16245,8625,24870
6728,SUMATERA UTARA,8688,DELI SERDANG,8906,GALANG,0,0,0
6728,SUMATERA UTARA,9114,SIMALUNGUN,9115,SIANTAR,12917,19726,32643
6728,SUMATERA UTARA,9114,SIMALUNGUN,9372,BANDAR HULUAN,6467,6922,13389
6728,SUMATERA UTARA,9114,SIMALUNGUN,9326,HUTA BAYU RAJA,3696,10975,14671
6728,SUMATERA UTARA,8688,DELI SERDANG,8801,NAMORAMBE,0,0,0
6728,SUMATERA UTARA,9114,SIMALUNGUN,9424,SILOU KAHEAN,2095,6009,8104
6728,SUMATERA UTARA,9114,SIMALUNGUN,9382,BANDAR,13056,16782,29838
6728,SUMATERA UTARA,8688,DELI SERDANG,8760,KUTALIMBARU,0,0,0
6728,SUMATERA UTARA,9114,SIMALUNGUN,9310,DOLOK BATU NANGGAR,11047,10255,21302
6728,SUMATERA UTARA,9114,SIMALUNGUN,9397,BANDAR MASILAM,6559,5814,12373
6728,SUMATERA UTARA,9114,SIMALUNGUN,9160,PANEI,2220,9457,11677
6728,SUMATERA UTARA,9114,SIMALUNGUN,9150,GUNUNG MALIGAS,7665,5511,13176
6728,SUMATERA UTARA,9114,SIMALUNGUN,9407,SILIMAKUTA,626,5254,5880
6728,SUMATERA UTARA,9114,SIMALUNGUN,9220,SIDAMANIK,3902,10164,14066
6728,SUMATERA UTARA,9114,SIMALUNGUN,9441,TAPIAN DOLOK,9783,10642,20425
6728,SUMATERA UTARA,9114,SIMALUNGUN,9245,TANAH JAWA,8933,16027,24960
6728,SUMATERA UTARA,9114,SIMALUNGUN,9133,GUNUNG MALELA,8780,9304,18084
6728,SUMATERA UTARA,9114,SIMALUNGUN,9182,JORLANG HATARAN,1949,6265,8214
6728,SUMATERA UTARA,9114,SIMALUNGUN,9452,RAYA,2199,13824,16023
6728,SUMATERA UTARA,9114,SIMALUNGUN,9276,DOLOK PANRIBUAN,865,8446,9311
6728,SUMATERA UTARA,9114,SIMALUNGUN,9470,UJUNG PADANG,8424,11708,20132
6728,SUMATERA UTARA,9114,SIMALUNGUN,9304,GIRSANG SIPANGAN BOLON,860,7009,7869
6728,SUMATERA UTARA,9114,SIMALUNGUN,9192,RAYA KAHEAN,2269,6713,8982
6728,SUMATERA UTARA,9114,SIMALUNGUN,9234,PEMATANG SIDAMANIK,1896,6648,8544
6728,SUMATERA UTARA,9114,SIMALUNGUN,9172,PANOMBEIAN PANE,3068,7582,10650
6728,SUMATERA UTARA,9497,ASAHAN,9660,SEI KEPAYANG BARAT,2862,2225,5087
6728,SUMATERA UTARA,9114,SIMALUNGUN,9266,HATONDUHAN,2079,8167,10246
6728,SUMATERA UTARA,9114,SIMALUNGUN,9298,HARANGGAOL HORISON,222,2690,2912
6728,SUMATERA UTARA,9497,ASAHAN,9649,SEI DADAP,7438,7839,15277
6728,SUMATERA UTARA,9497,ASAHAN,9498,MERANTI,3218,6662,9880
6728,SUMATERA UTARA,9114,SIMALUNGUN,9204,BOSAR MALIGAS,8701,11264,19965
6728,SUMATERA UTARA,9114,SIMALUNGUN,9287,PURBA,1039,9521,10560
6728,SUMATERA UTARA,9497,ASAHAN,9681,SETIA JANJI,2826,3921,6747
6728,SUMATERA UTARA,9497,ASAHAN,9631,AEK SONGSONGAN,3259,5662,8921
6728,SUMATERA UTARA,9497,ASAHAN,9514,TANJUNG BALAI,7629,5422,13051
6728,SUMATERA UTARA,9497,ASAHAN,9506,AIR JOMAN,9421,11402,20823
6728,SUMATERA UTARA,9497,ASAHAN,9673,TINGGI RAJA,4582,5487,10069
6728,SUMATERA UTARA,9497,ASAHAN,9618,KOTA KISARAN TIMUR,20541,14396,34937
6728,SUMATERA UTARA,9497,ASAHAN,9667,SEI KEPAYANG TIMUR,2391,1179,3570
6728,SUMATERA UTARA,9497,ASAHAN,9641,RAHUNING,4415,4765,9180
6728,SUMATERA UTARA,9497,ASAHAN,9712,TELUK DALAM,4211,4397,8608
6728,SUMATERA UTARA,9497,ASAHAN,9687,SILAU LAUT,4445,5187,9632
6728,SUMATERA UTARA,9497,ASAHAN,9576,BUNTU PANE,4976,7425,12401
6728,SUMATERA UTARA,9497,ASAHAN,9719,AEK LEDONG,3824,6019,9843
6728,SUMATERA UTARA,9727,LABUHANBATU,9739,RANTAU SELATAN,19295,9890,29185
6728,SUMATERA UTARA,9114,SIMALUNGUN,9488,PAMATANG SILIMA HUTA,323,5053,5376
6728,SUMATERA UTARA,9497,ASAHAN,9552,PULAU RAKYAT,6746,9180,15926
6728,SUMATERA UTARA,9497,ASAHAN,9693,RAWANG PANCA ARGA,4490,4739,9229
6728,SUMATERA UTARA,9727,LABUHANBATU,9774,BILAH HULU,15414,13143,28557
6728,SUMATERA UTARA,9497,ASAHAN,9530,SIMPANG EMPAT,7103,10817,17920
6728,SUMATERA UTARA,9727,LABUHANBATU,9807,PANAI TENGAH,5368,8405,13773
6728,SUMATERA UTARA,9497,ASAHAN,9701,PULO BANDRING,7239,8182,15421
6728,SUMATERA UTARA,9497,ASAHAN,9596,AEK KUASAN,4761,7872,12633
6728,SUMATERA UTARA,9727,LABUHANBATU,9749,BILAH BARAT,10276,6125,16401
6728,SUMATERA UTARA,9497,ASAHAN,9565,BANDAR PULAU,4477,6895,11372
6728,SUMATERA UTARA,9835,DAIRI,10009,SILAHISABUNGAN,200,2090,2290
6728,SUMATERA UTARA,9727,LABUHANBATU,9818,PANAI HILIR,6461,7671,14132
6728,SUMATERA UTARA,9497,ASAHAN,9604,KOTA KISARAN BARAT,16480,12068,28548
6728,SUMATERA UTARA,9727,LABUHANBATU,9799,PANGKATAN,7165,9523,16688
6728,SUMATERA UTARA,9835,DAIRI,9947,SIEMPAT NEMPU HILIR,730,4521,5251
6728,SUMATERA UTARA,9497,ASAHAN,9523,SEI KEPAYANG,2956,4231,7187
6728,SUMATERA UTARA,9727,LABUHANBATU,9728,RANTAU UTARA,24400,16271,40671
6728,SUMATERA UTARA,9835,DAIRI,9994,GUNUNG SITEMBER,804,3933,4737
6728,SUMATERA UTARA,9835,DAIRI,10003,BRAMPU,1314,2208,3522
6728,SUMATERA UTARA,9497,ASAHAN,9586,BANDAR PASIR MANDOGE,4857,11593,16450
6728,SUMATERA UTARA,9497,ASAHAN,9539,AIR BATU,9790,9766,19556
6728,SUMATERA UTARA,9727,LABUHANBATU,9827,PANAI HULU,7452,7769,15221
6728,SUMATERA UTARA,9835,DAIRI,9984,LAE PARIRA,1210,5601,6811
6728,SUMATERA UTARA,9727,LABUHANBATU,9760,BILAH HILIR,10740,13104,23844
6728,SUMATERA UTARA,10020,TOBA SAMOSIR,10206,TAMPAHAN,134,1971,2105
6728,SUMATERA UTARA,9835,DAIRI,9914,TANAH PINEM,1809,9164,10973
6728,SUMATERA UTARA,9835,DAIRI,9958,PEGAGAN HILIR,905,6282,7187
6728,SUMATERA UTARA,9835,DAIRI,9897,SILIMA PUNGGA PUNGA,1240,5235,6475
6728,SUMATERA UTARA,10020,TOBA SAMOSIR,10021,BALIGE,1692,16619,18311
6728,SUMATERA UTARA,10020,TOBA SAMOSIR,10213,SIANTAR NARUMONDA,300,2563,2863
6728,SUMATERA UTARA,9835,DAIRI,10015,SITINJO,1038,4314,5352
6728,SUMATERA UTARA,10020,TOBA SAMOSIR,10173,ULUAN,297,3850,4147
6728,SUMATERA UTARA,9835,DAIRI,9883,SIEMPAT NEMPU,1109,7533,8642
6728,SUMATERA UTARA,9835,DAIRI,9972,PARBULUAN,805,8640,9445
6728,SUMATERA UTARA,9835,DAIRI,9848,SUMBUL,1797,16966,18763
6728,SUMATERA UTARA,9835,DAIRI,9868,TIGALINGGA,1728,9860,11588
6728,SUMATERA UTARA,10020,TOBA SAMOSIR,10191,SIGUMPAR,269,3368,3637
6728,SUMATERA UTARA,10020,TOBA SAMOSIR,10200,NASSAU,617,3259,3876
6728,SUMATERA UTARA,10020,TOBA SAMOSIR,10120,PORSEA,758,5734,6492
6728,SUMATERA UTARA,10020,TOBA SAMOSIR,10102,PINTU POHAN MERANTI,574,2485,3059
6728,SUMATERA UTARA,10020,TOBA SAMOSIR,10055,LAGUBOTI,781,9000,9781
6728,SUMATERA UTARA,9835,DAIRI,9836,SIDIKALANG,5185,17072,22257
6728,SUMATERA UTARA,10020,TOBA SAMOSIR,83409,PARMAKSIAN,762,4203,4965
6728,SUMATERA UTARA,10020,TOBA SAMOSIR,10157,LUMBAN JULU,242,3990,4232
6728,SUMATERA UTARA,10020,TOBA SAMOSIR,83408,BONATUA LUNASI,279,2402,2681
6728,SUMATERA UTARA,10020,TOBA SAMOSIR,10113,BORBOR,208,3139,3347
6728,SUMATERA UTARA,9835,DAIRI,9934,SIEMPAT NEMPU HULU,2251,6313,8564
6728,SUMATERA UTARA,10020,TOBA SAMOSIR,10076,SILAEN,414,6305,6719
6728,SUMATERA UTARA,10227,MANDAILING NATAL,10554,MUARA BATANG GADIS,4479,2393,6872
6728,SUMATERA UTARA,10227,MANDAILING NATAL,10602,PUNCAK SORIK MARAPI,3985,299,4284
6728,SUMATERA UTARA,10020,TOBA SAMOSIR,10091,HABINSARAN,636,6951,7587
6728,SUMATERA UTARA,10227,MANDAILING NATAL,10485,LINGGA BAYU,6986,4178,11164
6728,SUMATERA UTARA,10227,MANDAILING NATAL,10524,NATAL,8616,5370,13986
6728,SUMATERA UTARA,10227,MANDAILING NATAL,10588,HUTA BARGOT,3140,626,3766
6728,SUMATERA UTARA,10020,TOBA SAMOSIR,10147,AJIBATA,191,3686,3877
6728,SUMATERA UTARA,10227,MANDAILING NATAL,10423,ULU PUNGKUT,2232,182,2414
6728,SUMATERA UTARA,10227,MANDAILING NATAL,10614,PAKANTAN,725,370,1095
6728,SUMATERA UTARA,10227,MANDAILING NATAL,10228,PANYABUNGAN KOTA,29000,5814,34814
6728,SUMATERA UTARA,10227,MANDAILING NATAL,10453,BATANG NATAL,9102,2683,11785
6728,SUMATERA UTARA,10227,MANDAILING NATAL,10569,RANTO BAEK,4376,1664,6040
6728,SUMATERA UTARA,10227,MANDAILING NATAL,10280,PANYABUNGAN TIMUR,5181,805,5986
6728,SUMATERA UTARA,10227,MANDAILING NATAL,10308,PANYABUNGAN BARAT,4153,683,4836
6728,SUMATERA UTARA,10227,MANDAILING NATAL,10402,TAMBANGAN,5476,837,6313
6728,SUMATERA UTARA,10227,MANDAILING NATAL,10343,BUKIT MALINTANG,3906,1343,5249
6728,SUMATERA UTARA,10227,MANDAILING NATAL,10319,SIABU,16900,4237,21137
6728,SUMATERA UTARA,10227,MANDAILING NATAL,10355,KOTANOPAN,10802,1950,12752
6728,SUMATERA UTARA,10646,NIAS SELATAN,83459,ULUNOYO,0,0,0
6728,SUMATERA UTARA,10646,NIAS SELATAN,83460,HURUNA,0,0,0
6728,SUMATERA UTARA,10227,MANDAILING NATAL,10505,BATAHAN,7227,2751,9978
6728,SUMATERA UTARA,10646,NIAS SELATAN,83462,ONOHAZUMBA,0,0,0
6728,SUMATERA UTARA,10227,MANDAILING NATAL,10437,MUARA SIPONGI,3410,1666,5076
6728,SUMATERA UTARA,10646,NIAS SELATAN,10963,ARAMO,0,0,0
6728,SUMATERA UTARA,10227,MANDAILING NATAL,10267,PANYABUNGAN UTARA,6169,2550,8719
6728,SUMATERA UTARA,10646,NIAS SELATAN,10674,GOMO,0,0,0
6728,SUMATERA UTARA,10646,NIAS SELATAN,10805,TELUK DALAM,1587,16952,18539
6728,SUMATERA UTARA,10646,NIAS SELATAN,11005,FANAYAMA,0,0,0
6728,SUMATERA UTARA,10227,MANDAILING NATAL,10392,LEMBAH SORIK MARAPI,4566,637,5203
6728,SUMATERA UTARA,10227,MANDAILING NATAL,10623,SINUNUKAN,4297,4290,8587
6728,SUMATERA UTARA,10227,MANDAILING NATAL,10638,NAGA JUANG,845,1062,1907
6728,SUMATERA UTARA,10646,NIAS SELATAN,10699,LAHUSA,952,10935,11887
6728,SUMATERA UTARA,10646,NIAS SELATAN,10887,SUSUA,0,0,0
6728,SUMATERA UTARA,10646,NIAS SELATAN,83466,SOMAMBAWA,529,4392,4921
6728,SUMATERA UTARA,10646,NIAS SELATAN,10823,AMANDRAYA,1376,3881,5257
6728,SUMATERA UTARA,10227,MANDAILING NATAL,10296,PANYABUNGAN SELATAN,4475,656,5131
6728,SUMATERA UTARA,10646,NIAS SELATAN,10647,LOLOMATUA,0,0,0
6728,SUMATERA UTARA,10646,NIAS SELATAN,83464,ULUSUSUA,1720,5107,6827
6728,SUMATERA UTARA,10646,NIAS SELATAN,10902,MANIAMOLO,0,0,0
6728,SUMATERA UTARA,10646,NIAS SELATAN,10917,HILIMEGAI,0,0,0
6728,SUMATERA UTARA,10646,NIAS SELATAN,10929,TOMA,0,0,0
6728,SUMATERA UTARA,11022,PAKPAK BHARAT,11058,PERGETTENG GETTENG SENGKUT,780,971,1751
6728,SUMATERA UTARA,10646,NIAS SELATAN,10953,UMBUNASI,0,0,0
6728,SUMATERA UTARA,10646,NIAS SELATAN,83467,BORONADU,0,0,0
6728,SUMATERA UTARA,10646,NIAS SELATAN,83468,SIMUK,0,0,0
6728,SUMATERA UTARA,10646,NIAS SELATAN,10990,MAZO,851,6331,7182
6728,SUMATERA UTARA,11083,HUMBANG HASUNDUTAN,11216,PAKKAT,0,0,0
6728,SUMATERA UTARA,10646,NIAS SELATAN,10735,HIBALA,0,0,0
6728,SUMATERA UTARA,11022,PAKPAK BHARAT,11064,PAGINDAR,207,346,553
6728,SUMATERA UTARA,11022,PAKPAK BHARAT,11034,KERAJAAN,1262,2414,3676
6728,SUMATERA UTARA,11083,HUMBANG HASUNDUTAN,11084,PARLILITAN,0,0,0
6728,SUMATERA UTARA,10646,NIAS SELATAN,10941,MAZINO,1391,5820,7211
6728,SUMATERA UTARA,11022,PAKPAK BHARAT,11023,SITELU TALI URANG JEHE,2143,1729,3872
6728,SUMATERA UTARA,11083,HUMBANG HASUNDUTAN,11192,SIJAMAPOLANG,306,2260,2566
6728,SUMATERA UTARA,11083,HUMBANG HASUNDUTAN,11203,ONAN GANJANG,496,4531,5027
6728,SUMATERA UTARA,10646,NIAS SELATAN,83471,TANAH MASA,0,0,0
6728,SUMATERA UTARA,11022,PAKPAK BHARAT,11052,SITELU TALI URANG JULU,599,1122,1721
6728,SUMATERA UTARA,11083,HUMBANG HASUNDUTAN,11162,DOLOK SANGGUL,0,0,0
6728,SUMATERA UTARA,11022,PAKPAK BHARAT,11045,SALAK,855,2621,3476
6728,SUMATERA UTARA,11247,SAMOSIR,11305,PALIPI,358,7874,8232
6728,SUMATERA UTARA,11247,SAMOSIR,11319,RONGGUR NIHUTA,267,3605,3872
6728,SUMATERA UTARA,11022,PAKPAK BHARAT,11069,TINADA,421,1386,1807
6728,SUMATERA UTARA,11083,HUMBANG HASUNDUTAN,11119,BAKTIRAJA,208,3339,3547
6728,SUMATERA UTARA,11022,PAKPAK BHARAT,11076,SIEMPAT RUBE,414,1486,1900
6728,SUMATERA UTARA,11247,SAMOSIR,11248,SIANJUR MULA MULA,215,4468,4683
6728,SUMATERA UTARA,11083,HUMBANG HASUNDUTAN,11105,POLLUNG,0,0,0
6728,SUMATERA UTARA,11083,HUMBANG HASUNDUTAN,11237,TARABINTANG,0,0,0
6728,SUMATERA UTARA,11374,SERDANG BEDAGAI,11375,PANTAI CERMIN,11276,9103,20379
6728,SUMATERA UTARA,11374,SERDANG BEDAGAI,11564,TEBING TINGGI,12524,9286,21810
6728,SUMATERA UTARA,11374,SERDANG BEDAGAI,11579,PEGAJAHAN,5846,8612,14458
6728,SUMATERA UTARA,11247,SAMOSIR,11292,NAINGGOLAN,297,5292,5589
6728,SUMATERA UTARA,11083,HUMBANG HASUNDUTAN,11139,LINTONG NIHUTA,1419,13138,14557
6728,SUMATERA UTARA,11083,HUMBANG HASUNDUTAN,11127,PARANGINAN,0,0,0
6728,SUMATERA UTARA,11247,SAMOSIR,11328,PANGURURAN,966,13704,14670
6728,SUMATERA UTARA,11374,SERDANG BEDAGAI,11593,SEI BAMBAN,7063,13952,21015
6728,SUMATERA UTARA,11374,SERDANG BEDAGAI,11463,DOLOK MERAWAN,5940,3684,9624
6728,SUMATERA UTARA,11374,SERDANG BEDAGAI,11417,TELUK MENGKUDU,9692,9765,19457
6728,SUMATERA UTARA,11247,SAMOSIR,11260,HARIAN,363,3524,3887
6728,SUMATERA UTARA,11374,SERDANG BEDAGAI,11604,TEBING SYAHBANDAR,10468,5890,16358
6728,SUMATERA UTARA,11247,SAMOSIR,11279,ONAN RUNGGU,261,4752,5013
6728,SUMATERA UTARA,11374,SERDANG BEDAGAI,11543,SILINDA,1158,3375,4533
6728,SUMATERA UTARA,11374,SERDANG BEDAGAI,11531,KOTARIH,1591,2761,4352
6728,SUMATERA UTARA,11374,SERDANG BEDAGAI,11448,TANJUNG BERINGIN,7955,7942,15897
6728,SUMATERA UTARA,11374,SERDANG BEDAGAI,11502,DOLOK MASIHUL,13599,12301,25900
6728,SUMATERA UTARA,11635,BATU BARA,11734,SEI BALAI,6451,7252,13703
6728,SUMATERA UTARA,11247,SAMOSIR,11357,SIMANINDO,479,10367,10846
6728,SUMATERA UTARA,11374,SERDANG BEDAGAI,11553,SERBA JADI,4518,5707,10225
6728,SUMATERA UTARA,11635,BATU BARA,11651,SEI SUKA,13961,12921,26882
6728,SUMATERA UTARA,12208,PADANG LAWAS UTARA,12209,DOLOK SIGOMPULON,5245,2407,7652
6728,SUMATERA UTARA,11374,SERDANG BEDAGAI,11615,BINTANG BAYU,3783,2781,6564
6728,SUMATERA UTARA,12208,PADANG LAWAS UTARA,12464,PADANG BOLAK JULU,3887,1054,4941
6728,SUMATERA UTARA,11374,SERDANG BEDAGAI,11457,BANDAR KHALIFAH,4193,7930,12123
6728,SUMATERA UTARA,11635,BATU BARA,11721,TANJUNG TIRAM,10275,13665,23940
6728,SUMATERA UTARA,11635,BATU BARA,11707,TALAWI,10748,13683,24431
6728,SUMATERA UTARA,11635,BATU BARA,11679,LIMA PULUH,18101,22403,40504
6728,SUMATERA UTARA,11635,BATU BARA,11636,MEDANG DERAS,10611,10600,21211
6728,SUMATERA UTARA,12208,PADANG LAWAS UTARA,12560,SIMANGAMBAT,12475,13490,25965
6728,SUMATERA UTARA,11374,SERDANG BEDAGAI,11481,SIPISPIS,7929,8827,16756
6728,SUMATERA UTARA,11374,SERDANG BEDAGAI,11388,PERBAUNGAN,28203,21630,49833
6728,SUMATERA UTARA,12208,PADANG LAWAS UTARA,12341,HALONGONAN,10677,5694,16371
6728,SUMATERA UTARA,12208,PADANG LAWAS UTARA,12595,HULU SIHAPAS,1693,382,2075
6728,SUMATERA UTARA,12606,PADANG LAWAS,12607,SOSOPAN,3501,1262,4763
6728,SUMATERA UTARA,11635,BATU BARA,11665,AIR PUTIH,11257,12959,24216
6728,SUMATERA UTARA,12606,PADANG LAWAS,12736,LUBUK BARUMUN,6099,1660,7759
6728,SUMATERA UTARA,12208,PADANG LAWAS UTARA,12254,DOLOK,9196,2746,11942
6728,SUMATERA UTARA,12208,PADANG LAWAS UTARA,12527,BATANG ONANG,4184,1640,5824
6728,SUMATERA UTARA,12606,PADANG LAWAS,12809,BARUMUN,15495,4218,19713
6728,SUMATERA UTARA,12606,PADANG LAWAS,83472,SIHAPAS BARUMUN,2188,432,2620
6728,SUMATERA UTARA,12606,PADANG LAWAS,12891,BATANG LUBU SUTAM,4142,1598,5740
6728,SUMATERA UTARA,12606,PADANG LAWAS,12708,HURISTAK,5480,2539,8019
6728,SUMATERA UTARA,12606,PADANG LAWAS,83406,BARUMUN SELATAN,2990,710,3700
6728,SUMATERA UTARA,6729,LABUHANBATU SELATAN,6741,KAMPUNG RAKYAT,12712,14141,26853
6728,SUMATERA UTARA,6729,LABUHANBATU SELATAN,6757,TORGAMBA,17524,29511,47035
6728,SUMATERA UTARA,12208,PADANG LAWAS UTARA,12386,PADANG BOLAK,24707,6380,31087
6728,SUMATERA UTARA,12606,PADANG LAWAS,12630,BARUMUN TENGAH,7043,1296,8339
6728,SUMATERA UTARA,12606,PADANG LAWAS,12793,ULU BARUMUN,4212,1738,5950
6728,SUMATERA UTARA,6729,LABUHANBATU SELATAN,6730,KOTAPINANG,14894,13122,28016
6728,SUMATERA UTARA,6729,LABUHANBATU SELATAN,6772,SUNGAI KANAN,14780,7798,22578
6728,SUMATERA UTARA,12606,PADANG LAWAS,83407,AEK NABARA BARUMUN,4731,939,5670
6728,SUMATERA UTARA,12606,PADANG LAWAS,12851,SOSA,10863,3981,14844
6728,SUMATERA UTARA,12208,PADANG LAWAS UTARA,12488,PORTIBI,10348,1955,12303
6728,SUMATERA UTARA,6789,LABUHANBATU UTARA,6812,KUALUH HILIR,4649,9288,13937
6728,SUMATERA UTARA,12606,PADANG LAWAS,12761,HUTA RAJA TINGGI,10019,8416,18435
6728,SUMATERA UTARA,6729,LABUHANBATU SELATAN,6782,SILANGKITANG,6988,9008,15996
6728,SUMATERA UTARA,6789,LABUHANBATU UTARA,6862,AEK NATAS,7817,7835,15652
6728,SUMATERA UTARA,6789,LABUHANBATU UTARA,6790,KUALUH HULU,11924,21298,33222
6728,SUMATERA UTARA,6789,LABUHANBATU UTARA,6829,MARBAU,11432,9894,21326
6728,SUMATERA UTARA,6888,NIAS UTARA,6983,LAHEWA,1884,6709,8593
6728,SUMATERA UTARA,6789,LABUHANBATU UTARA,6820,AEK KUO,5583,9640,15223
6728,SUMATERA UTARA,6888,NIAS UTARA,6964,TUGALA OYO,202,2890,3092
6728,SUMATERA UTARA,6888,NIAS UTARA,6903,SAWO,639,3293,3932
6728,SUMATERA UTARA,6888,NIAS UTARA,6914,TUHEMBERUA,469,4122,4591
6728,SUMATERA UTARA,6888,NIAS UTARA,7005,LAHEWA TIMUR,421,3031,3452
6728,SUMATERA UTARA,6888,NIAS UTARA,6973,AFULU,1024,3083,4107
6728,SUMATERA UTARA,6789,LABUHANBATU UTARA,6875,KUALUH SELATAN,11146,18706,29852
6728,SUMATERA UTARA,6789,LABUHANBATU UTARA,6804,KUALUH LEIDONG,5008,8122,13130
6728,SUMATERA UTARA,6888,NIAS UTARA,6930,NAMOHALU ESIWA,346,4987,5333
6728,SUMATERA UTARA,6888,NIAS UTARA,6889,LOTU,508,4498,5006
6728,SUMATERA UTARA,11743,KOTA MEDAN,11844,MEDAN LABUHAN,28948,22552,51500
6728,SUMATERA UTARA,6888,NIAS UTARA,6949,ALASA,964,5926,6890
6728,SUMATERA UTARA,11743,KOTA MEDAN,11872,MEDAN BARU,6607,12637,19244
6728,SUMATERA UTARA,6888,NIAS UTARA,6923,SITOLU ORI,523,4696,5219
6728,SUMATERA UTARA,7013,NIAS BARAT,7026,SIROMBU,1121,3396,4517
6728,SUMATERA UTARA,7013,NIAS BARAT,7052,MANDREHE BARAT,243,2714,2957
6728,SUMATERA UTARA,11743,KOTA MEDAN,11897,MEDAN TIMUR,28108,28932,57040
6728,SUMATERA UTARA,7013,NIAS BARAT,7112,LOLOFITU MOI,1197,4315,5512
6728,SUMATERA UTARA,6888,NIAS UTARA,6942,ALASA TALUMUZOI,303,2070,2373
6728,SUMATERA UTARA,11743,KOTA MEDAN,11859,MEDAN MAIMUN,12801,9913,22714
6728,SUMATERA UTARA,11743,KOTA MEDAN,11744,MEDAN KOTA,16439,25773,42212
6728,SUMATERA UTARA,11743,KOTA MEDAN,11818,MEDAN AREA,32862,22676,55538
6728,SUMATERA UTARA,11743,KOTA MEDAN,11831,MEDAN JOHOR,33926,27539,61465
6728,SUMATERA UTARA,7013,NIAS BARAT,7014,LAHOMI,616,4002,4618
6728,SUMATERA UTARA,7013,NIAS BARAT,7099,MANDREHE UTARA,406,3086,3492
6728,SUMATERA UTARA,11743,KOTA MEDAN,11889,MEDAN PETISAH,11954,22355,34309
6728,SUMATERA UTARA,11743,KOTA MEDAN,11779,MEDAN BARAT,19269,20754,40023
6728,SUMATERA UTARA,11743,KOTA MEDAN,11810,MEDAN AMPLAS,33273,20574,53847
6728,SUMATERA UTARA,11743,KOTA MEDAN,11879,MEDAN PERJUANGAN,25497,24598,50095
6728,SUMATERA UTARA,11743,KOTA MEDAN,11909,MEDAN SELAYANG,19764,25578,45342
6728,SUMATERA UTARA,7013,NIAS BARAT,7078,MANDREHE,700,8860,9560
6728,SUMATERA UTARA,11743,KOTA MEDAN,11757,MEDAN SUNGGAL,27470,24877,52347
6728,SUMATERA UTARA,11743,KOTA MEDAN,11866,MEDAN POLONIA,11286,12557,23843
6728,SUMATERA UTARA,11743,KOTA MEDAN,11786,MEDAN DELI,39353,29295,68648
6728,SUMATERA UTARA,11743,KOTA MEDAN,11851,MEDAN TEMBUNG,36652,26457,63109
6728,SUMATERA UTARA,11916,KOTA PEMATANGSIANTAR,11965,SIANTAR SITALASARI,5997,7923,13920
6728,SUMATERA UTARA,11916,KOTA PEMATANGSIANTAR,11917,SIANTAR TIMUR,4159,14493,18652
6728,SUMATERA UTARA,11743,KOTA MEDAN,11772,MEDAN DENAI,38688,28462,67150
6728,SUMATERA UTARA,11743,KOTA MEDAN,11764,MEDAN HELVETIA,33517,35254,68771
6728,SUMATERA UTARA,11743,KOTA MEDAN,11838,MEDAN MARELAN,39648,20964,60612
6728,SUMATERA UTARA,11916,KOTA PEMATANGSIANTAR,11942,SIANTAR SELATAN,1181,8265,9446
6728,SUMATERA UTARA,12000,KOTA TANJUNG BALAI,12020,TELUK NIBUNG,7963,5189,13152
6728,SUMATERA UTARA,11916,KOTA PEMATANGSIANTAR,11971,SIANTAR MARIMBUN,1284,7142,8426
6728,SUMATERA UTARA,11916,KOTA PEMATANGSIANTAR,11949,SIANTAR MARIHAT,1689,8070,9759
6728,SUMATERA UTARA,12000,KOTA TANJUNG BALAI,12026,DATUK BANDAR,6436,6972,13408
6728,SUMATERA UTARA,12000,KOTA TANJUNG BALAI,12014,SEI TUALANG RASO,5044,3642,8686
6728,SUMATERA UTARA,11743,KOTA MEDAN,11793,MEDAN TUNTUNGAN,12319,27223,39542
6728,SUMATERA UTARA,11916,KOTA PEMATANGSIANTAR,11934,SIANTAR UTARA,7902,15791,23693
6728,SUMATERA UTARA,11743,KOTA MEDAN,11803,MEDAN BELAWAN,21862,17425,39287
6728,SUMATERA UTARA,11978,KOTA SIBOLGA,11979,SIBOLGA UTARA,1651,7978,9629
6728,SUMATERA UTARA,11916,KOTA PEMATANGSIANTAR,11925,SIANTAR BARAT,10327,9058,19385
6728,SUMATERA UTARA,11978,KOTA SIBOLGA,11990,SIBOLGA SELATAN,5701,6600,12301
6728,SUMATERA UTARA,11916,KOTA PEMATANGSIANTAR,11957,SIANTAR MARTOBA,7585,12545,20130
6728,SUMATERA UTARA,12038,KOTA BINJAI,12049,BINJAI KOTA,8407,7482,15889
6728,SUMATERA UTARA,12081,KOTA TEBING TINGGI,12106,BAJENIS,8963,7862,16825
6728,SUMATERA UTARA,12081,KOTA TEBING TINGGI,12082,PADANG HULU,8165,6273,14438
6728,SUMATERA UTARA,12122,KOTA PADANG SIDIMPUAN,12123,PADANGSIDIMPUAN UTARA,24148,5833,29981
6728,SUMATERA UTARA,12038,KOTA BINJAI,12072,BINJAI SELATAN,16054,9154,25208
6728,SUMATERA UTARA,11978,KOTA SIBOLGA,11985,SIBOLGA KOTA,3161,3866,7027
6728,SUMATERA UTARA,11978,KOTA SIBOLGA,11995,SIBOLGA SAMBAS,4169,4129,8298
6728,SUMATERA UTARA,12000,KOTA TANJUNG BALAI,12001,TANJUNG BALAI SELATAN,3993,5131,9124
6728,SUMATERA UTARA,12081,KOTA TEBING TINGGI,12098,PADANG HILIR,9204,6888,16092
6728,SUMATERA UTARA,12122,KOTA PADANG SIDIMPUAN,12169,PADANGSIDIMPUAN HUTAIMBARU,6595,1554,8149
6728,SUMATERA UTARA,12000,KOTA TANJUNG BALAI,12008,TANJUNG BALAI UTARA,3523,3551,7074
6728,SUMATERA UTARA,12000,KOTA TANJUNG BALAI,12032,DATUK BANDAR TIMUR,7560,4126,11686
6728,SUMATERA UTARA,12038,KOTA BINJAI,12057,BINJAI BARAT,12530,7522,20052
6728,SUMATERA UTARA,12122,KOTA PADANG SIDIMPUAN,12140,PADANGSIDIMPUAN SELATAN,20957,8884,29841
12920,SUMATERA BARAT,12921,PESISIR SELATAN,12922,PANCUNG SOAL,6917,3211,10128
12920,SUMATERA BARAT,12921,PESISIR SELATAN,13005,IV NAGARI BAYANG UTARA,3711,549,4260
6728,SUMATERA UTARA,12038,KOTA BINJAI,12039,BINJAI UTARA,23149,11275,34424
6728,SUMATERA UTARA,12081,KOTA TEBING TINGGI,12114,TEBING TINGGI KOTA,5861,7338,13199
6728,SUMATERA UTARA,12038,KOTA BINJAI,12064,BINJAI TIMUR,17748,10030,27778
6728,SUMATERA UTARA,12122,KOTA PADANG SIDIMPUAN,12180,PADANGSIDIMPUAN TENGGARA,9769,3925,13694
6728,SUMATERA UTARA,12122,KOTA PADANG SIDIMPUAN,12153,PADANGSIDIMPUAN BATUNADUA,7548,2276,9824
6728,SUMATERA UTARA,12081,KOTA TEBING TINGGI,12090,RAMBUTAN,9399,7137,16536
12920,SUMATERA BARAT,12921,PESISIR SELATAN,12946,BATANG KAPAS,9918,3763,13681
6728,SUMATERA UTARA,7132,KOTA GUNUNGSITOLI,7166,GUNUNGSITOLI SELATAN,535,6019,6554
12920,SUMATERA BARAT,12921,PESISIR SELATAN,12959,BAYANG,16018,3220,19238
6728,SUMATERA UTARA,7132,KOTA GUNUNGSITOLI,7230,GUNUNGSITOLI BARAT,313,3331,3644
12920,SUMATERA BARAT,12921,PESISIR SELATAN,12982,LINGGO SARI BAGANTI,13824,5574,19398
12920,SUMATERA BARAT,12921,PESISIR SELATAN,12996,BASA AMPEK BALAI TAPAN,3384,2180,5564
6728,SUMATERA UTARA,7132,KOTA GUNUNGSITOLI,7182,GUNUNGSITOLI UTARA,1333,6073,7406
12920,SUMATERA BARAT,12921,PESISIR SELATAN,12931,RANAH PESISIR,9987,4188,14175
6728,SUMATERA UTARA,12122,KOTA PADANG SIDIMPUAN,12199,PADANGSIDIMPUAN ANGKOLA JULU,2830,951,3781
12920,SUMATERA BARAT,12921,PESISIR SELATAN,12977,SUTERA,16484,4997,21481
12920,SUMATERA BARAT,12921,PESISIR SELATAN,12952,IV JURAI,17408,5299,22707
6728,SUMATERA UTARA,7132,KOTA GUNUNGSITOLI,7133,GUNUNGSITOLI,6030,20577,26607
12920,SUMATERA BARAT,12921,PESISIR SELATAN,83473,AIRPURA,3805,2483,6288
12920,SUMATERA BARAT,13010,SOLOK,13090,TIGO LURAH,3878,910,4788
6728,SUMATERA UTARA,7132,KOTA GUNUNGSITOLI,7193,GUNUNGSITOLI IDANOI,1153,9868,11021
12920,SUMATERA BARAT,12921,PESISIR SELATAN,83474,RANAH AMPEK HULU TAPAN,4143,1864,6007
12920,SUMATERA BARAT,13010,SOLOK,13030,GUNUNG TALANG,19944,3412,23356
12920,SUMATERA BARAT,13010,SOLOK,13011,PANTAI CERMIN,7142,1409,8551
12920,SUMATERA BARAT,13010,SOLOK,13039,BUKIT SUNDI,9553,1730,11283
12920,SUMATERA BARAT,13010,SOLOK,13096,DANAU KEMBAR,7174,746,7920
12920,SUMATERA BARAT,13010,SOLOK,13083,JUNJUNG SIRI,5220,738,5958
12920,SUMATERA BARAT,13010,SOLOK,13019,PAYUNG SEKAKI,3587,572,4159
12920,SUMATERA BARAT,12921,PESISIR SELATAN,12990,LUNANG,4741,5076,9817
12920,SUMATERA BARAT,12921,PESISIR SELATAN,83475,SILAUT,3708,3568,7276
12920,SUMATERA BARAT,12921,PESISIR SELATAN,12964,KOTO XI TARUSAN,16477,5388,21865
12920,SUMATERA BARAT,13010,SOLOK,13086,HILIRAN GUMANTI,6056,1149,7205
12920,SUMATERA BARAT,12921,PESISIR SELATAN,12936,LENGAYANG,16625,7014,23639
12920,SUMATERA BARAT,13010,SOLOK,13014,LEMBAH GUMANTI,19286,2441,21727
12920,SUMATERA BARAT,13010,SOLOK,13055,KUBUNG,23290,3836,27126
12920,SUMATERA BARAT,13099,SIJUNJUNG,13143,KOTO VII,11768,3037,14805
12920,SUMATERA BARAT,13010,SOLOK,13073,X KOTO DIATAS,7811,1579,9390
12920,SUMATERA BARAT,13099,SIJUNJUNG,13100,TANJUNG GADANG,8787,1879,10666
12920,SUMATERA BARAT,13099,SIJUNJUNG,13118,IV NAGARI,6079,924,7003
12920,SUMATERA BARAT,13010,SOLOK,13045,IX KOTO SEI LASI,4366,911,5277
12920,SUMATERA BARAT,13163,TANAH DATAR,13242,LINTAU BUO UTARA,8652,9698,18350
12920,SUMATERA BARAT,13010,SOLOK,13064,X KOTO SINGKARAK,13797,2730,16527
12920,SUMATERA BARAT,13099,SIJUNJUNG,13108,SIJUNJUNG,16417,4014,20431
12920,SUMATERA BARAT,13010,SOLOK,13023,LEMBANG JAYA,10038,1668,11706
12920,SUMATERA BARAT,13099,SIJUNJUNG,13136,LUBUAK TAROK,4601,2626,7227
12920,SUMATERA BARAT,13163,TANAH DATAR,13195,TANJUNG EMAS,9512,2338,11850
12920,SUMATERA BARAT,13163,TANAH DATAR,13189,LIMA KAUM,15118,3139,18257
12920,SUMATERA BARAT,13163,TANAH DATAR,13205,SUNGAYANG,6180,2312,8492
12920,SUMATERA BARAT,13099,SIJUNJUNG,13158,KUPITAN,4641,1234,5875
12920,SUMATERA BARAT,13099,SIJUNJUNG,13124,KAMANG BARU,14311,6826,21137
12920,SUMATERA BARAT,13099,SIJUNJUNG,13149,SUMPUR KUDUS,7899,3756,11655
12920,SUMATERA BARAT,13163,TANAH DATAR,13211,SUNGAI TARAB,11803,2642,14445
12920,SUMATERA BARAT,13163,TANAH DATAR,13200,LINTAU BUO,5338,3689,9027
12920,SUMATERA BARAT,13163,TANAH DATAR,13239,TANJUANG BARU,5799,948,6747
12920,SUMATERA BARAT,13163,TANAH DATAR,13164,X KOTO,14816,3437,18253
12920,SUMATERA BARAT,13163,TANAH DATAR,13229,SALIMPAUANG,8057,1692,9749
12920,SUMATERA BARAT,13163,TANAH DATAR,13222,PARIANGAN,7683,1711,9394
12920,SUMATERA BARAT,13253,PADANG PARIAMAN,13308,PATAMUAN,5676,1688,7364
12920,SUMATERA BARAT,13163,TANAH DATAR,13248,BATIPUAH SELATAN,5057,822,5879
12920,SUMATERA BARAT,13253,PADANG PARIAMAN,13287,ULAKAN TAPAKIH,6696,1771,8467
12920,SUMATERA BARAT,13253,PADANG PARIAMAN,13276,V KOTO KAMPUNG DALAM,8863,1924,10787
12920,SUMATERA BARAT,13253,PADANG PARIAMAN,13254,LUBUK ALUNG,14807,3443,18250
12920,SUMATERA BARAT,13253,PADANG PARIAMAN,13290,SINTUAK TOBOH GADANG,6880,1660,8540
12920,SUMATERA BARAT,13163,TANAH DATAR,13236,PADANG GANTING,4988,2093,7081
12920,SUMATERA BARAT,13163,TANAH DATAR,13183,RAMBATAN,13817,2801,16618
12920,SUMATERA BARAT,13253,PADANG PARIAMAN,13260,NAN SABARIS,10825,2050,12875
12920,SUMATERA BARAT,13253,PADANG PARIAMAN,13297,BATANG GASAN,4503,811,5314
12920,SUMATERA BARAT,13317,AGAM,13318,TANJUNG MUTIARA,0,0,0
12920,SUMATERA BARAT,13163,TANAH DATAR,13174,BATIPUH,10613,2865,13478
12920,SUMATERA BARAT,13253,PADANG PARIAMAN,13271,VII KOTO SUNGAI SARIK,11635,4194,15829
12920,SUMATERA BARAT,13253,PADANG PARIAMAN,13266,2 X 11 KAYU TANAM,8807,2678,11485
12920,SUMATERA BARAT,13253,PADANG PARIAMAN,13285,IV KOTO AUR MALINTANG,6398,1674,8072
12920,SUMATERA BARAT,13253,PADANG PARIAMAN,13304,2 X 11 ENAM LINGKUNG,5922,2390,8312
12920,SUMATERA BARAT,13317,AGAM,13376,TILATANG KAMANG,14173,2953,17126
12920,SUMATERA BARAT,13253,PADANG PARIAMAN,13311,ENAM LINGKUNG,7414,1835,9249
12920,SUMATERA BARAT,13253,PADANG PARIAMAN,13256,BATANG ANAI,14936,3786,18722
12920,SUMATERA BARAT,13253,PADANG PARIAMAN,13279,SUNGAI GARINGGING,8524,3051,11575
12920,SUMATERA BARAT,13253,PADANG PARIAMAN,13293,PADANG SAGO,3017,1001,4018
12920,SUMATERA BARAT,13253,PADANG PARIAMAN,13300,V KOTO TIMUR,5615,1130,6745
12920,SUMATERA BARAT,13253,PADANG PARIAMAN,13282,SUNGAI LIMAU,10420,2269,12689
12920,SUMATERA BARAT,13317,AGAM,13407,KAMANG MAGEK,9425,1691,11116
12920,SUMATERA BARAT,13317,AGAM,13353,BANUHAMPU,14317,2522,16839
12920,SUMATERA BARAT,13317,AGAM,13369,BASO,12864,2871,15735
12920,SUMATERA BARAT,13317,AGAM,13392,SUNGAI PUA,9093,1753,10846
12920,SUMATERA BARAT,13317,AGAM,13322,LUBUK BASUNG,23529,6334,29863
12920,SUMATERA BARAT,13317,AGAM,13380,PALUPUH,5158,1242,6400
12920,SUMATERA BARAT,13416,LIMA PULUH KOTA,13483,SITUJUAH LIMO NAGARI,8640,2074,10714
12920,SUMATERA BARAT,13416,LIMA PULUH KOTA,13474,LAREH SAGO HALABAN,14331,4617,18948
12920,SUMATERA BARAT,13416,LIMA PULUH KOTA,13470,GUNUANG OMEH,4834,1426,6260
12920,SUMATERA BARAT,13317,AGAM,13398,AMPEK NAGARI,8612,2306,10918
12920,SUMATERA BARAT,13317,AGAM,13403,CANDUNG,8670,1787,10457
12920,SUMATERA BARAT,13317,AGAM,13345,IV KOTO,9894,1639,11533
12920,SUMATERA BARAT,13317,AGAM,13361,IV ANGKAT CANDUNG,15606,3746,19352
12920,SUMATERA BARAT,13317,AGAM,13385,PELEMBAYAN,11355,2205,13560
12920,SUMATERA BARAT,13416,LIMA PULUH KOTA,13495,BUKIK BARISAN,9332,1789,11121
12920,SUMATERA BARAT,13416,LIMA PULUH KOTA,13443,HARAU,17964,4949,22913
12920,SUMATERA BARAT,13416,LIMA PULUH KOTA,13438,LUAK,11062,2388,13450
12920,SUMATERA BARAT,13317,AGAM,13328,TANJUNG RAYA,13017,2843,15860
12920,SUMATERA BARAT,13416,LIMA PULUH KOTA,13417,SULIKI,5588,1711,7299
12920,SUMATERA BARAT,13317,AGAM,13338,MATUR,7477,1340,8817
12920,SUMATERA BARAT,13416,LIMA PULUH KOTA,13430,PAYAKUMBUH,12815,2761,15576
12920,SUMATERA BARAT,13509,PASAMAN,13541,SIMPANG ALAHAN MATI,3971,661,4632
12920,SUMATERA BARAT,13509,PASAMAN,13544,PADANG GELUGUR,10148,2766,12914
12920,SUMATERA BARAT,13416,LIMA PULUH KOTA,13424,GUGUAK,13440,4045,17485
12920,SUMATERA BARAT,13317,AGAM,13411,MALALAK,3628,613,4241
12920,SUMATERA BARAT,13509,PASAMAN,13528,DUO KOTO,7767,3060,10827
12920,SUMATERA BARAT,13416,LIMA PULUH KOTA,13455,PANGKALAN KOTO BARU,10502,2272,12774
12920,SUMATERA BARAT,13554,KEPULAUAN MENTAWAI,13599,SIKAKAP,0,0,0
12920,SUMATERA BARAT,13416,LIMA PULUH KOTA,13489,MUNGKA,9650,2084,11734
12920,SUMATERA BARAT,13509,PASAMAN,13531,TIGO NAGARI,7644,1702,9346
12920,SUMATERA BARAT,13416,LIMA PULUH KOTA,13462,KAPUR IX,8460,2862,11322
12920,SUMATERA BARAT,13416,LIMA PULUH KOTA,13501,AKABILURU,10465,1721,12186
12920,SUMATERA BARAT,13554,KEPULAUAN MENTAWAI,13592,SIPORA UTARA,0,0,0
12920,SUMATERA BARAT,13509,PASAMAN,13535,RAO,7961,3385,11346
12920,SUMATERA BARAT,13554,KEPULAUAN MENTAWAI,13555,PAGAI UTARA,0,0,0
12920,SUMATERA BARAT,13554,KEPULAUAN MENTAWAI,13588,SIBERUT TENGAH,0,0,0
12920,SUMATERA BARAT,13509,PASAMAN,13510,BONJOL,8207,1880,10087
12920,SUMATERA BARAT,13509,PASAMAN,13546,RAO UTARA,4623,1040,5663
12920,SUMATERA BARAT,13608,DHARMASRAYA,83414,PADANG LAWEH,1983,1169,3152
12920,SUMATERA BARAT,13608,DHARMASRAYA,83413,TIUMANG,3588,3345,6933
12920,SUMATERA BARAT,13509,PASAMAN,13538,MAPAT TUNGGUL SELATAN,3120,1120,4240
12920,SUMATERA BARAT,13509,PASAMAN,13550,RAO SELATAN,8978,2319,11297
12920,SUMATERA BARAT,13554,KEPULAUAN MENTAWAI,13567,SIBERUT SELATAN,0,0,0
12920,SUMATERA BARAT,13509,PASAMAN,13522,PANTI,9871,3635,13506
12920,SUMATERA BARAT,13509,PASAMAN,13524,MAPAT TUNGGUL,2915,1845,4760
12920,SUMATERA BARAT,13608,DHARMASRAYA,13630,SITIUNG,9578,3881,13459
12920,SUMATERA BARAT,13509,PASAMAN,13515,LUBUK SIKAPING,19038,3231,22269
12920,SUMATERA BARAT,13608,DHARMASRAYA,83412,KOTO SALAK,5324,4371,9695
12920,SUMATERA BARAT,13554,KEPULAUAN MENTAWAI,13580,SIBERUT BARAT,0,0,0
12920,SUMATERA BARAT,13608,DHARMASRAYA,13623,SUNGAI RUMBAI,5003,4837,9840
12920,SUMATERA BARAT,13554,KEPULAUAN MENTAWAI,13584,SIBERUT BARAT DAYA,0,0,0
12920,SUMATERA BARAT,13554,KEPULAUAN MENTAWAI,13573,SIBERUT UTARA,0,0,0
12920,SUMATERA BARAT,13634,SOLOK SELATAN,13635,SANGIR,13722,4466,18188
12920,SUMATERA BARAT,13554,KEPULAUAN MENTAWAI,13603,PAGAI SELATAN,0,0,0
12920,SUMATERA BARAT,13608,DHARMASRAYA,13609,KOTO BARU,11072,4531,15603
12920,SUMATERA BARAT,13681,PASAMAN BARAT,13682,SUNGAI BEREMAS,7121,1775,8896
12920,SUMATERA BARAT,13608,DHARMASRAYA,83416,KOTO BESAR,7452,4523,11975
12920,SUMATERA BARAT,13554,KEPULAUAN MENTAWAI,13559,SIPORA SELATAN,0,0,0
12920,SUMATERA BARAT,13681,PASAMAN BARAT,13705,SUNGAI AUA,10071,4072,14143
12920,SUMATERA BARAT,13608,DHARMASRAYA,83411,TIMPEH,4678,3173,7851
12920,SUMATERA BARAT,13608,DHARMASRAYA,83415,ASAM JUJUHAN,4257,1595,5852
12920,SUMATERA BARAT,13634,SOLOK SELATAN,13652,KOTO PARIK GADANG DIATEH,7881,2064,9945
12920,SUMATERA BARAT,13634,SOLOK SELATAN,13671,PAUH DUO,6413,1616,8029
12920,SUMATERA BARAT,13608,DHARMASRAYA,13617,PULAU PUNJUNG,14604,4167,18771
12920,SUMATERA BARAT,13634,SOLOK SELATAN,13657,SANGIR JUJUAN,5340,1078,6418
12920,SUMATERA BARAT,13681,PASAMAN BARAT,13707,LUHAK NAN DUO,13729,5522,19251
12920,SUMATERA BARAT,13681,PASAMAN BARAT,13700,RANAH BATAHAN,9098,3287,12385
12920,SUMATERA BARAT,13608,DHARMASRAYA,83410,SEMBILAN KOTO,2602,1145,3747
12920,SUMATERA BARAT,13634,SOLOK SELATAN,13640,SUNGAI PAGU,11577,2697,14274
12920,SUMATERA BARAT,13681,PASAMAN BARAT,13686,PASAMAN,23134,5883,29017
12920,SUMATERA BARAT,13712,KOTA PADANG,13797,KURANJI,49937,9780,59717
12920,SUMATERA BARAT,13681,PASAMAN BARAT,13697,GUNUNG TULEH,0,0,0
12920,SUMATERA BARAT,13712,KOTA PADANG,13756,BUNGUS TELUK KABUNG,8788,1516,10304
12920,SUMATERA BARAT,13681,PASAMAN BARAT,13710,SASAK RANAH PESISIA,4940,1703,6643
12920,SUMATERA BARAT,13681,PASAMAN BARAT,13694,KINALI,20039,8905,28944
12920,SUMATERA BARAT,13634,SOLOK SELATAN,13676,SANGIR BALAI JANGGO,6212,2771,8983
12920,SUMATERA BARAT,13681,PASAMAN BARAT,13690,TALAMAU,11156,1890,13046
12920,SUMATERA BARAT,13634,SOLOK SELATAN,13663,SANGIR BATANG HARI,4920,2411,7331
12920,SUMATERA BARAT,13828,KOTA SOLOK,13837,TANJUNG HARAPAN,11256,2426,13682
12920,SUMATERA BARAT,13828,KOTA SOLOK,13829,LUBUK SIKARAH,14393,2644,17037
12920,SUMATERA BARAT,13886,KOTA PADANG PANJANG,13887,PADANG PANJANG TIMUR,7967,1786,9753
12920,SUMATERA BARAT,13712,KOTA PADANG,13787,PAUH,22107,4039,26146
12920,SUMATERA BARAT,13681,PASAMAN BARAT,13703,KOTO BALINGKA,8334,3546,11880
12920,SUMATERA BARAT,13681,PASAMAN BARAT,13684,LEMBAH MELINTANG,14078,3312,17390
12920,SUMATERA BARAT,13712,KOTA PADANG,13713,PADANG SELATAN,18798,9241,28039
12920,SUMATERA BARAT,13712,KOTA PADANG,13779,LUBUK KILANGAN,18849,4298,23147
12920,SUMATERA BARAT,13712,KOTA PADANG,13737,PADANG BARAT,14282,8106,22388
12920,SUMATERA BARAT,13712,KOTA PADANG,13726,PADANG TIMUR,29436,7665,37101
12920,SUMATERA BARAT,13712,KOTA PADANG,13814,KOTO TANGAH,59982,17433,77415
12920,SUMATERA BARAT,13844,KOTA SAWAHLUNTO,13845,LEMBAH SEGAR,5128,1387,6515
12920,SUMATERA BARAT,13886,KOTA PADANG PANJANG,13896,PADANG PANJANG BARAT,10980,2616,13596
12920,SUMATERA BARAT,13712,KOTA PADANG,13748,PADANG UTARA,20697,5443,26140
12920,SUMATERA BARAT,13933,KOTA PAYAKUMBUH,83418,PAYAKUMBUH SELATAN,4221,884,5105
12920,SUMATERA BARAT,13844,KOTA SAWAHLUNTO,13874,TALAWI,7466,2165,9631
12920,SUMATERA BARAT,13712,KOTA PADANG,13807,NANGGALO,21193,5640,26833
12920,SUMATERA BARAT,13712,KOTA PADANG,13763,LUBUK BEGALUNG,40781,10537,51318
12920,SUMATERA BARAT,13844,KOTA SAWAHLUNTO,13857,BARANGIN,7000,2017,9017
14086,RIAU,14166,KAMPAR,14167,BANGKINANG,13629,3037,16666
12920,SUMATERA BARAT,13933,KOTA PAYAKUMBUH,13995,PAYAKUMBUH TIMUR,9517,2883,12400
12920,SUMATERA BARAT,13905,KOTA BUKITTINGGI,13924,AUR BIRUGO TIGO BALEH,9145,1894,11039
12920,SUMATERA BARAT,13905,KOTA BUKITTINGGI,13906,GUGUAK PANJANG,14470,3681,18151
12920,SUMATERA BARAT,13933,KOTA PAYAKUMBUH,83417,LAMPOSI TIGO NAGORI,3908,796,4704
12920,SUMATERA BARAT,14010,KOTA PARIAMAN,14034,PARIAMAN UTARA,7904,1652,9556
14086,RIAU,14166,KAMPAR,14344,SALO,7392,2835,10227
14086,RIAU,14166,KAMPAR,14358,BANGKINANG SEBERANG,11190,4604,15794
14086,RIAU,14166,KAMPAR,14351,RUMBIO JAYA,6378,1933,8311
14086,RIAU,14166,KAMPAR,14368,PERHENTIAN RAJA,4377,3512,7889
12920,SUMATERA BARAT,13844,KOTA SAWAHLUNTO,13868,SILUNGKANG,3880,1097,4977
14086,RIAU,14166,KAMPAR,14313,TAPUNG HILIR,11596,14887,26483
12920,SUMATERA BARAT,13933,KOTA PAYAKUMBUH,13934,PAYAKUMBUH BARAT,17746,4672,22418
14086,RIAU,14166,KAMPAR,14330,TAPUNG HULU,13569,23052,36621
12920,SUMATERA BARAT,14010,KOTA PARIAMAN,14011,PARIAMAN TENGAH,12517,2697,15214
14086,RIAU,14166,KAMPAR,14221,SIAK HULU,26069,15156,41225
12920,SUMATERA BARAT,14010,KOTA PARIAMAN,14052,PARIAMAN SELATAN,6952,1198,8150
14086,RIAU,14166,KAMPAR,14388,KAMPAR KIRI TENGAH,6778,7583,14361
12920,SUMATERA BARAT,14010,KOTA PARIAMAN,14069,PARIAMAN TIMUR,6606,1123,7729
14086,RIAU,14166,KAMPAR,14200,XIII KOTO KAMPAR,7865,3407,11272
12920,SUMATERA BARAT,13933,KOTA PAYAKUMBUH,13966,PAYAKUMBUH UTARA,11739,2515,14254
14086,RIAU,14166,KAMPAR,14214,KUOK,8927,2144,11071
14086,RIAU,14166,KAMPAR,14400,GUNUNG SAHILAN,3496,5186,8682
14086,RIAU,14166,KAMPAR,14172,KAMPAR,21187,3084,24271
14086,RIAU,14166,KAMPAR,14185,TAMBANG,24850,7197,32047
14086,RIAU,14166,KAMPAR,14373,KAMPAR TIMUR,9819,2174,11993
14086,RIAU,14166,KAMPAR,14380,KAMPAR UTARA,8313,1015,9328
14086,RIAU,14166,KAMPAR,14251,KAMPAR KIRI HILIR,2927,2378,5305
14086,RIAU,14414,INDRAGIRI HULU,14576,SUNGAI LALA,2980,3760,6740
14086,RIAU,14414,INDRAGIRI HULU,14536,BATANG GANGSAL,2930,8765,11695
14086,RIAU,14166,KAMPAR,14407,KOTO KAMPAR HULU,6013,3739,9752
14086,RIAU,14166,KAMPAR,14288,TAPUNG,20749,21824,42573
14086,RIAU,14414,INDRAGIRI HULU,14415,RENGAT,13895,7258,21153
14086,RIAU,14414,INDRAGIRI HULU,14589,LUBUK BATU JAYA,4383,6048,10431
14086,RIAU,14166,KAMPAR,14266,KAMPAR KIRI HULU,3018,2676,5694
14086,RIAU,14166,KAMPAR,14234,KAMPAR KIRI,6538,6706,13244
14086,RIAU,14414,INDRAGIRI HULU,14599,RAKIT KULIM,2964,5331,8295
14086,RIAU,14414,INDRAGIRI HULU,14565,KUALA CENAKU,3081,2684,5765
14086,RIAU,14630,BENGKALIS,14662,BUKIT BATU,7195,8878,16073
14086,RIAU,14414,INDRAGIRI HULU,14547,LIRIK,4756,6406,11162
14086,RIAU,14414,INDRAGIRI HULU,14619,BATANG PERANAP,1451,3724,5175
14086,RIAU,14414,INDRAGIRI HULU,14515,BATANG CENAKU,6179,10963,17142
14086,RIAU,14414,INDRAGIRI HULU,14503,SIBERIDA,9303,12380,21683
14086,RIAU,14630,BENGKALIS,14631,BENGKALIS,16789,19492,36281
14086,RIAU,14414,INDRAGIRI HULU,14434,RENGAT BARAT,10154,10050,20204
14086,RIAU,14414,INDRAGIRI HULU,14453,KELAYANG,5024,6316,11340
14086,RIAU,14414,INDRAGIRI HULU,14472,PASIR PENYU,7817,6499,14316
14086,RIAU,14414,INDRAGIRI HULU,14490,PERANAP,5137,7276,12413
14086,RIAU,14630,BENGKALIS,14652,BANTAN,6261,12783,19044
14086,RIAU,14630,BENGKALIS,14678,MANDAU,62864,48405,111269
14086,RIAU,14741,INDRAGIRI HILIR,14835,TANAH MERAH,4265,6252,10517
14086,RIAU,14741,INDRAGIRI HILIR,14858,GAUNG,3890,10251,14141
14086,RIAU,14741,INDRAGIRI HILIR,14902,TELUK BELENGKONG,1831,4209,6040
14086,RIAU,14741,INDRAGIRI HILIR,14742,RETEH,6818,11872,18690
14086,RIAU,14741,INDRAGIRI HILIR,14870,TEMBILAHAN HULU,8262,9519,17781
14086,RIAU,14741,INDRAGIRI HILIR,14782,TEMPULING,6121,7074,13195
14086,RIAU,14630,BENGKALIS,14727,PINGGIR,12781,29362,42143
14086,RIAU,14741,INDRAGIRI HILIR,14799,MANDAH,6031,9066,15097
14086,RIAU,14741,INDRAGIRI HILIR,14887,PELANGIRAN,7530,10750,18280
14086,RIAU,14630,BENGKALIS,14694,RUPAT,4639,10921,15560
14086,RIAU,14741,INDRAGIRI HILIR,14916,PULAU BURUNG,3662,6237,9899
14086,RIAU,14741,INDRAGIRI HILIR,14766,KUALA INDRAGIRI,2120,3762,5882
14086,RIAU,14741,INDRAGIRI HILIR,14875,KEMUNING,5547,9778,15325
14086,RIAU,14955,PELALAWAN,14956,UKUI,6226,11287,17513
14086,RIAU,14630,BENGKALIS,14707,RUPAT UTARA,2010,4412,6422
14086,RIAU,14741,INDRAGIRI HILIR,14846,BATANG TUAKA,5321,4658,9979
14086,RIAU,14630,BENGKALIS,14713,SIAK KECIL,4122,6616,10738
14086,RIAU,14741,INDRAGIRI HILIR,14932,CONCONG,1902,2585,4487
14086,RIAU,14741,INDRAGIRI HILIR,14753,ENOK,5876,9762,15638
14086,RIAU,14741,INDRAGIRI HILIR,14939,KEMPAS,7234,9230,16464
14086,RIAU,14741,INDRAGIRI HILIR,14812,KATEMAN,6148,11228,17376
14086,RIAU,15087,ROKAN HULU,15088,UJUNG BATU,10220,8410,18630
14086,RIAU,14955,PELALAWAN,14977,PANGKALAN KURAS,9447,13425,22872
14086,RIAU,14955,PELALAWAN,15068,BANDAR SEI KIJANG,3431,4035,7466
14086,RIAU,14741,INDRAGIRI HILIR,14821,KERITANG,8712,19039,27751
14086,RIAU,14741,INDRAGIRI HILIR,14790,GAUNG ANAK SERKA,3727,5167,8894
14086,RIAU,14955,PELALAWAN,15057,KUALA KAMPAR,2199,5971,8170
14086,RIAU,14741,INDRAGIRI HILIR,14775,TEMBILAHAN,16782,15154,31936
14086,RIAU,14955,PELALAWAN,14968,PANGKALAN KERINCI,18025,15584,33609
14086,RIAU,14955,PELALAWAN,15036,BUNUT,2619,3288,5907
14086,RIAU,14955,PELALAWAN,15074,BANDAR PETALANGAN,3584,4257,7841
14086,RIAU,15087,ROKAN HULU,15203,BANGUN PURBA,4772,4503,9275
14086,RIAU,14955,PELALAWAN,15006,LANGGAM,4440,6402,10842
14086,RIAU,15087,ROKAN HULU,15228,BONAI DARUSSALAM,4331,7374,11705
14086,RIAU,15087,ROKAN HULU,15211,TANDUN,6095,7593,13688
14086,RIAU,14741,INDRAGIRI HILIR,14948,SUNGAI BATANG,1866,3041,4907
14086,RIAU,14955,PELALAWAN,15047,TELUK MERANTI,2956,4559,7515
14086,RIAU,15087,ROKAN HULU,15221,KABUN,5662,6036,11698
14086,RIAU,14955,PELALAWAN,15025,KERUMUTAN,6079,5294,11373
14086,RIAU,14955,PELALAWAN,15015,PELALAWAN,2747,3972,6719
14086,RIAU,15087,ROKAN HULU,15124,TAMBUSAI,9690,15701,25391
14086,RIAU,15087,ROKAN HULU,15248,PENDALIAN IV KOTO,3029,3031,6060
14086,RIAU,14955,PELALAWAN,14995,PANGKALAN LESUNG,5190,7422,12612
14086,RIAU,15087,ROKAN HULU,15242,KEPENUHAN HULU,4936,3645,8581
14086,RIAU,15087,ROKAN HULU,15109,RAMBAH,16335,5770,22105
14086,RIAU,15254,ROKAN HILIR,15390,BATU HAMPAR,1519,2243,3762
14086,RIAU,15087,ROKAN HULU,15236,PAGARAN TAPAH DARUSSALAM,2472,2610,5082
14086,RIAU,15087,ROKAN HULU,15162,RAMBAH SAMO,8552,7015,15567
14086,RIAU,15254,ROKAN HILIR,15383,SIMPANG KANAN,5009,7837,12846
14086,RIAU,15087,ROKAN HULU,15148,KUNTO DARUSSALAM,9138,9687,18825
14086,RIAU,15254,ROKAN HILIR,15396,RANTAU KOPAR,1853,1322,3175
14086,RIAU,15087,ROKAN HULU,15191,TAMBUSAI UTARA,10511,27182,37693
14086,RIAU,15254,ROKAN HILIR,15345,SINABOI,2307,4039,6346
14086,RIAU,15087,ROKAN HULU,15177,RAMBAH HILIR,10506,9196,19702
14086,RIAU,15254,ROKAN HILIR,15314,BAGAN SINEMBAH,28025,36760,64785
14086,RIAU,15254,ROKAN HILIR,15255,KUBU,3811,6624,10435
14086,RIAU,15087,ROKAN HULU,15137,KEPENUHAN,6899,3528,10427
14086,RIAU,15254,ROKAN HILIR,15369,BANGKO PUSAKO,8998,17643,26641
14086,RIAU,15254,ROKAN HILIR,15338,PASIR LIMAU KAPAS,4920,10135,15055
14086,RIAU,15087,ROKAN HULU,15094,ROKAN IV KOTO,6808,4731,11539
14086,RIAU,15254,ROKAN HILIR,83476,KUBU BABUSSALAM,3401,6403,9804
14086,RIAU,15412,SIAK,15521,LUBUK DALAM,3304,5382,8686
14086,RIAU,15254,ROKAN HILIR,15350,PUJUD,11948,22239,34187
14086,RIAU,15254,ROKAN HILIR,15401,PEKAITAN,1990,6877,8867
14086,RIAU,15254,ROKAN HILIR,15287,TANAH PUTIH,11955,14995,26950
14086,RIAU,15254,ROKAN HILIR,15363,TANAH PUTIH TANJUNG MELAWAN,3084,3173,6257
14086,RIAU,15412,SIAK,15453,SUNGAI MANDAU,2029,1366,3395
14086,RIAU,15412,SIAK,15537,MEMPURA,4380,2374,6754
14086,RIAU,15254,ROKAN HILIR,15271,BANGKO,19000,18967,37967
14086,RIAU,15254,ROKAN HILIR,15301,RIMBA MELINTANG,6396,10380,16776
14086,RIAU,15412,SIAK,15499,KOTO GASIB,4646,3688,8334
14086,RIAU,15553,KUANTAN SINGINGI,83477,KUANTAN HILIR SEBERANG,2058,4193,6251
14086,RIAU,15412,SIAK,15413,SIAK,6738,4063,10801
14086,RIAU,15412,SIAK,15510,KANDIS,9204,18538,27742
14086,RIAU,15412,SIAK,15438,MINAS,5636,5502,11138
14086,RIAU,15553,KUANTAN SINGINGI,15737,LOGAS TANAH DARAT,4216,6376,10592
14086,RIAU,15412,SIAK,15528,SABAK AUH,2828,2668,5496
14086,RIAU,15553,KUANTAN SINGINGI,15709,SINGINGI HILIR,7107,10333,17440
14086,RIAU,15412,SIAK,15444,TUALANG,27533,17667,45200
14086,RIAU,15412,SIAK,15463,DAYUN,5753,7306,13059
14086,RIAU,15553,KUANTAN SINGINGI,15695,GUNUNGTOAR,4098,2314,6412
14086,RIAU,15553,KUANTAN SINGINGI,15554,KUANTAN MUDIK,6920,4427,11347
14086,RIAU,15412,SIAK,15475,KERINCI KANAN,4978,6490,11468
14086,RIAU,15412,SIAK,15422,SUNGAI APIT,5613,7568,13181
14086,RIAU,15553,KUANTAN SINGINGI,15612,SINGINGI,6743,7972,14715
14086,RIAU,15412,SIAK,15488,BUNGA RAYA,5464,6569,12033
14086,RIAU,15553,KUANTAN SINGINGI,83479,PUCUK RANTAU,1783,2715,4498
14086,RIAU,15412,SIAK,15545,PUSAKO,1768,1188,2956
14086,RIAU,15553,KUANTAN SINGINGI,15763,HULU KUANTAN,1913,1913,3826
14086,RIAU,14087,KEPULAUAN MERANTI,83483,RANGSANG PESISIR,2067,5108,7175
14086,RIAU,15553,KUANTAN SINGINGI,15668,BENAI,4613,3492,8105
14086,RIAU,15553,KUANTAN SINGINGI,15722,PANGEAN,4788,4219,9007
14086,RIAU,14087,KEPULAUAN MERANTI,14121,RANGSANG,2581,6100,8681
14086,RIAU,15553,KUANTAN SINGINGI,83478,SENTAJO RAYA,7298,7780,15078
14086,RIAU,14087,KEPULAUAN MERANTI,83481,TEBING TINGGI TIMUR,1589,4186,5775
14086,RIAU,15553,KUANTAN SINGINGI,15751,INUMAN,2407,4376,6783
14086,RIAU,15775,KOTA PEKANBARU,15776,SUKAJADI,14226,6524,20750
14086,RIAU,15553,KUANTAN SINGINGI,15655,CERENTI,3551,3203,6754
14086,RIAU,14087,KEPULAUAN MERANTI,14144,MERBAU,2319,4747,7066
14086,RIAU,15775,KOTA PEKANBARU,15829,TENAYAN RAYA,35014,20133,55147
14086,RIAU,14087,KEPULAUAN MERANTI,83480,PULAUMERBAU,1839,4562,6401
14086,RIAU,15553,KUANTAN SINGINGI,15626,KUANTAN HILIR,3500,3617,7117
14086,RIAU,14087,KEPULAUAN MERANTI,14105,RANGSANG BARAT,3045,5253,8298
14086,RIAU,15775,KOTA PEKANBARU,15813,BUKIT RAYA,30135,10460,40595
14086,RIAU,14087,KEPULAUAN MERANTI,14135,TEBING TINGGI BARAT,2888,4905,7793
14086,RIAU,15775,KOTA PEKANBARU,15784,PEKANBARU KOTA,8588,2758,11346
14086,RIAU,15775,KOTA PEKANBARU,15839,RUMBAI PESISIR,24020,8242,32262
14086,RIAU,15553,KUANTAN SINGINGI,15585,KUANTAN TENGAH,13599,9329,22928
14086,RIAU,14087,KEPULAUAN MERANTI,14088,TEBING TINGGI,11280,14905,26185
14086,RIAU,15775,KOTA PEKANBARU,15795,LIMA PULUH,10507,9741,20248
14086,RIAU,15846,KOTA DUMAI,15880,MEDANG KAMPAI,2160,2569,4729
14086,RIAU,14087,KEPULAUAN MERANTI,83482,TASIK PUTRI PUYU,2003,5523,7526
14086,RIAU,15846,KOTA DUMAI,83422,DUMAI SELATAN,12695,9708,22403
14086,RIAU,15775,KOTA PEKANBARU,15823,MARPOYAN DAMAI,37088,15061,52149
14086,RIAU,15846,KOTA DUMAI,15874,SUNGAI SEMBILAN,3944,10744,14688
14086,RIAU,15775,KOTA PEKANBARU,15800,SENAPELAN,10511,6906,17417
14086,RIAU,15846,KOTA DUMAI,15858,DUMAI TIMUR,12643,13952,26595
14086,RIAU,15775,KOTA PEKANBARU,15818,TAMPAN,46591,16585,63176
15885,JAMBI,15961,KERINCI,16128,GUNUNG TUJUH,4804,2826,7630
15885,JAMBI,15961,KERINCI,83423,BUKITKERMAN,5591,1449,7040
14086,RIAU,15775,KOTA PEKANBARU,15834,PAYUNG SEKAKI,21464,18553,40017
14086,RIAU,15775,KOTA PEKANBARU,15791,SAIL,7270,2552,9822
14086,RIAU,15846,KOTA DUMAI,15847,DUMAI BARAT,8634,8526,17160
14086,RIAU,15846,KOTA DUMAI,83421,DUMAI KOTA,10345,9291,19636
15885,JAMBI,15961,KERINCI,16140,SIULAK,9457,3211,12668
14086,RIAU,15775,KOTA PEKANBARU,15807,RUMBAI,16179,11664,27843
15885,JAMBI,15961,KERINCI,16168,DEPATI TUJUH,9411,1087,10498
15885,JAMBI,15961,KERINCI,16033,GUNUNG KERINCI,5439,1921,7360
15885,JAMBI,15961,KERINCI,16081,KAYU ARO,6688,5817,12505
15885,JAMBI,15961,KERINCI,15962,GUNUNG RAYA,3254,1511,4765
15885,JAMBI,15961,KERINCI,83869,SIULAK MUKAI,1703,4138,5841
14086,RIAU,15846,KOTA DUMAI,15868,BUKIT KAPUR,7090,10694,17784
15885,JAMBI,15961,KERINCI,83484,AIR HANGAT BARAT,5517,1260,6777
15885,JAMBI,16183,MERANGIN,16184,JANGKAT,3823,2325,6148
15885,JAMBI,16183,MERANGIN,16353,PANGKALAN JAMBU,2766,1141,3907
15885,JAMBI,16183,MERANGIN,16335,TABIR TIMUR,1467,3009,4476
15885,JAMBI,15961,KERINCI,16010,AIR HANGAT,7685,1189,8874
15885,JAMBI,15961,KERINCI,83870,KAYU ARO BARAT,7380,5302,12682
15885,JAMBI,15961,KERINCI,15979,DANAU KERINCI,6905,1588,8493
15885,JAMBI,16183,MERANGIN,16327,TABIR ILIR,1901,3670,5571
15885,JAMBI,15961,KERINCI,16111,AIR HANGAT TIMUR,9624,1622,11246
15885,JAMBI,15961,KERINCI,16060,KELILING DANAU,11353,2450,13803
15885,JAMBI,15961,KERINCI,16045,BATANG MERANGIN,2744,1946,4690
15885,JAMBI,16183,MERANGIN,16362,SUNGAI TENANG,3572,1763,5335
15885,JAMBI,16183,MERANGIN,16340,RENAH PEMBARAP,4952,2115,7067
15885,JAMBI,15961,KERINCI,15994,SITINJAU LAUT,7094,1363,8457
15885,JAMBI,16183,MERANGIN,16375,RENAH PAMENANG,3617,4819,8436
15885,JAMBI,16183,MERANGIN,16318,PAMENANG BARAT,3843,5362,9205
15885,JAMBI,16183,MERANGIN,16307,BATANG MASUMAI,3954,1444,5398
15885,JAMBI,16183,MERANGIN,16398,TABIR BARAT,3337,2746,6083
15885,JAMBI,16183,MERANGIN,16234,TABIR,7757,7323,15080
15885,JAMBI,16183,MERANGIN,16380,PAMENANG SELATAN,2785,2787,5572
15885,JAMBI,16183,MERANGIN,16223,SUNGAI MANAU,4176,1322,5498
15885,JAMBI,16183,MERANGIN,16392,TABIR LINTAS,1732,2476,4208
15885,JAMBI,16183,MERANGIN,16196,BANGKO,15527,9014,24541
15885,JAMBI,16183,MERANGIN,16385,MARGO TABIR,3521,3851,7372
15885,JAMBI,16183,MERANGIN,16276,LEMBAH MASURAI,4810,6224,11034
15885,JAMBI,16183,MERANGIN,16205,MUARA SIAU,2103,2841,4944
15885,JAMBI,16183,MERANGIN,16299,NALO TATAN,3176,3784,6960
15885,JAMBI,16183,MERANGIN,16246,PAMENANG,7719,10204,17923
15885,JAMBI,16420,SAROLANGUN,16528,AIR HITAM,4078,8358,12436
15885,JAMBI,16420,SAROLANGUN,16421,BATANG ASAI,4821,3849,8670
15885,JAMBI,16183,MERANGIN,16292,BANGKO  BARAT,2571,3643,6214
15885,JAMBI,16183,MERANGIN,16261,TABIR ULU,1889,2501,4390
15885,JAMBI,16183,MERANGIN,16268,TABIR SELATAN,6435,9787,16222
15885,JAMBI,16420,SAROLANGUN,16556,SINGKUT,8310,12660,20970
15885,JAMBI,16420,SAROLANGUN,16460,SAROLANGUN,17727,9566,27293
15885,JAMBI,16420,SAROLANGUN,16539,BATHIN VIII,7002,4897,11899
15885,JAMBI,16420,SAROLANGUN,16507,MANDIANGIN,5970,12813,18783
15885,JAMBI,16183,MERANGIN,16413,TIANG PUMPUNG,1540,1256,2796
15885,JAMBI,16576,BATANGHARI,16629,BATIN XXIV,4564,9778,14342
15885,JAMBI,16420,SAROLANGUN,16476,PAUH,3769,8414,12183
15885,JAMBI,16420,SAROLANGUN,16444,LIMUN,5585,4783,10368
15885,JAMBI,16576,BATANGHARI,16608,MUARA BULIAN,17517,13529,31046
15885,JAMBI,16420,SAROLANGUN,16492,PELAWAN,7793,8655,16448
15885,JAMBI,16576,BATANGHARI,16594,MUARA TEMBESI,7589,7721,15310
15885,JAMBI,16699,MUARO JAMBI,16851,TAMAN RAJO,3570,3016,6586
15885,JAMBI,16420,SAROLANGUN,16567,CERMIN NAN GEDANG,3543,2448,5991
15885,JAMBI,16576,BATANGHARI,16577,MERSAM,6751,7857,14608
15885,JAMBI,16699,MUARO JAMBI,16813,SUNGAI GELAM,10668,23702,34370
15885,JAMBI,16699,MUARO JAMBI,16783,KUMPEH ULU,11373,14702,26075
15885,JAMBI,16576,BATANGHARI,16691,MARO SEBO ILIR,3539,3928,7467
15885,JAMBI,16576,BATANGHARI,16647,PEMAYUNG,8011,8427,16438
15885,JAMBI,16576,BATANGHARI,16666,MARO SEBO ULU,5077,9527,14604
15885,JAMBI,16699,MUARO JAMBI,16840,BAHAR SELATAN,3414,5524,8938
15885,JAMBI,16576,BATANGHARI,16681,BAJUBANG,6693,12232,18925
15885,JAMBI,16699,MUARO JAMBI,16754,MARO SEBO,5282,5638,10920
15885,JAMBI,16699,MUARO JAMBI,16719,SEKERNAN,8551,13151,21702
15885,JAMBI,16699,MUARO JAMBI,16801,SUNGAI BAHAR,5289,8710,13999
15885,JAMBI,16862,TANJUNG JABUNG BARAT,16917,MUARA PAPALIK,2234,3363,5597
15885,JAMBI,16699,MUARO JAMBI,16700,JAMBI LUAR KOTA,17456,15204,32660
15885,JAMBI,16862,TANJUNG JABUNG BARAT,16863,TUNGKAL ULU,2737,4201,6938
15885,JAMBI,16699,MUARO JAMBI,16736,KUMPEH,5559,6227,11786
15885,JAMBI,16699,MUARO JAMBI,83485,BAHAR UTARA,2705,4563,7268
15885,JAMBI,16862,TANJUNG JABUNG BARAT,16910,RENAH MENDALUH,2281,3957,6238
15885,JAMBI,16699,MUARO JAMBI,16767,MESTONG,7528,13695,21223
15885,JAMBI,16862,TANJUNG JABUNG BARAT,16928,BRAM ITAM,3788,4532,8320
15885,JAMBI,16862,TANJUNG JABUNG BARAT,16933,KUALA BETARA,3531,3124,6655
15885,JAMBI,16946,TANJUNG JABUNG TIMUR,16947,MUARA SABAK TIMUR,5789,11453,17242
15885,JAMBI,16862,TANJUNG JABUNG BARAT,16897,TEBING TINGGI,8607,6973,15580
15885,JAMBI,16862,TANJUNG JABUNG BARAT,16888,MERLUNG,3325,4559,7884
15885,JAMBI,16946,TANJUNG JABUNG TIMUR,17011,MUARA SABAK BARAT,3610,5136,8746
15885,JAMBI,16862,TANJUNG JABUNG BARAT,16923,SEBERANG KOTA,1896,2316,4212
15885,JAMBI,16862,TANJUNG JABUNG BARAT,16878,PENGABUAN,5332,7031,12363
15885,JAMBI,16862,TANJUNG JABUNG BARAT,16883,BETARA,4117,7705,11822
15885,JAMBI,16946,TANJUNG JABUNG TIMUR,16960,NIPAH PANJANG,5961,7281,13242
15885,JAMBI,16862,TANJUNG JABUNG BARAT,16938,SENYERANG,5288,6593,11881
15885,JAMBI,16946,TANJUNG JABUNG TIMUR,17003,DENDANG,3014,6001,9015
15885,JAMBI,16862,TANJUNG JABUNG BARAT,16903,BATANG ASAM,4154,9031,13185
15885,JAMBI,16946,TANJUNG JABUNG TIMUR,17019,KUALA JAMBI,3044,4451,7495
15885,JAMBI,16862,TANJUNG JABUNG BARAT,16871,TUNGKAL ILIR,16516,15705,32221
15885,JAMBI,16946,TANJUNG JABUNG TIMUR,17034,GERAGAI,4448,8985,13433
15885,JAMBI,17051,BUNGO,17174,RIMBO TENGAH,7962,4803,12765
15885,JAMBI,16946,TANJUNG JABUNG TIMUR,16971,MENDAHARA,5514,8133,13647
15885,JAMBI,16946,TANJUNG JABUNG TIMUR,17026,MENDAHARA ULU,2975,5247,8222
15885,JAMBI,17051,BUNGO,17179,BATHIN III ULU,1919,2437,4356
15885,JAMBI,16946,TANJUNG JABUNG TIMUR,17044,BERBAK,2056,2864,4920
15885,JAMBI,17051,BUNGO,17189,BATHIN II PELAYANG,888,3187,4075
15885,JAMBI,17051,BUNGO,17097,PELEPAT,6234,10849,17083
15885,JAMBI,17051,BUNGO,17086,TANAH SEPENGGAL,5289,7291,12580
15885,JAMBI,17051,BUNGO,17052,TANAH TUMBUH,3162,5439,8601
15885,JAMBI,16946,TANJUNG JABUNG TIMUR,16981,RANTAU RASAU,4989,7801,12790
15885,JAMBI,16946,TANJUNG JABUNG TIMUR,16993,S A D U,3519,4079,7598
15885,JAMBI,17051,BUNGO,17153,BATIN II BABEKO,2382,3401,5783
15885,JAMBI,17051,BUNGO,17071,PASAR MUARO BUNGO,7609,3796,11405
15885,JAMBI,17051,BUNGO,17168,BUNGO DANI,8162,4587,12749
15885,JAMBI,17051,BUNGO,17195,TANAH SEPENGGAL LINTAS,5988,7546,13534
15885,JAMBI,17051,BUNGO,17064,RANTAU PANDAN,2998,2670,5668
15885,JAMBI,17051,BUNGO,17135,PELEPAT ILIR,11089,15057,26146
15885,JAMBI,17215,TEBO,17276,VII KOTO,3587,6576,10163
15885,JAMBI,17215,TEBO,17216,TEBO TENGAH,9219,9931,19150
15885,JAMBI,17051,BUNGO,17207,JUJUHAN ILIR,2762,3306,6068
15885,JAMBI,17051,BUNGO,17159,BATHIN III,6653,4369,11022
15885,JAMBI,17051,BUNGO,17077,JUJUHAN,4596,4038,8634
15885,JAMBI,17215,TEBO,17304,TENGAH ILIR,3432,9269,12701
15885,JAMBI,17215,TEBO,17310,SERAI SERUMPUN,1502,3127,4629
15885,JAMBI,17215,TEBO,17287,RIMBO ULU,7310,14933,22243
15885,JAMBI,17051,BUNGO,17111,LIMBUR LUBUK MENGKUANG,8303,1842,10145
15885,JAMBI,17215,TEBO,17263,SUMAY,2946,7022,9968
15885,JAMBI,17215,TEBO,17319,VII KOTO ILIR,2210,5414,7624
15885,JAMBI,17333,KOTA JAMBI,17346,JAMBI SELATAN,33531,35684,69215
15885,JAMBI,17215,TEBO,17229,TEBO ILIR,6215,8066,14281
15885,JAMBI,17333,KOTA JAMBI,17385,KOTA BARU,43981,37230,81211
15885,JAMBI,17333,KOTA JAMBI,17367,PASAR JAMBI,3149,3502,6651
15885,JAMBI,15886,KOTA SUNGAI PENUH,15907,PESISIR BUKIT,5100,1055,6155
15885,JAMBI,17215,TEBO,17294,RIMBO ILIR,5815,8805,14620
15885,JAMBI,17215,TEBO,17241,TEBO ULU,6341,9787,16128
15885,JAMBI,17333,KOTA JAMBI,17379,DANAU TELUK,4582,2183,6765
15885,JAMBI,17333,KOTA JAMBI,17396,JELUTUNG,16369,16868,33237
15885,JAMBI,15886,KOTA SUNGAI PENUH,15887,SUNGAIPENUH,3731,1303,5034
15885,JAMBI,15886,KOTA SUNGAI PENUH,15951,KUMUN DEBAI,3362,1858,5220
15885,JAMBI,17215,TEBO,17254,RIMBO BUJANG,14800,20051,34851
15885,JAMBI,15886,KOTA SUNGAI PENUH,15937,TANAH KAMPUNG,3185,1254,4439
17404,SUMATERA SELATAN,17405,OGAN KOMERING ULU,17535,LENGKITI,7282,4320,11602
15885,JAMBI,17215,TEBO,17325,MUARA TABIR,2795,5570,8365
15885,JAMBI,17333,KOTA JAMBI,17372,PELAYANGAN,4581,2503,7084
17404,SUMATERA SELATAN,17405,OGAN KOMERING ULU,17498,SEMIDANG AJI,7504,3824,11328
15885,JAMBI,17333,KOTA JAMBI,17356,JAMBI TIMUR,19590,24911,44501
15885,JAMBI,15886,KOTA SUNGAI PENUH,83486,PONDOK TINGGI,6970,1819,8789
15885,JAMBI,17333,KOTA JAMBI,17334,TELANAIPURA,29777,20088,49865
17404,SUMATERA SELATAN,17405,OGAN KOMERING ULU,17417,PENGANDONAN,3286,1327,4613
17404,SUMATERA SELATAN,17405,OGAN KOMERING ULU,17557,SINAR PENINJAUAN,6014,6294,12308
15885,JAMBI,15886,KOTA SUNGAI PENUH,83487,KOTO BARU,3139,694,3833
15885,JAMBI,15886,KOTA SUNGAI PENUH,15923,HAMPARAN RAWANG,7057,1294,8351
17404,SUMATERA SELATAN,17405,OGAN KOMERING ULU,17520,LUBUK BATANG,9919,5519,15438
17404,SUMATERA SELATAN,17405,OGAN KOMERING ULU,17406,SOSOH BUAY RAYAP,3951,2281,6232
17404,SUMATERA SELATAN,17405,OGAN KOMERING ULU,17476,BATURAJA TIMUR,30403,16271,46674
15885,JAMBI,15886,KOTA SUNGAI PENUH,83488,SUNGAIBUNGKAL,3837,1278,5115
17404,SUMATERA SELATAN,17405,OGAN KOMERING ULU,17430,PENINJAUAN,13074,9287,22361
17404,SUMATERA SELATAN,17570,OGAN KOMERING ILIR,17571,TANJUNG LUBUK,0,0,0
17404,SUMATERA SELATAN,17405,OGAN KOMERING ULU,17463,BATURAJA BARAT,11318,7105,18423
17404,SUMATERA SELATAN,17405,OGAN KOMERING ULU,17490,ULU OGAN,3309,770,4079
17404,SUMATERA SELATAN,17405,OGAN KOMERING ULU,17455,MUARA JAYA,2288,664,2952
17404,SUMATERA SELATAN,17570,OGAN KOMERING ILIR,17872,TELUK GELAM,0,0,0
17404,SUMATERA SELATAN,17570,OGAN KOMERING ILIR,17732,AIR SUGIHAN,0,0,0
17404,SUMATERA SELATAN,17570,OGAN KOMERING ILIR,17715,LEMPUING,0,0,0
17404,SUMATERA SELATAN,17405,OGAN KOMERING ULU,17564,LUBUK RAJA,10299,6810,17109
17404,SUMATERA SELATAN,17570,OGAN KOMERING ILIR,17799,PANGKALAN LAMPAM,0,0,0
17404,SUMATERA SELATAN,17570,OGAN KOMERING ILIR,17752,SUNGAI MENANG,0,0,0
17404,SUMATERA SELATAN,17570,OGAN KOMERING ILIR,17787,CENGAL,0,0,0
17404,SUMATERA SELATAN,17570,OGAN KOMERING ILIR,17856,LEMPUING JAYA,0,0,0
17404,SUMATERA SELATAN,17895,MUARA ENIM,17896,TANJUNG AGUNG,0,0,0
17404,SUMATERA SELATAN,17570,OGAN KOMERING ILIR,17817,MESUJI MAKMUR,0,0,0
17404,SUMATERA SELATAN,17570,OGAN KOMERING ILIR,17838,MESUJI RAYA,0,0,0
17404,SUMATERA SELATAN,17570,OGAN KOMERING ILIR,17770,JEJAWI,0,0,0
17404,SUMATERA SELATAN,17570,OGAN KOMERING ILIR,17608,MESUJI,0,0,0
17404,SUMATERA SELATAN,17895,MUARA ENIM,18211,BENAKAT,0,0,0
17404,SUMATERA SELATAN,17570,OGAN KOMERING ILIR,17623,KAYU AGUNG,0,0,0
17404,SUMATERA SELATAN,17570,OGAN KOMERING ILIR,17649,SIRAH PULAU PADANG,0,0,0
17404,SUMATERA SELATAN,17895,MUARA ENIM,18156,SUNGAI ROTAN,0,0,0
17404,SUMATERA SELATAN,17570,OGAN KOMERING ILIR,17670,TULUNG SELAPAN,0,0,0
17404,SUMATERA SELATAN,17570,OGAN KOMERING ILIR,17693,PAMPANGAN,0,0,0
17404,SUMATERA SELATAN,17570,OGAN KOMERING ILIR,17887,PEDAMARAN TIMUR,0,0,0
17404,SUMATERA SELATAN,17895,MUARA ENIM,18235,MUARA BELIDA,0,0,0
17404,SUMATERA SELATAN,17570,OGAN KOMERING ILIR,17593,PEDAMARAN,0,0,0
17404,SUMATERA SELATAN,17895,MUARA ENIM,18120,LUBAI,0,0,0
17404,SUMATERA SELATAN,17895,MUARA ENIM,18176,LEMBAK,0,0,0
17404,SUMATERA SELATAN,17895,MUARA ENIM,18106,PENUKAL,0,0,0
17404,SUMATERA SELATAN,17895,MUARA ENIM,18218,ABAB,0,0,0
17404,SUMATERA SELATAN,17895,MUARA ENIM,18142,RAMBANG,0,0,0
17404,SUMATERA SELATAN,17895,MUARA ENIM,17967,GUNUNG MEGANG,0,0,0
17404,SUMATERA SELATAN,17895,MUARA ENIM,17991,TALANG UBI,0,0,0
17404,SUMATERA SELATAN,17895,MUARA ENIM,83489,BELIMBING,0,0,0
17404,SUMATERA SELATAN,17895,MUARA ENIM,18088,TANAH ABANG,0,0,0
17404,SUMATERA SELATAN,17895,MUARA ENIM,17923,MUARA ENIM,0,0,0
17404,SUMATERA SELATAN,17895,MUARA ENIM,18197,PENUKAL UTARA,0,0,0
17404,SUMATERA SELATAN,17895,MUARA ENIM,83490,BELINDA DARAT,0,0,0
17404,SUMATERA SELATAN,17895,MUARA ENIM,18079,UJAN MAS,0,0,0
17404,SUMATERA SELATAN,18244,LAHAT,18528,GUMAY TALANG,2223,2681,4904
17404,SUMATERA SELATAN,17895,MUARA ENIM,18055,SEMENDE DARAT TENGAH,0,0,0
17404,SUMATERA SELATAN,17895,MUARA ENIM,18036,LAWANG KIDUL,0,0,0
17404,SUMATERA SELATAN,17895,MUARA ENIM,18068,SEMENDE DARAT ULU,0,0,0
17404,SUMATERA SELATAN,17895,MUARA ENIM,18227,KELEKAR,0,0,0
17404,SUMATERA SELATAN,17895,MUARA ENIM,18012,GELUMBANG,0,0,0
17404,SUMATERA SELATAN,18244,LAHAT,18245,TANJUNGSAKTI PUMU,4650,1857,6507
17404,SUMATERA SELATAN,17895,MUARA ENIM,17940,RAMBANG DANGKU,0,0,0
17404,SUMATERA SELATAN,18244,LAHAT,18516,PSEKSU,2205,2101,4306
17404,SUMATERA SELATAN,18244,LAHAT,18599,GUMAY ULU,1392,1521,2913
17404,SUMATERA SELATAN,18244,LAHAT,18610,MERAPI SELATAN,0,0,0
17404,SUMATERA SELATAN,18244,LAHAT,18496,KIKIM BARAT,3623,5080,8703
17404,SUMATERA SELATAN,17895,MUARA ENIM,83491,LUBAI ULU,0,0,0
17404,SUMATERA SELATAN,17895,MUARA ENIM,18044,SEMENDE DARAT LAUT,0,0,0
17404,SUMATERA SELATAN,18244,LAHAT,18565,MERAPI TIMUR,5860,5925,11785
17404,SUMATERA SELATAN,18244,LAHAT,18486,KIKIM TENGAH,2227,2370,4597
17404,SUMATERA SELATAN,18244,LAHAT,18453,KIKIM TIMUR,7048,8516,15564
17404,SUMATERA SELATAN,18244,LAHAT,18376,PAJAR BULAN,4695,2141,6836
17404,SUMATERA SELATAN,18244,LAHAT,18320,MERAPI BARAT,6809,4981,11790
17404,SUMATERA SELATAN,18244,LAHAT,18580,TANJUNG SAKTI PUMI,5158,2292,7450
17404,SUMATERA SELATAN,18244,LAHAT,18620,TANJUNGTEBAT,3326,1483,4809
17404,SUMATERA SELATAN,18643,MUSI RAWAS,18644,TUGUMULYO,13763,12132,25895
17404,SUMATERA SELATAN,18244,LAHAT,18544,PAGAR GUNUNG,4380,2913,7293
17404,SUMATERA SELATAN,18244,LAHAT,18305,PULAUPINANG,0,0,0
17404,SUMATERA SELATAN,18244,LAHAT,18340,LAHAT,0,0,0
17404,SUMATERA SELATAN,18244,LAHAT,83492,SUKAMERINDU,3258,1350,4608
17404,SUMATERA SELATAN,18244,LAHAT,18282,KOTA AGUNG,4424,2410,6834
17404,SUMATERA SELATAN,18643,MUSI RAWAS,18880,NIBUNG,3677,8427,12104
17404,SUMATERA SELATAN,18244,LAHAT,18635,MUARAPAYANG,1834,2404,4238
17404,SUMATERA SELATAN,18244,LAHAT,18434,KIKIM SELATAN,3471,4007,7478
17404,SUMATERA SELATAN,18244,LAHAT,18260,JARAI,6312,4403,10715
17404,SUMATERA SELATAN,18244,LAHAT,18407,MULAK ULU,7665,2443,10108
17404,SUMATERA SELATAN,18643,MUSI RAWAS,18833,PURWODADI,4302,4848,9150
17404,SUMATERA SELATAN,18643,MUSI RAWAS,18799,SELANGIT,4149,6753,10902
17404,SUMATERA SELATAN,18643,MUSI RAWAS,18902,TIANG PUMPUNG KEPUNGUT,2551,3948,6499
17404,SUMATERA SELATAN,18643,MUSI RAWAS,18716,RAWAS ULU,5943,12827,18770
17404,SUMATERA SELATAN,18643,MUSI RAWAS,18704,RAWAS ILIR,4686,9807,14493
17404,SUMATERA SELATAN,18643,MUSI RAWAS,18922,TUAH NEGERI,5351,8592,13943
17404,SUMATERA SELATAN,18643,MUSI RAWAS,18683,MUARA KELINGI,6903,15404,22307
17404,SUMATERA SELATAN,18643,MUSI RAWAS,18892,KARANG DAPO,3247,7615,10862
17404,SUMATERA SELATAN,18643,MUSI RAWAS,18865,KARANG JAYA,8705,10183,18888
17404,SUMATERA SELATAN,18942,MUSI BANYUASIN,18943,SEKAYU,20267,17999,38266
17404,SUMATERA SELATAN,18643,MUSI RAWAS,18733,ULU RAWAS,3864,3180,7044
17404,SUMATERA SELATAN,18643,MUSI RAWAS,18741,RUPIT,12593,11305,23898
17404,SUMATERA SELATAN,18643,MUSI RAWAS,18662,MUARA LAKITAN,7427,13073,20500
17404,SUMATERA SELATAN,18643,MUSI RAWAS,18934,SUKA KARYA,2428,5866,8294
17404,SUMATERA SELATAN,18942,MUSI BANYUASIN,19145,LALAN,0,0,0
17404,SUMATERA SELATAN,18643,MUSI RAWAS,18785,STL ULU TERAWAS,6743,10338,17081
17404,SUMATERA SELATAN,18643,MUSI RAWAS,18812,MEGANG SAKTI,9252,20566,29818
17404,SUMATERA SELATAN,18942,MUSI BANYUASIN,18972,SUNGAI KERUH,0,0,0
17404,SUMATERA SELATAN,18643,MUSI RAWAS,18912,SUMBER HARTA,4992,4947,9939
17404,SUMATERA SELATAN,18643,MUSI RAWAS,18759,JAYALOKA,2484,5870,8354
17404,SUMATERA SELATAN,18942,MUSI BANYUASIN,19081,KELUANG,7653,9078,16731
17404,SUMATERA SELATAN,19172,BANYUASIN,83430,SEMBAWA,10371,6633,17004
17404,SUMATERA SELATAN,18942,MUSI BANYUASIN,19027,BABAT TOMAN,6874,9482,16356
17404,SUMATERA SELATAN,19172,BANYUASIN,83429,SUAK TAPEH,6057,3414,9471
17404,SUMATERA SELATAN,18942,MUSI BANYUASIN,19009,SANGA DESA,0,0,0
17404,SUMATERA SELATAN,19172,BANYUASIN,83493,SUMBER MARGA TELANG,5701,6002,11703
17404,SUMATERA SELATAN,18942,MUSI BANYUASIN,83427,BABAT SUPAT,0,0,0
17404,SUMATERA SELATAN,18643,MUSI RAWAS,18772,MUARA BELITI,6811,6409,13220
17404,SUMATERA SELATAN,18942,MUSI BANYUASIN,19055,SUNGAI LILIN,0,0,0
17404,SUMATERA SELATAN,18942,MUSI BANYUASIN,83425,TUNGKAL JAYA,0,0,0
17404,SUMATERA SELATAN,18942,MUSI BANYUASIN,19130,PLAKAT TINGGI,0,0,0
17404,SUMATERA SELATAN,19172,BANYUASIN,19173,BANYUASIN I,14114,13552,27666
17404,SUMATERA SELATAN,18942,MUSI BANYUASIN,83426,LAWANG WETAN,4725,6979,11704
17404,SUMATERA SELATAN,19172,BANYUASIN,19403,RANTAU BAYUR,11553,10119,21672
17404,SUMATERA SELATAN,18942,MUSI BANYUASIN,19095,BAYUNG LENCIR,0,0,0
17404,SUMATERA SELATAN,19172,BANYUASIN,19315,RAMBUTAN,11080,10913,21993
17404,SUMATERA SELATAN,19172,BANYUASIN,19440,TANJUNG LAGO,7175,12596,19771
17404,SUMATERA SELATAN,19172,BANYUASIN,19336,MUARA PADANG,5059,10856,15915
17404,SUMATERA SELATAN,18942,MUSI BANYUASIN,18992,BATANG HARI LEKO,0,0,0
17404,SUMATERA SELATAN,19172,BANYUASIN,19479,AIR SALEK,5476,13113,18589
17404,SUMATERA SELATAN,19172,BANYUASIN,19293,BETUNG,13961,12304,26265
17404,SUMATERA SELATAN,19172,BANYUASIN,19375,MAKARTI JAYA,5696,8327,14023
17404,SUMATERA SELATAN,19172,BANYUASIN,19263,PULAU RIMAU,7831,14483,22314
17404,SUMATERA SELATAN,18942,MUSI BANYUASIN,18958,LAIS,0,0,0
17404,SUMATERA SELATAN,19492,OGAN KOMERING ULU TIMUR,19493,MARTAPURA,18924,8413,27337
17404,SUMATERA SELATAN,19172,BANYUASIN,19390,TALANG KELAPA,32924,30737,63661
17404,SUMATERA SELATAN,19172,BANYUASIN,83494,AIR KUMBANG,4359,8278,12637
17404,SUMATERA SELATAN,19492,OGAN KOMERING ULU TIMUR,19718,SEMENDAWAI BARAT,6071,4489,10560
17404,SUMATERA SELATAN,19172,BANYUASIN,19456,MUARA SUGIHAN,8365,14268,22633
17404,SUMATERA SELATAN,19492,OGAN KOMERING ULU TIMUR,19731,SEMENDAWAI TIMUR,8709,11847,20556
17404,SUMATERA SELATAN,19492,OGAN KOMERING ULU TIMUR,19684,BUAY MADANG TIMUR,25069,10296,35365
17404,SUMATERA SELATAN,19492,OGAN KOMERING ULU TIMUR,19675,BUNGA MAYANG,5155,3579,8734
17404,SUMATERA SELATAN,19172,BANYUASIN,19425,TUNGKAL ILIR,6315,8380,14695
17404,SUMATERA SELATAN,19172,BANYUASIN,19224,BANYUASIN III,19371,14466,33837
17404,SUMATERA SELATAN,19172,BANYUASIN,19352,MUARA TELANG,8231,12020,20251
17404,SUMATERA SELATAN,19492,OGAN KOMERING ULU TIMUR,19510,BUAY MADANG,16800,5633,22433
17404,SUMATERA SELATAN,19492,OGAN KOMERING ULU TIMUR,19708,MADANG SUKU III,7916,6924,14840
17404,SUMATERA SELATAN,19492,OGAN KOMERING ULU TIMUR,19528,BELITANG,20440,10959,31399
17404,SUMATERA SELATAN,19492,OGAN KOMERING ULU TIMUR,19654,BELITANG III,11159,10420,21579
17404,SUMATERA SELATAN,19492,OGAN KOMERING ULU TIMUR,19758,BELITANG JAYA,5685,6716,12401
17404,SUMATERA SELATAN,19492,OGAN KOMERING ULU TIMUR,19596,MADANG SUKU I,12164,8339,20503
17404,SUMATERA SELATAN,19172,BANYUASIN,19202,BANYUASIN II,6299,13648,19947
17404,SUMATERA SELATAN,19492,OGAN KOMERING ULU TIMUR,19772,BELITANG MADANG RAYA,15858,8806,24664
17404,SUMATERA SELATAN,19808,OGAN KOMERING ULU SELATAN,20029,RUNJUNG AGUNG,4181,2091,6272
17404,SUMATERA SELATAN,19492,OGAN KOMERING ULU TIMUR,19788,BELITANG MULYA,7336,5088,12424
17404,SUMATERA SELATAN,19492,OGAN KOMERING ULU TIMUR,19749,JAYAPURA,3653,4309,7962
17404,SUMATERA SELATAN,19492,OGAN KOMERING ULU TIMUR,19609,SEMENDAWAI SUKU III,11753,10914,22667
17404,SUMATERA SELATAN,19808,OGAN KOMERING ULU SELATAN,20049,SINDANG DANAU,4075,1615,5690
17404,SUMATERA SELATAN,19808,OGAN KOMERING ULU SELATAN,20066,TIGA DIHAJI,3396,1930,5326
17404,SUMATERA SELATAN,19492,OGAN KOMERING ULU TIMUR,19565,BUAY PEMUKA PELIUNG,12516,7643,20159
17404,SUMATERA SELATAN,19808,OGAN KOMERING ULU SELATAN,19809,MUARA DUA,0,0,0
17404,SUMATERA SELATAN,19808,OGAN KOMERING ULU SELATAN,19989,BUAY PEMATANG RIBU RANAU TENGAH,6485,5499,11984
17404,SUMATERA SELATAN,19492,OGAN KOMERING ULU TIMUR,19551,CEMPAKA,8171,5818,13989
17404,SUMATERA SELATAN,19492,OGAN KOMERING ULU TIMUR,19579,MADANG SUKU II,11062,6549,17611
17404,SUMATERA SELATAN,19808,OGAN KOMERING ULU SELATAN,19979,KISAM ILIR,2621,1505,4126
17404,SUMATERA SELATAN,19808,OGAN KOMERING ULU SELATAN,19888,BUAY SANDANG AJI,5879,3163,9042
17404,SUMATERA SELATAN,19492,OGAN KOMERING ULU TIMUR,19800,BUAY PEMUKA BANGSA RAJA,5242,1877,7119
17404,SUMATERA SELATAN,19808,OGAN KOMERING ULU SELATAN,19861,MUARA DUA KISAM,6595,2837,9432
17404,SUMATERA SELATAN,19808,OGAN KOMERING ULU SELATAN,19936,BUAY PEMACA,10388,11000,21388
17404,SUMATERA SELATAN,19492,OGAN KOMERING ULU TIMUR,19629,BELITANG II,11681,13684,25365
17404,SUMATERA SELATAN,19808,OGAN KOMERING ULU SELATAN,20039,SUNGAI ARE,3608,2317,5925
17404,SUMATERA SELATAN,20087,OGAN ILIR,20088,MUARA KUANG,0,0,0
17404,SUMATERA SELATAN,19808,OGAN KOMERING ULU SELATAN,20057,BUANA PEMACA,3712,2744,6456
17404,SUMATERA SELATAN,19808,OGAN KOMERING ULU SELATAN,20075,BUAY RAWAN,4132,3158,7290
17404,SUMATERA SELATAN,19808,OGAN KOMERING ULU SELATAN,19838,BANDING AGUNG,6327,5185,11512
17404,SUMATERA SELATAN,19808,OGAN KOMERING ULU SELATAN,19959,KISAM TINGGI,7281,3865,11146
17404,SUMATERA SELATAN,19808,OGAN KOMERING ULU SELATAN,19920,MEKAKAU ILIR,6229,4923,11152
17404,SUMATERA SELATAN,20087,OGAN ILIR,20266,RANTAU PANJANG,0,0,0
17404,SUMATERA SELATAN,19808,OGAN KOMERING ULU SELATAN,20012,WARKUK RANAU SELATAN,6058,5819,11877
17404,SUMATERA SELATAN,20087,OGAN ILIR,20320,LUBUK KELIAT,0,0,0
17404,SUMATERA SELATAN,20087,OGAN ILIR,20145,INDRALAYA,10312,8945,19257
17404,SUMATERA SELATAN,20087,OGAN ILIR,20279,SUNGAI PINANG,0,0,0
17404,SUMATERA SELATAN,20087,OGAN ILIR,20331,PAYARAMAN,0,0,0
17404,SUMATERA SELATAN,19808,OGAN KOMERING ULU SELATAN,19905,BUAY RUNJUNG,3940,2317,6257
17404,SUMATERA SELATAN,20087,OGAN ILIR,20166,PEMULUTAN,0,0,0
17404,SUMATERA SELATAN,19808,OGAN KOMERING ULU SELATAN,19880,SIMPANG,3537,3024,6561
17404,SUMATERA SELATAN,19808,OGAN KOMERING ULU SELATAN,19824,PULAU BERINGIN,8505,5917,14422
17404,SUMATERA SELATAN,20087,OGAN ILIR,20293,KANDIS,0,0,0
17404,SUMATERA SELATAN,20087,OGAN ILIR,20254,PEMULUTAN BARAT,0,0,0
17404,SUMATERA SELATAN,20087,OGAN ILIR,20192,RANTAU ALAI,0,0,0
17404,SUMATERA SELATAN,20087,OGAN ILIR,20306,RAMBANG KUANG,0,0,0
17404,SUMATERA SELATAN,20087,OGAN ILIR,20103,TANJUNG BATU,13131,10764,23895
17404,SUMATERA SELATAN,20345,EMPAT LAWANG,20426,TEBING TINGGI,0,0,0
17404,SUMATERA SELATAN,20345,EMPAT LAWANG,83431,SIKAP DALAM,0,0,0
17404,SUMATERA SELATAN,20087,OGAN ILIR,20206,INDRALAYA UTARA,0,0,0
17404,SUMATERA SELATAN,20345,EMPAT LAWANG,20482,TALANG PADANG,0,0,0
17404,SUMATERA SELATAN,20345,EMPAT LAWANG,20464,LINTANG KANAN,0,0,0
17404,SUMATERA SELATAN,20087,OGAN ILIR,20238,PEMULUTAN SELATAN,0,0,0
17404,SUMATERA SELATAN,20345,EMPAT LAWANG,20346,MUARA PINANG,0,0,0
17404,SUMATERA SELATAN,20512,KOTA PALEMBANG,20611,KERTAPATI,23192,20737,43929
17404,SUMATERA SELATAN,20087,OGAN ILIR,20223,INDRALAYA SELATAN,5797,5465,11262
17404,SUMATERA SELATAN,20512,KOTA PALEMBANG,20592,KALIDONI,0,0,0
17404,SUMATERA SELATAN,20087,OGAN ILIR,20125,TANJUNG RAJA,0,0,0
17404,SUMATERA SELATAN,20512,KOTA PALEMBANG,20598,BUKIT KECIL,11929,9431,21360
17404,SUMATERA SELATAN,20512,KOTA PALEMBANG,20559,ILIR TIMUR II,44260,41162,85422
17404,SUMATERA SELATAN,20345,EMPAT LAWANG,20496,PASEMAH AIR KERUH,0,0,0
17404,SUMATERA SELATAN,20345,EMPAT LAWANG,20400,ULU MUSI,0,0,0
17404,SUMATERA SELATAN,20512,KOTA PALEMBANG,20513,ILIR BARAT II,0,0,0
17404,SUMATERA SELATAN,20512,KOTA PALEMBANG,20618,PLAJU,24482,21746,46228
17404,SUMATERA SELATAN,20345,EMPAT LAWANG,83495,SALING,0,0,0
17404,SUMATERA SELATAN,20636,KOTA PAGAR ALAM,20665,DEMPO SELATAN,0,0,0
17404,SUMATERA SELATAN,20512,KOTA PALEMBANG,20540,ILIR BARAT I,37846,30192,68038
17404,SUMATERA SELATAN,20636,KOTA PAGAR ALAM,20648,PAGAR ALAM SELATAN,12743,11880,24623
17404,SUMATERA SELATAN,20636,KOTA PAGAR ALAM,20657,DEMPO UTARA,0,0,0
17404,SUMATERA SELATAN,20512,KOTA PALEMBANG,20547,ILIR TIMUR I,14921,23998,38919
17404,SUMATERA SELATAN,20512,KOTA PALEMBANG,20585,KEMUNING,22231,20596,42827
17404,SUMATERA SELATAN,20512,KOTA PALEMBANG,20631,SEMATANG BORANG,10095,9480,19575
17404,SUMATERA SELATAN,20345,EMPAT LAWANG,20369,PENDOPO,0,0,0
17404,SUMATERA SELATAN,20345,EMPAT LAWANG,83496,PENDOPO BARAT,0,0,0
17404,SUMATERA SELATAN,20677,KOTA LUBUKLINGGAU,20678,LUBUK LINGGAU TIMUR I,9128,5781,14909
17404,SUMATERA SELATAN,20636,KOTA PAGAR ALAM,20671,DEMPO TENGAH,3982,3741,7723
17404,SUMATERA SELATAN,20512,KOTA PALEMBANG,20572,SUKARAMI,37593,36794,74387
17404,SUMATERA SELATAN,20512,KOTA PALEMBANG,20580,SAKO,0,0,0
17404,SUMATERA SELATAN,20677,KOTA LUBUKLINGGAU,20687,LUBUK LINGGAU BARAT I,9041,6624,15665
17404,SUMATERA SELATAN,20512,KOTA PALEMBANG,20605,GANDUS,17009,13804,30813
17404,SUMATERA SELATAN,20677,KOTA LUBUKLINGGAU,20728,LUBUK LINGGAU BARAT II,6145,5141,11286
17404,SUMATERA SELATAN,20677,KOTA LUBUKLINGGAU,20718,LUBUK LINGGAU TIMUR II,7461,8773,16234
17404,SUMATERA SELATAN,20677,KOTA LUBUKLINGGAU,20737,LUBUK LINGGAU SELATAN II,8213,6481,14694
17404,SUMATERA SELATAN,20636,KOTA PAGAR ALAM,20637,PAGAR ALAM UTARA,10883,9697,20580
17404,SUMATERA SELATAN,20677,KOTA LUBUKLINGGAU,20707,LUBUK LINGGAU UTARA I,3219,5172,8391
17404,SUMATERA SELATAN,20512,KOTA PALEMBANG,20532,SEBERANG ULU II,25990,22029,48019
17404,SUMATERA SELATAN,20512,KOTA PALEMBANG,20521,SEBERANG ULU I,43087,40138,83225
20802,BENGKULU,20923,BENGKULU SELATAN,21050,AIR NIPIS,1575,3472,5047
17404,SUMATERA SELATAN,20758,KOTA PRABUMULIH,20797,PRABUMULIH SELATAN,0,0,0
17404,SUMATERA SELATAN,20758,KOTA PRABUMULIH,20791,PRABUMULIH UTARA,0,0,0
17404,SUMATERA SELATAN,20677,KOTA LUBUKLINGGAU,20699,LUBUK LINGGAU SELATAN I,4140,3578,7718
20802,BENGKULU,20923,BENGKULU SELATAN,20924,KEDURANG,2269,3389,5658
17404,SUMATERA SELATAN,20758,KOTA PRABUMULIH,20781,RAMBANG KPK TENGAH,0,0,0
17404,SUMATERA SELATAN,20758,KOTA PRABUMULIH,20775,CAMBAI,0,0,0
20802,BENGKULU,20923,BENGKULU SELATAN,21072,BUNGA MAS,1175,2145,3320
17404,SUMATERA SELATAN,20758,KOTA PRABUMULIH,20759,PRABUMULIH BARAT,0,0,0
17404,SUMATERA SELATAN,20677,KOTA LUBUKLINGGAU,20747,LUBUK LINGGAU UTARA II,8457,8323,16780
20802,BENGKULU,20923,BENGKULU SELATAN,21015,PINO RAYA,2893,6548,9441
20802,BENGKULU,21093,REJANG LEBONG,21243,SINDANG BELITI ILIR,2523,1889,4412
17404,SUMATERA SELATAN,20758,KOTA PRABUMULIH,20766,PRABUMULIH TIMUR,0,0,0
20802,BENGKULU,20923,BENGKULU SELATAN,21061,ULU MANNA,1549,2612,4161
20802,BENGKULU,21093,REJANG LEBONG,21094,KOTA PADANG,2936,2311,5247
20802,BENGKULU,20923,BENGKULU SELATAN,20944,SEGINIM,2195,5529,7724
20802,BENGKULU,20923,BENGKULU SELATAN,21083,PASAR MANNA,5237,3726,8963
20802,BENGKULU,21093,REJANG LEBONG,21187,CURUP TIMUR,6122,4478,10600
20802,BENGKULU,21093,REJANG LEBONG,21226,SINDANG BELITI ULU,3196,2775,5971
20802,BENGKULU,20923,BENGKULU SELATAN,21003,KOTA MANNA,7696,6787,14483
20802,BENGKULU,21093,REJANG LEBONG,21121,SINDANG KELINGI,3968,4448,8416
20802,BENGKULU,21093,REJANG LEBONG,21197,CURUP SELATAN,6994,3052,10046
20802,BENGKULU,20923,BENGKULU SELATAN,21037,KEDURANG ILIR,1163,2962,4125
20802,BENGKULU,21093,REJANG LEBONG,21236,SINDANG DATARAN,2372,3168,5540
20802,BENGKULU,20923,BENGKULU SELATAN,20967,PINO,2357,3805,6162
20802,BENGKULU,20923,BENGKULU SELATAN,20984,MANNA,3045,3989,7034
20802,BENGKULU,21093,REJANG LEBONG,21220,BINDURIANG,2024,2934,4958
20802,BENGKULU,21265,BENGKULU UTARA,83497,ARMA JAYA,2495,3498,5993
20802,BENGKULU,21093,REJANG LEBONG,21254,BERMANI ULU RAYA,2640,3001,5641
20802,BENGKULU,21093,REJANG LEBONG,21172,CURUP UTARA,4986,3406,8392
20802,BENGKULU,21093,REJANG LEBONG,21157,SELUPU REJANG,8279,7672,15951
20802,BENGKULU,21093,REJANG LEBONG,21144,BERMANI ULU,3445,3253,6698
20802,BENGKULU,21093,REJANG LEBONG,21134,CURUP,9087,5179,14266
20802,BENGKULU,21093,REJANG LEBONG,21105,PADANG ULAK TANDING,4389,5104,9493
20802,BENGKULU,21265,BENGKULU UTARA,21436,PUTRI HIJAU,6189,14071,20260
20802,BENGKULU,21093,REJANG LEBONG,21209,CURUP TENGAH,10518,6393,16911
20802,BENGKULU,21265,BENGKULU UTARA,21417,NAPAL PUTIH,1468,2589,4057
20802,BENGKULU,21265,BENGKULU UTARA,21396,KETAHUN,7423,16588,24011
20802,BENGKULU,21265,BENGKULU UTARA,83439,AIR PADANG,1053,2189,3242
20802,BENGKULU,21492,KAUR,21493,KINAL,1295,1452,2747
20802,BENGKULU,21265,BENGKULU UTARA,21309,ARGA MAKMUR,10570,9445,20015
20802,BENGKULU,21265,BENGKULU UTARA,21456,AIR BESI,1836,3124,4960
20802,BENGKULU,21265,BENGKULU UTARA,21273,KERKAP,2733,3738,6471
20802,BENGKULU,21265,BENGKULU UTARA,83438,HULU PALIK,2153,3535,5688
20802,BENGKULU,21265,BENGKULU UTARA,21266,ENGGANO,353,1119,1472
20802,BENGKULU,21265,BENGKULU UTARA,21380,BATIK NAU,1904,5531,7435
20802,BENGKULU,21265,BENGKULU UTARA,21474,AIR NAPAL,2130,3141,5271
20802,BENGKULU,21265,BENGKULU UTARA,83499,ULOK KUPAI,2321,3735,6056
20802,BENGKULU,21492,KAUR,21609,SEMIDANG GUMAY,1509,1902,3411
20802,BENGKULU,21492,KAUR,21670,LUNGKANG KULE,848,884,1732
20802,BENGKULU,21492,KAUR,21551,KAUR SELATAN,4352,4152,8504
20802,BENGKULU,21265,BENGKULU UTARA,21356,LAIS,2630,4121,6751
20802,BENGKULU,21492,KAUR,21680,PADANG GUCI HILIR,774,1176,1950
20802,BENGKULU,21265,BENGKULU UTARA,21345,PADANG JAYA,6005,10204,16209
20802,BENGKULU,21702,SELUMA,21852,TALO KECIL,1975,2843,4818
20802,BENGKULU,21492,KAUR,21529,KAUR UTARA,1593,1757,3350
20802,BENGKULU,21265,BENGKULU UTARA,21339,GIRI MULYA,2545,6080,8625
20802,BENGKULU,21492,KAUR,21591,NASAL,2242,5688,7930
20802,BENGKULU,21492,KAUR,21637,LUAS,1594,1476,3070
20802,BENGKULU,21492,KAUR,21657,TETAP,1648,2213,3861
20802,BENGKULU,21265,BENGKULU UTARA,84087,TANJUNGAGUNG PALIK,1617,2626,4243
20802,BENGKULU,21492,KAUR,21571,MAJE,2040,5192,7232
20802,BENGKULU,21492,KAUR,21508,TANJUNG KEMUNING,2047,3866,5913
20802,BENGKULU,21702,SELUMA,21840,SELUMA SELATAN,2511,3843,6354
20802,BENGKULU,21492,KAUR,21623,KELAM TENGAH,1477,1930,3407
20802,BENGKULU,21492,KAUR,21649,MUARA SAHUNG,1405,2251,3656
20802,BENGKULU,21702,SELUMA,21730,TALO,3001,2607,5608
20802,BENGKULU,21702,SELUMA,21766,SEMIDANG ALAS MARAS,4585,6452,11037
20802,BENGKULU,21702,SELUMA,21822,SELUMA TIMUR,2398,2652,5050
20802,BENGKULU,21492,KAUR,21690,PADANG GUCI HULU,1630,1486,3116
20802,BENGKULU,21702,SELUMA,21703,SUKARAJA,5255,11794,17049
20802,BENGKULU,21492,KAUR,21541,KAUR TENGAH,1791,1031,2822
20802,BENGKULU,21702,SELUMA,21813,SELUMA BARAT,1653,3074,4727
20802,BENGKULU,21702,SELUMA,21831,SELUMA UTARA,3101,2237,5338
20802,BENGKULU,21702,SELUMA,21745,SEMIDANG ALAS,2385,4503,6888
20802,BENGKULU,21885,MUKOMUKO,21963,TERAMANG JAYA,2115,3210,5325
20802,BENGKULU,21702,SELUMA,21862,ULU TALO,1116,2004,3120
20802,BENGKULU,21885,MUKOMUKO,22014,V KOTO,1560,1682,3242
20802,BENGKULU,21702,SELUMA,21800,LUBUK SANDI,2958,3066,6024
20802,BENGKULU,21885,MUKOMUKO,22025,AIR MAJUNTO,1735,4048,5783
20802,BENGKULU,21702,SELUMA,21872,ILIR TALO,3446,4100,7546
20802,BENGKULU,21885,MUKOMUKO,21990,PENARIK,3657,8469,12126
20802,BENGKULU,21885,MUKOMUKO,22042,SUNGAI RUMBAI,1409,2936,4345
20802,BENGKULU,21885,MUKOMUKO,21913,PONDOK SUGUH,2448,2910,5358
20802,BENGKULU,22052,LEBONG,83445,URAM JAYA,1497,1342,2839
20802,BENGKULU,21885,MUKOMUKO,21904,TERAS TERUNJAM,1292,2426,3718
20802,BENGKULU,21702,SELUMA,21787,AIR PERIUKAN,3396,8103,11499
20802,BENGKULU,21885,MUKOMUKO,21950,AIR RAMI,2532,3746,6278
20802,BENGKULU,21885,MUKOMUKO,21886,LUBUK PINANG,2938,3605,6543
20802,BENGKULU,21885,MUKOMUKO,22034,AIR DIKIT,1341,1969,3310
20802,BENGKULU,21885,MUKOMUKO,22005,XIV KOTO,2269,3886,6155
20802,BENGKULU,21885,MUKOMUKO,21894,KOTA MUKOMUKO,4087,3800,7887
20802,BENGKULU,22052,LEBONG,83440,TOPOS,2179,1273,3452
20802,BENGKULU,21702,SELUMA,21722,SELUMA,2107,2253,4360
20802,BENGKULU,22052,LEBONG,83446,PINANG BELAPIS,947,1572,2519
20802,BENGKULU,22052,LEBONG,22053,RIMBO PENGADANG,1015,1395,2410
20802,BENGKULU,22052,LEBONG,83441,BINGIN KUNING,2134,3030,5164
20802,BENGKULU,21885,MUKOMUKO,21942,MALIN DEMAN,1470,1569,3039
20802,BENGKULU,22135,KEPAHIANG,22187,KEPAHIANG,11782,8776,20558
20802,BENGKULU,21885,MUKOMUKO,21977,SELAGAN RAYA,1587,2072,3659
20802,BENGKULU,22052,LEBONG,83443,PELABAI,1106,1841,2947
20802,BENGKULU,22052,LEBONG,22093,LEBONG ATAS,1292,3201,4493
20802,BENGKULU,22135,KEPAHIANG,22154,UJAN MAS,5854,4247,10101
20802,BENGKULU,22135,KEPAHIANG,22136,BERMANI ILIR,4707,3749,8456
20802,BENGKULU,22135,KEPAHIANG,22215,KEBAWETAN,2751,4037,6788
20802,BENGKULU,22135,KEPAHIANG,22206,MERIGI,3112,2074,5186
20802,BENGKULU,22052,LEBONG,22106,LEBONG UTARA,3685,4223,7908
20802,BENGKULU,20803,BENGKULU TENGAH,20804,KARANG TINGGI,3222,4033,7255
20802,BENGKULU,22052,LEBONG,83444,AMEN,1926,2189,4115
20802,BENGKULU,21885,MUKOMUKO,21925,IPUH,4599,3303,7902
20802,BENGKULU,22135,KEPAHIANG,22172,TEBAT KARAI,3908,2894,6802
20802,BENGKULU,20803,BENGKULU TENGAH,20856,PEMATANG TIGA,1688,2119,3807
20802,BENGKULU,22052,LEBONG,22080,LEBONG TENGAH,2062,2699,4761
20802,BENGKULU,22052,LEBONG,22063,LEBONG SELATAN,2948,4071,7019
20802,BENGKULU,22052,LEBONG,83442,LEBONG SAKTI,2144,2533,4677
20802,BENGKULU,22252,KOTA BENGKULU,22253,SELEBAR,13191,14343,27534
20802,BENGKULU,22252,KOTA BENGKULU,22294,KAMPUNG MELAYU,5941,10124,16065
20802,BENGKULU,22252,KOTA BENGKULU,22301,RATU AGUNG,13362,12179,25541
20802,BENGKULU,20803,BENGKULU TENGAH,83434,PONDOK KUBANG,1887,3093,4980
20802,BENGKULU,20803,BENGKULU TENGAH,20832,PONDOK KELAPA,6299,9254,15553
20802,BENGKULU,20803,BENGKULU TENGAH,83432,MERIGI KELINDANG,1939,1992,3931
20802,BENGKULU,20803,BENGKULU TENGAH,20877,PAGAR JATI,2139,1495,3634
20802,BENGKULU,22135,KEPAHIANG,22241,MUARA KEMUMU,7875,4840,12715
20802,BENGKULU,22135,KEPAHIANG,22230,SEBERANG MUSI,1848,2038,3886
20802,BENGKULU,22252,KOTA BENGKULU,22272,TELUK SEGARA,6580,6028,12608
20802,BENGKULU,22252,KOTA BENGKULU,22286,MUARA BANGKA HULU,8978,9713,18691
20802,BENGKULU,20803,BENGKULU TENGAH,83435,BANG HAJI,1321,1839,3160
20802,BENGKULU,22252,KOTA BENGKULU,22320,SUNGAI SERUT,5649,5477,11126
20802,BENGKULU,22252,KOTA BENGKULU,22310,RATU SAMBAN,6364,5628,11992
22328,LAMPUNG,22605,LAMPUNG SELATAN,22861,WAY SULAN,5586,5523,11109
20802,BENGKULU,20803,BENGKULU TENGAH,83433,MERIGI SAKTI,1680,1577,3257
20802,BENGKULU,20803,BENGKULU TENGAH,20899,TABA PENANJUNG,3001,3085,6086
22328,LAMPUNG,22605,LAMPUNG SELATAN,22704,PENENGAHAN,12876,8009,20885
20802,BENGKULU,20803,BENGKULU TENGAH,20818,TALANG EMPAT,2864,5044,7908
22328,LAMPUNG,22605,LAMPUNG SELATAN,22606,NATAR,47475,48609,96084
22328,LAMPUNG,22605,LAMPUNG SELATAN,22690,KATIBUNG,14360,19665,34025
20802,BENGKULU,22252,KOTA BENGKULU,83447,SINGARAN PATI,9676,10109,19785
22328,LAMPUNG,22605,LAMPUNG SELATAN,22771,KETAPANG,9411,16970,26381
20802,BENGKULU,22252,KOTA BENGKULU,22260,GADING CEMPAKA,11391,9534,20925
22328,LAMPUNG,22605,LAMPUNG SELATAN,22674,SIDOMULYO,13677,17155,30832
22328,LAMPUNG,22875,LAMPUNG TENGAH,23073,WAY PANGUBUAN,0,0,0
22328,LAMPUNG,22605,LAMPUNG SELATAN,22852,TANJUNG SARI,5253,11441,16694
22328,LAMPUNG,22605,LAMPUNG SELATAN,22788,SRAGI,6015,10701,16716
22328,LAMPUNG,22605,LAMPUNG SELATAN,22727,PALAS,11593,18557,30150
22328,LAMPUNG,22875,LAMPUNG TENGAH,23121,ANAK TUHA,9261,10591,19852
22328,LAMPUNG,22605,LAMPUNG SELATAN,22799,RAJA BASA,6766,5739,12505
22328,LAMPUNG,22605,LAMPUNG SELATAN,22815,CANDIPURO,10428,17781,28209
22328,LAMPUNG,22605,LAMPUNG SELATAN,22830,MERBAU MATARAM,11085,15336,26421
22328,LAMPUNG,22875,LAMPUNG TENGAH,23089,PUBIAN,0,0,0
22328,LAMPUNG,22605,LAMPUNG SELATAN,22749,JATI AGUNG,23310,39079,62389
22328,LAMPUNG,22875,LAMPUNG TENGAH,23080,BANDAR MATARAM,0,0,0
22328,LAMPUNG,22605,LAMPUNG SELATAN,22846,BAKAUHENI,4849,6914,11763
22328,LAMPUNG,22875,LAMPUNG TENGAH,23165,BANDAR SURABAYA,0,0,0
22328,LAMPUNG,22875,LAMPUNG TENGAH,23108,SELAGAI LINGGA,6962,10519,17481
22328,LAMPUNG,22875,LAMPUNG TENGAH,23063,SEPUTIH AGUNG,0,0,0
22328,LAMPUNG,22605,LAMPUNG SELATAN,22629,TANJUNG BINTANG,18312,21523,39835
22328,LAMPUNG,22875,LAMPUNG TENGAH,23144,KOTA GAJAH,0,0,0
22328,LAMPUNG,22875,LAMPUNG TENGAH,23175,ANAK RATU AJI,4765,4801,9566
22328,LAMPUNG,22605,LAMPUNG SELATAN,22870,WAY PANJI,3043,6742,9785
22328,LAMPUNG,22875,LAMPUNG TENGAH,23134,SENDANG AGUNG,7971,11593,19564
22328,LAMPUNG,22605,LAMPUNG SELATAN,22646,KALIANDA,27326,18077,45403
22328,LAMPUNG,22875,LAMPUNG TENGAH,22906,PADANG RATU,11954,14615,26569
22328,LAMPUNG,22875,LAMPUNG TENGAH,22876,KALIREJO,0,0,0
22328,LAMPUNG,22875,LAMPUNG TENGAH,22973,SEPUTIH RAMAN,11382,15761,27143
22328,LAMPUNG,22875,LAMPUNG TENGAH,22890,BANGUN REJO,13338,17207,30545
22328,LAMPUNG,22875,LAMPUNG TENGAH,23036,TERUSAN NUNYAI,16298,8448,24746
22328,LAMPUNG,22875,LAMPUNG TENGAH,23151,BUMI NABUNG,6403,11524,17927
22328,LAMPUNG,23189,LAMPUNG UTARA,23359,ABUNG SURAKARTA,7638,7672,15310
22328,LAMPUNG,23189,LAMPUNG UTARA,23369,MUARA SUNGKAI,4600,3659,8259
22328,LAMPUNG,22875,LAMPUNG TENGAH,23182,PUTRA RUMBIA,2984,7564,10548
22328,LAMPUNG,22875,LAMPUNG TENGAH,22997,SEPUTIH BANYAK,10431,15373,25804
22328,LAMPUNG,23189,LAMPUNG UTARA,23381,BUNGA MAYANG,9289,9801,19090
22328,LAMPUNG,22875,LAMPUNG TENGAH,23044,BUMI RATU NUBAN,0,0,0
22328,LAMPUNG,22875,LAMPUNG TENGAH,22937,TRIMURJO,14700,15086,29786
22328,LAMPUNG,23189,LAMPUNG UTARA,23190,BUKIT KEMUNING,12022,8881,20903
22328,LAMPUNG,22875,LAMPUNG TENGAH,23022,SEPUTIH SURABAYA,0,0,0
22328,LAMPUNG,22875,LAMPUNG TENGAH,23158,WAY SEPUTIH,4372,5452,9824
22328,LAMPUNG,23189,LAMPUNG UTARA,23423,SUNGKAI JAYA,2863,1477,4340
22328,LAMPUNG,22875,LAMPUNG TENGAH,23054,BEKRI,5992,7848,13840
22328,LAMPUNG,22875,LAMPUNG TENGAH,22921,GUNUNG SUGIH,21134,15244,36378
22328,LAMPUNG,22875,LAMPUNG TENGAH,22962,TERBANGGI BESAR,30702,28699,59401
22328,LAMPUNG,22875,LAMPUNG TENGAH,22988,RUMBIA,0,0,0
22328,LAMPUNG,23189,LAMPUNG UTARA,23433,SUNGKAI BARAT,3889,1979,5868
22328,LAMPUNG,23189,LAMPUNG UTARA,23245,ABUNG TIMUR,10640,9879,20519
22328,LAMPUNG,22875,LAMPUNG TENGAH,23009,SEPUTIH MATARAM,0,0,0
22328,LAMPUNG,23189,LAMPUNG UTARA,23199,KOTABUMI,17105,9815,26920
22328,LAMPUNG,23189,LAMPUNG UTARA,23393,HULU SUNGKAI,4298,3246,7544
22328,LAMPUNG,22875,LAMPUNG TENGAH,22952,PUNGGUR,10383,10495,20878
22328,LAMPUNG,23189,LAMPUNG UTARA,23213,SUNGKAI SELATAN,7158,4587,11745
22328,LAMPUNG,23189,LAMPUNG UTARA,23330,ABUNG TENGAH,4872,4274,9146
22328,LAMPUNG,23460,LAMPUNG BARAT,23621,GEDUNG SURIAN,3284,6243,9527
22328,LAMPUNG,23189,LAMPUNG UTARA,23225,TANJUNG RAJA,10734,6405,17139
22328,LAMPUNG,23189,LAMPUNG UTARA,23290,SUNGKAI UTARA,9410,8598,18008
22328,LAMPUNG,23189,LAMPUNG UTARA,23413,ABUNG PEKURUN,3630,2241,5871
22328,LAMPUNG,23189,LAMPUNG UTARA,23404,SUNGKAI TENGAH,3722,4817,8539
22328,LAMPUNG,23189,LAMPUNG UTARA,23342,ABUNG TINGGI,6167,2888,9055
22328,LAMPUNG,23189,LAMPUNG UTARA,23452,BLAMBANGAN PAGAR,5002,5087,10089
22328,LAMPUNG,23189,LAMPUNG UTARA,23351,ABUNG SEMULI,6774,6828,13602
22328,LAMPUNG,23460,LAMPUNG BARAT,23461,PESISIR SELATAN,4192,7113,11305
22328,LAMPUNG,23460,LAMPUNG BARAT,23727,BANDAR NEGERI SUOH,3554,12461,16015
22328,LAMPUNG,23189,LAMPUNG UTARA,23444,ABUNG KUNANG,3602,1725,5327
22328,LAMPUNG,23460,LAMPUNG BARAT,23627,NGAMBUR,2966,6534,9500
22328,LAMPUNG,23189,LAMPUNG UTARA,23273,ABUNG SELATAN,13790,12211,26001
22328,LAMPUNG,23460,LAMPUNG BARAT,23673,LUMBOK SEMINUNG,1344,2767,4111
22328,LAMPUNG,23460,LAMPUNG BARAT,23637,BANGKUNAT BELIMBING,6748,7624,14372
22328,LAMPUNG,23460,LAMPUNG BARAT,23486,PESISIR UTARA,2334,1998,4332
22328,LAMPUNG,23189,LAMPUNG UTARA,23258,ABUNG BARAT,6751,3720,10471
22328,LAMPUNG,23460,LAMPUNG BARAT,23597,LEMONG,2804,4201,7005
22328,LAMPUNG,23460,LAMPUNG BARAT,23706,PAGAR DEWA,4442,7097,11539
22328,LAMPUNG,23189,LAMPUNG UTARA,23306,KOTABUMI UTARA,8436,9019,17455
22328,LAMPUNG,23189,LAMPUNG UTARA,23315,KOTABUMI SELATAN,23409,10075,33484
22328,LAMPUNG,23460,LAMPUNG BARAT,23525,BELALAU,3214,4594,7808
22328,LAMPUNG,23460,LAMPUNG BARAT,23573,SUKAU,5589,6182,11771
22328,LAMPUNG,23460,LAMPUNG BARAT,23536,WAY TENONG,8031,7973,16004
22328,LAMPUNG,23460,LAMPUNG BARAT,23518,SUMBER JAYA,5894,6786,12680
22328,LAMPUNG,23460,LAMPUNG BARAT,23716,BATU KETULIS,3145,4511,7656
22328,LAMPUNG,23460,LAMPUNG BARAT,23695,KEBUN TEBU,3788,6998,10786
22328,LAMPUNG,23460,LAMPUNG BARAT,23584,KARYA PENGGAWA,2485,3268,5753
22328,LAMPUNG,23460,LAMPUNG BARAT,23662,WAY KRUI,2098,2040,4138
22328,LAMPUNG,23460,LAMPUNG BARAT,23552,SUOH,2539,8688,11227
22328,LAMPUNG,23460,LAMPUNG BARAT,23684,AIR HITAM,1855,5112,6967
22328,LAMPUNG,23737,TULANG BAWANG,23862,GEDUNG AJI BARU,5159,5937,11096
22328,LAMPUNG,23460,LAMPUNG BARAT,23477,PESISIR TENGAH,4901,3958,8859
22328,LAMPUNG,23460,LAMPUNG BARAT,23651,KRUI SELATAN,1876,2190,4066
22328,LAMPUNG,23460,LAMPUNG BARAT,23546,SEKINCAU,4000,6367,10367
22328,LAMPUNG,23737,TULANG BAWANG,23738,MENGGALA,13801,8094,21895
22328,LAMPUNG,23460,LAMPUNG BARAT,23611,BENGKUNAT,1693,2637,4330
22328,LAMPUNG,23737,TULANG BAWANG,23833,RAWA PITU,3671,5030,8701
22328,LAMPUNG,23460,LAMPUNG BARAT,23561,BATU BRAK,4509,3365,7874
22328,LAMPUNG,23737,TULANG BAWANG,23853,MERAKSA AJI,2683,4573,7256
22328,LAMPUNG,23460,LAMPUNG BARAT,23505,BALIK BUKIT,9850,9071,18921
22328,LAMPUNG,23737,TULANG BAWANG,23796,PENAWAR TAMA,5193,10065,15258
22328,LAMPUNG,23460,LAMPUNG BARAT,83871,PULAUPISANG,420,483,903
22328,LAMPUNG,23737,TULANG BAWANG,23843,PENAWAR AJI,2945,6682,9627
22328,LAMPUNG,23737,TULANG BAWANG,23879,BANJAR BARU,4256,3655,7911
22328,LAMPUNG,23737,TULANG BAWANG,23867,DENTE TELADAS,11203,16059,27262
22328,LAMPUNG,23737,TULANG BAWANG,23773,GEDUNG MENENG,12145,8936,21081
22328,LAMPUNG,23737,TULANG BAWANG,23785,RAWA JITU SELATAN,7308,8111,15419
22328,LAMPUNG,23737,TULANG BAWANG,23811,RAWA JITU TIMUR,3723,3535,7258
22328,LAMPUNG,23737,TULANG BAWANG,23820,BANJAR MARGO,6913,11789,18702
22328,LAMPUNG,23737,TULANG BAWANG,23890,MENGGALA TIMUR,4136,4044,8180
22328,LAMPUNG,23903,TANGGAMUS,23904,KOTA AGUNG,13219,8682,21901
22328,LAMPUNG,23737,TULANG BAWANG,23760,BANJAR AGUNG,9065,11866,20931
22328,LAMPUNG,23903,TANGGAMUS,24175,AIR NANINGAN,6446,9399,15845
22328,LAMPUNG,23903,TANGGAMUS,24141,GUNUNG ALIP,7502,2452,9954
22328,LAMPUNG,23903,TANGGAMUS,24132,GISTING,11552,10386,21938
22328,LAMPUNG,23903,TANGGAMUS,24120,KOTA AGUNG TIMUR,5999,3851,9850
22328,LAMPUNG,23903,TANGGAMUS,24164,BANDAR NEGERI SEMUONG,4143,2959,7102
22328,LAMPUNG,23903,TANGGAMUS,24080,PEMATANG SAWA,4187,5017,9204
22328,LAMPUNG,23903,TANGGAMUS,24064,ULU BELU,8822,15824,24646
22328,LAMPUNG,23903,TANGGAMUS,24153,LIMAU,5774,5649,11423
22328,LAMPUNG,23903,TANGGAMUS,23920,TALANG PADANG,15246,8169,23415
22328,LAMPUNG,23737,TULANG BAWANG,23749,GEDUNG AJI,2963,4177,7140
22328,LAMPUNG,23903,TANGGAMUS,24185,BULOK,5741,5552,11293
22328,LAMPUNG,24202,LAMPUNG TIMUR,24389,BUMI AGUNG,4028,6537,10565
22328,LAMPUNG,24202,LAMPUNG TIMUR,24396,BANDAR SRIBHAWONO,8520,16946,25466
22328,LAMPUNG,23903,TANGGAMUS,24103,KOTA AGUNG BARAT,7870,2479,10349
22328,LAMPUNG,24202,LAMPUNG TIMUR,24404,MATARAM BARU,7243,6867,14110
22328,LAMPUNG,24202,LAMPUNG TIMUR,24434,WAWAY KARYA,7262,11813,19075
22328,LAMPUNG,23903,TANGGAMUS,23940,WONOSOBO,9505,8407,17912
22328,LAMPUNG,23903,TANGGAMUS,24094,KLUMBAYAN,3312,3053,6365
22328,LAMPUNG,24202,LAMPUNG TIMUR,24466,WAY BUNGUR,6184,6650,12834
22328,LAMPUNG,23903,TANGGAMUS,24002,PUGUNG,17210,12849,30059
22328,LAMPUNG,23903,TANGGAMUS,24195,KLUMBAYAN BARAT,2504,4011,6515
22328,LAMPUNG,23903,TANGGAMUS,24029,SEMAKA,9700,10814,20514
22328,LAMPUNG,23903,TANGGAMUS,23964,PULAU PANGGUNG,10590,8366,18956
22328,LAMPUNG,23903,TANGGAMUS,23983,CUKUH BALAK,6671,5921,12592
22328,LAMPUNG,24202,LAMPUNG TIMUR,24412,MELINTING,7092,6258,13350
22328,LAMPUNG,24202,LAMPUNG TIMUR,24221,LABUHAN MARINGGAI,15344,17773,33117
22328,LAMPUNG,24202,LAMPUNG TIMUR,24375,BATANGHARI NUBAN,13191,11497,24688
22328,LAMPUNG,24202,LAMPUNG TIMUR,24233,JABUNG,14974,11938,26912
22328,LAMPUNG,23903,TANGGAMUS,24050,SUMBER REJO,7162,11835,18997
22328,LAMPUNG,24202,LAMPUNG TIMUR,24446,LABUHAN RATU,9509,14686,24195
22328,LAMPUNG,24202,LAMPUNG TIMUR,24203,SUKADANA,16048,20971,37019
22328,LAMPUNG,24484,WAY KANAN,24485,BLAMBANGAN UMPU,15627,17377,33004
22328,LAMPUNG,24202,LAMPUNG TIMUR,24337,METRO KIBANG,3696,8757,12453
22328,LAMPUNG,24202,LAMPUNG TIMUR,24325,RAMAN UTARA,8379,13592,21971
22328,LAMPUNG,24202,LAMPUNG TIMUR,24312,PURBOLINGGO,11947,12203,24150
22328,LAMPUNG,24202,LAMPUNG TIMUR,24419,GUNUNG PELINDUNG,5656,4853,10509
22328,LAMPUNG,24202,LAMPUNG TIMUR,24425,PASIR SAKTI,7267,11532,18799
22328,LAMPUNG,24202,LAMPUNG TIMUR,24458,BRAJA SELEBAH,4243,7450,11693
22328,LAMPUNG,24202,LAMPUNG TIMUR,24249,PEKALONGAN,12982,14914,27896
22328,LAMPUNG,24202,LAMPUNG TIMUR,24345,MARGA TIGA,9349,15063,24412
22328,LAMPUNG,24202,LAMPUNG TIMUR,24359,SEKAMPUNG UDIK,12570,25441,38011
22328,LAMPUNG,24484,WAY KANAN,24691,BUAY BAHUGA,6544,4884,11428
22328,LAMPUNG,24484,WAY KANAN,24602,NEGERI AGUNG,8245,12719,20964
22328,LAMPUNG,24484,WAY KANAN,24621,WAY TUBA,6969,5816,12785
22328,LAMPUNG,24484,WAY KANAN,24645,GUNUNG LABUHAN,7220,7314,14534
22328,LAMPUNG,24202,LAMPUNG TIMUR,24475,MARGA SEKAMPUNG,5634,9094,14728
22328,LAMPUNG,24484,WAY KANAN,24573,BAHUGA,2582,3552,6134
22328,LAMPUNG,24202,LAMPUNG TIMUR,24260,SEKAMPUNG,13038,22103,35141
22328,LAMPUNG,24202,LAMPUNG TIMUR,24296,WAY JEPARA,11540,16469,28009
22328,LAMPUNG,24202,LAMPUNG TIMUR,24278,BATANGHARI,14832,17860,32692
22328,LAMPUNG,24484,WAY KANAN,24680,NEGERI BESAR,3560,7351,10911
22328,LAMPUNG,24850,PESAWARAN,24871,NEGERI KATON,16088,19953,36041
22328,LAMPUNG,24484,WAY KANAN,24665,NEGARA BATIN,6849,12418,19267
22328,LAMPUNG,24484,WAY KANAN,24634,REBANG TANGKAS,4776,6773,11549
22328,LAMPUNG,24850,PESAWARAN,24972,KEDONDONG,9382,8520,17902
22328,LAMPUNG,24850,PESAWARAN,83502,WAY KHILAU,8782,5561,14343
22328,LAMPUNG,24850,PESAWARAN,24892,TEGINENENG,12054,18464,30518
22328,LAMPUNG,24484,WAY KANAN,24699,BUMI AGUNG,7544,7178,14722
22328,LAMPUNG,24850,PESAWARAN,24925,PADANG CERMIN,18576,29941,48517
22328,LAMPUNG,24850,PESAWARAN,24851,GEDONG TATAAN,29078,23615,52693
22328,LAMPUNG,22329,PRINGSEWU,22360,AMBARAWA,8945,10042,18987
22328,LAMPUNG,24850,PESAWARAN,24908,WAY LIMA,12499,8331,20830
22328,LAMPUNG,22329,PRINGSEWU,22330,PRINGSEWU,20392,23527,43919
22328,LAMPUNG,24484,WAY KANAN,24510,KASUI,8025,8924,16949
22328,LAMPUNG,22329,PRINGSEWU,22425,SUKOHARJO,12013,12248,24261
22328,LAMPUNG,24484,WAY KANAN,24550,BARADATU,10836,10975,21811
22328,LAMPUNG,24484,WAY KANAN,24582,PAKUAN RATU,8196,15577,23773
22328,LAMPUNG,22439,MESUJI,22440,MESUJI,3073,6557,9630
22328,LAMPUNG,22329,PRINGSEWU,22406,BANYUMAS,5070,5724,10794
22328,LAMPUNG,24484,WAY KANAN,24529,BANJIT,10766,14072,24838
22328,LAMPUNG,24850,PESAWARAN,24949,PUNDUH PIDADA,3152,4742,7894
22328,LAMPUNG,22329,PRINGSEWU,83503,PAGELARAN UTARA,3380,4025,7405
22328,LAMPUNG,22329,PRINGSEWU,22416,ADILUWIH,8304,10223,18527
22328,LAMPUNG,22522,TULANG BAWANG BARAT,22548,GUNUNG TERANG,6907,11290,18197
22328,LAMPUNG,22439,MESUJI,22490,SIMPANG PEMATANG,8152,5796,13948
22328,LAMPUNG,22329,PRINGSEWU,22344,GADING REJO,21132,21505,42637
22328,LAMPUNG,22439,MESUJI,22464,RAWA JITU UTARA,6025,7080,13105
22328,LAMPUNG,22439,MESUJI,22508,TANJUNG RAYA,9256,11694,20950
22328,LAMPUNG,22329,PRINGSEWU,22368,PARDASUKA,9227,9407,18634
22328,LAMPUNG,24850,PESAWARAN,83501,MARGA PUNDUH,3949,4188,8137
22328,LAMPUNG,22329,PRINGSEWU,22381,PAGELARAN,14214,12974,27188
22328,LAMPUNG,22522,TULANG BAWANG BARAT,22581,PAGAR DEWA,1567,1846,3413
22328,LAMPUNG,22439,MESUJI,22476,WAY SERDANG,8697,14530,23227
22328,LAMPUNG,24709,KOTA BANDAR LAMPUNG,24806,SUKABUMI,14930,13529,28459
22328,LAMPUNG,22439,MESUJI,22450,MESUJI TIMUR,6093,11419,17512
22328,LAMPUNG,22522,TULANG BAWANG BARAT,22538,TULANG BAWANG UDIK,9087,8880,17967
22328,LAMPUNG,22522,TULANG BAWANG BARAT,22569,TUMIJAJAR,12035,12019,24054
22328,LAMPUNG,22439,MESUJI,22500,PANCA JAYA,3828,5505,9333
22328,LAMPUNG,24709,KOTA BANDAR LAMPUNG,24796,RAJABASA,12873,8524,21397
22328,LAMPUNG,24709,KOTA BANDAR LAMPUNG,24710,KEDATON,13389,11950,25339
22328,LAMPUNG,22522,TULANG BAWANG BARAT,22523,TULANG BAWANG TENGAH,23535,22445,45980
22328,LAMPUNG,24709,KOTA BANDAR LAMPUNG,24801,TANJUNG SENANG,12387,11279,23666
22328,LAMPUNG,24709,KOTA BANDAR LAMPUNG,83505,WAY HALIM,14706,16777,31483
22328,LAMPUNG,22522,TULANG BAWANG BARAT,22598,WAY KENANGA,3948,7789,11737
22328,LAMPUNG,22522,TULANG BAWANG BARAT,22560,LAMBU KIBANG,5716,7496,13212
22328,LAMPUNG,24709,KOTA BANDAR LAMPUNG,83504,LABUHAN RATU,12448,9195,21643
22328,LAMPUNG,24709,KOTA BANDAR LAMPUNG,83506,LANGKAPURA,10345,6788,17133
22328,LAMPUNG,22522,TULANG BAWANG BARAT,22587,GUNUNG AGUNG,6252,11866,18118
22328,LAMPUNG,24709,KOTA BANDAR LAMPUNG,24719,SUKARAME,16429,13325,29754
22328,LAMPUNG,24709,KOTA BANDAR LAMPUNG,24814,KEMILING,20159,13893,34052
22328,LAMPUNG,24709,KOTA BANDAR LAMPUNG,83508,KEDAMAIAN,11341,13007,24348
22328,LAMPUNG,24709,KOTA BANDAR LAMPUNG,83507,ENGGAL,7080,6082,13162
22328,LAMPUNG,24709,KOTA BANDAR LAMPUNG,24752,TANJUNGKARANG PUSAT,13571,11046,24617
24993,KEPULAUAN BANGKA BELITUNG,24994,BANGKA,24995,SUNGAILIAT,0,0,0
22328,LAMPUNG,24709,KOTA BANDAR LAMPUNG,24764,TELUKBETUNG SELATAN,8678,11231,19909
22328,LAMPUNG,24822,KOTA METRO,24829,METRO UTARA,6733,7972,14705
22328,LAMPUNG,24822,KOTA METRO,24845,METRO SELATAN,4363,4502,8865
22328,LAMPUNG,24822,KOTA METRO,24839,METRO TIMUR,10099,9804,19903
22328,LAMPUNG,24709,KOTA BANDAR LAMPUNG,83509,TELUKBETUNG TIMUR,8894,11855,20749
22328,LAMPUNG,24709,KOTA BANDAR LAMPUNG,24725,TANJUNGKARANG BARAT,15070,12050,27120
24993,KEPULAUAN BANGKA BELITUNG,24994,BANGKA,25012,MERAWANG,0,0,0
22328,LAMPUNG,24709,KOTA BANDAR LAMPUNG,83510,BUMI WARAS,9732,17938,27670
24993,KEPULAUAN BANGKA BELITUNG,24994,BANGKA,25023,MENDO BARAT,0,0,0
22328,LAMPUNG,24822,KOTA METRO,24823,METRO PUSAT,13634,12560,26194
22328,LAMPUNG,24709,KOTA BANDAR LAMPUNG,24785,TELUKBETUNG UTARA,12096,13208,25304
22328,LAMPUNG,24709,KOTA BANDAR LAMPUNG,24740,TANJUNGKARANG TIMUR,9096,9084,18180
22328,LAMPUNG,24709,KOTA BANDAR LAMPUNG,24732,PANJANG,13157,21583,34740
24993,KEPULAUAN BANGKA BELITUNG,24994,BANGKA,25064,PUDING BESAR,0,0,0
22328,LAMPUNG,24709,KOTA BANDAR LAMPUNG,24776,TELUKBETUNG BARAT,7144,8133,15277
22328,LAMPUNG,24822,KOTA METRO,24834,METRO BARAT,7103,7004,14107
24993,KEPULAUAN BANGKA BELITUNG,25072,BELITUNG,25073,TANJUNG PANDAN,0,0,0
24993,KEPULAUAN BANGKA BELITUNG,24994,BANGKA,25003,BELINYU,0,0,0
24993,KEPULAUAN BANGKA BELITUNG,25120,BANGKA SELATAN,25140,AIR GEGAS,4937,10700,15637
24993,KEPULAUAN BANGKA BELITUNG,25120,BANGKA SELATAN,25151,SIMPANG RIMBA,2378,7674,10052
24993,KEPULAUAN BANGKA BELITUNG,25072,BELITUNG,25086,MEMBALONG,0,0,0
24993,KEPULAUAN BANGKA BELITUNG,25120,BANGKA SELATAN,25121,TOBOALI,9492,20385,29877
24993,KEPULAUAN BANGKA BELITUNG,24994,BANGKA,25054,RIAU SILIP,0,0,0
24993,KEPULAUAN BANGKA BELITUNG,25181,BANGKA TENGAH,25182,KOBA,5218,10397,15615
24993,KEPULAUAN BANGKA BELITUNG,25120,BANGKA SELATAN,25159,PAYUNG,3945,5554,9499
24993,KEPULAUAN BANGKA BELITUNG,24994,BANGKA,25044,BAKAM,0,0,0
24993,KEPULAUAN BANGKA BELITUNG,25120,BANGKA SELATAN,25175,PULAUBESAR,1102,3247,4349
24993,KEPULAUAN BANGKA BELITUNG,25120,BANGKA SELATAN,25133,LEPAR PONGOK,1035,2578,3613
24993,KEPULAUAN BANGKA BELITUNG,24994,BANGKA,25037,PEMALI,0,0,0
24993,KEPULAUAN BANGKA BELITUNG,25181,BANGKA TENGAH,25228,NAMANG,2417,4033,6450
24993,KEPULAUAN BANGKA BELITUNG,25181,BANGKA TENGAH,25217,SIMPANG KATIS,3609,5884,9493
24993,KEPULAUAN BANGKA BELITUNG,25072,BELITUNG,25099,SELAT NASIK,0,0,0
24993,KEPULAUAN BANGKA BELITUNG,25072,BELITUNG,25113,BADAU,0,0,0
24993,KEPULAUAN BANGKA BELITUNG,25072,BELITUNG,25104,SIJUK,0,0,0
24993,KEPULAUAN BANGKA BELITUNG,25316,BELITUNG TIMUR,25317,MANGGAR,5785,12291,18076
24993,KEPULAUAN BANGKA BELITUNG,25181,BANGKA TENGAH,25236,LUBUK BESAR,2621,8581,11202
24993,KEPULAUAN BANGKA BELITUNG,25316,BELITUNG TIMUR,25340,KELAPA KAMPIT,3709,6222,9931
24993,KEPULAUAN BANGKA BELITUNG,25181,BANGKA TENGAH,25205,SUNGAI SELAN,3811,10194,14005
24993,KEPULAUAN BANGKA BELITUNG,25120,BANGKA SELATAN,25169,TUKAK SADAI,1253,4326,5579
24993,KEPULAUAN BANGKA BELITUNG,25245,BANGKA BARAT,25268,JEBUS,2873,6781,9654
24993,KEPULAUAN BANGKA BELITUNG,25120,BANGKA SELATAN,83511,KEPULAUAN PONGOK,432,1771,2203
24993,KEPULAUAN BANGKA BELITUNG,25245,BANGKA BARAT,25305,PARITTIGA,2588,12202,14790
24993,KEPULAUAN BANGKA BELITUNG,25181,BANGKA TENGAH,25194,PANGKALAN BARU,4402,13618,18020
24993,KEPULAUAN BANGKA BELITUNG,25316,BELITUNG TIMUR,25347,DAMAR,1879,4620,6499
24993,KEPULAUAN BANGKA BELITUNG,25245,BANGKA BARAT,25254,SIMPANG TERITIP,3094,9840,12934
24993,KEPULAUAN BANGKA BELITUNG,25316,BELITUNG TIMUR,25327,GANTUNG,3460,9386,12846
24993,KEPULAUAN BANGKA BELITUNG,25363,KOTA PANGKALPINANG,25388,RANGKUI,6481,9323,15804
24993,KEPULAUAN BANGKA BELITUNG,25245,BANGKA BARAT,25246,MUNTOK,6764,15251,22015
24993,KEPULAUAN BANGKA BELITUNG,25245,BANGKA BARAT,25280,KELAPA,3832,11573,15405
24993,KEPULAUAN BANGKA BELITUNG,25316,BELITUNG TIMUR,25335,DENDANG,1524,3909,5433
24993,KEPULAUAN BANGKA BELITUNG,25363,KOTA PANGKALPINANG,25372,TAMAN SARI,4880,4680,9560
24993,KEPULAUAN BANGKA BELITUNG,25316,BELITUNG TIMUR,25358,SIMPANG PESAK,986,3364,4350
24993,KEPULAUAN BANGKA BELITUNG,25363,KOTA PANGKALPINANG,25364,BUKITINTAN,4901,10417,15318
24993,KEPULAUAN BANGKA BELITUNG,25245,BANGKA BARAT,25295,TEMPILANG,3330,9069,12399
25405,KEPULAUAN RIAU,25471,BINTAN,25488,TELUK BINTAN,2081,3394,5475
25405,KEPULAUAN RIAU,25471,BINTAN,25517,MANTANG,944,1081,2025
25405,KEPULAUAN RIAU,25471,BINTAN,25527,SERI KUALA LOBAM,3175,4220,7395
24993,KEPULAUAN BANGKA BELITUNG,25363,KOTA PANGKALPINANG,25377,PANGKAL BALAM,3542,5719,9261
25405,KEPULAUAN RIAU,25471,BINTAN,25472,GUNUNG KIJANG,2001,4687,6688
25405,KEPULAUAN RIAU,25533,KARIMUN,25534,MORO,2902,6257,9159
24993,KEPULAUAN BANGKA BELITUNG,25363,KOTA PANGKALPINANG,25398,GERUNGGANG,8347,6642,14989
24993,KEPULAUAN BANGKA BELITUNG,25316,BELITUNG TIMUR,25353,SIMPANG RENGGIANG,1199,3025,4224
25405,KEPULAUAN RIAU,25471,BINTAN,25504,TELOK SEBONG,2606,4966,7572
24993,KEPULAUAN BANGKA BELITUNG,25363,KOTA PANGKALPINANG,83513,GIRIMAYA,2556,6631,9187
25405,KEPULAUAN RIAU,25533,KARIMUN,25577,KUNDUR UTARA,1636,3855,5491
25405,KEPULAUAN RIAU,25471,BINTAN,25512,TOAPAYA,1985,4026,6011
24993,KEPULAUAN BANGKA BELITUNG,25363,KOTA PANGKALPINANG,83512,GABEK,5096,6291,11387
25405,KEPULAUAN RIAU,25471,BINTAN,25522,BINTAN PESISIR,1111,2668,3779
25405,KEPULAUAN RIAU,25533,KARIMUN,25586,KUNDUR BARAT,2488,6027,8515
25405,KEPULAUAN RIAU,25471,BINTAN,25495,TAMBELAN,945,1370,2315
25405,KEPULAUAN RIAU,25597,NATUNA,25673,BUNGURAN SELATAN,403,940,1343
25405,KEPULAUAN RIAU,25533,KARIMUN,25564,TEBING,4654,6377,11031
25405,KEPULAUAN RIAU,25533,KARIMUN,25542,KUNDUR,3604,9532,13136
25405,KEPULAUAN RIAU,25533,KARIMUN,25592,DURAI,1184,1655,2839
25405,KEPULAUAN RIAU,25471,BINTAN,25477,BINTAN TIMUR,8196,11772,19968
25405,KEPULAUAN RIAU,25597,NATUNA,25650,PULAU TIGA,620,1661,2281
25405,KEPULAUAN RIAU,25471,BINTAN,25482,BINTAN UTARA,4073,5479,9552
25405,KEPULAUAN RIAU,25597,NATUNA,25646,PULAU LAUT,162,843,1005
25405,KEPULAUAN RIAU,25533,KARIMUN,83516,BELAT,833,2161,2994
25405,KEPULAUAN RIAU,25597,NATUNA,25605,BUNGURAN BARAT,1195,3899,5094
25405,KEPULAUAN RIAU,25533,KARIMUN,83515,UNGAR,753,1828,2581
25405,KEPULAUAN RIAU,25533,KARIMUN,25551,KARIMUN,7212,11466,18678
25405,KEPULAUAN RIAU,25533,KARIMUN,25558,MERAL,6103,10932,17035
25405,KEPULAUAN RIAU,25533,KARIMUN,83514,MERAL BARAT,2673,3130,5803
25405,KEPULAUAN RIAU,25683,LINGGA,25696,LINGGA,1868,3880,5748
25405,KEPULAUAN RIAU,25597,NATUNA,25598,MIDAI,684,1734,2418
25405,KEPULAUAN RIAU,25683,LINGGA,25715,SENAYANG,2671,7350,10021
25405,KEPULAUAN RIAU,25597,NATUNA,25628,BUNGURAN UTARA,445,1390,1835
25405,KEPULAUAN RIAU,25597,NATUNA,25637,SUBI,358,964,1322
25405,KEPULAUAN RIAU,25683,LINGGA,25736,SINGKEP BARAT,1711,6401,8112
25405,KEPULAUAN RIAU,25597,NATUNA,25661,BUNGURAN TIMUR LAUT,717,1542,2259
25405,KEPULAUAN RIAU,25533,KARIMUN,25572,BURU,1801,2289,4090
25405,KEPULAUAN RIAU,25429,KEPULAUAN ANAMBAS,25433,PALMATAK,1582,4248,5830
25405,KEPULAUAN RIAU,25597,NATUNA,25669,BUNGURAN TENGAH,519,1160,1679
25405,KEPULAUAN RIAU,25683,LINGGA,25684,SINGKEP,4141,7582,11723
25405,KEPULAUAN RIAU,25683,LINGGA,83519,SELAYAR,523,1168,1691
25405,KEPULAUAN RIAU,25683,LINGGA,83518,LINGGA TIMUR,711,1352,2063
25405,KEPULAUAN RIAU,25597,NATUNA,25615,SERASAN,824,1427,2251
25405,KEPULAUAN RIAU,25429,KEPULAUAN ANAMBAS,25447,SIANTAN SELATAN,493,1384,1877
25405,KEPULAUAN RIAU,25429,KEPULAUAN ANAMBAS,25454,JEMAJA TIMUR,299,879,1178
25405,KEPULAUAN RIAU,25746,KOTA BATAM,25785,SEI BEDUK,16320,21476,37796
25405,KEPULAUAN RIAU,25429,KEPULAUAN ANAMBAS,25467,SIANTAN TENGAH,369,1314,1683
25405,KEPULAUAN RIAU,25429,KEPULAUAN ANAMBAS,25443,SIANTAN TIMUR,407,1509,1916
25405,KEPULAUAN RIAU,25597,NATUNA,25678,SERASAN TIMUR,582,787,1369
25405,KEPULAUAN RIAU,25746,KOTA BATAM,25799,BENGKONG,22084,24017,46101
25405,KEPULAUAN RIAU,25597,NATUNA,25621,BUNGURAN TIMUR,3447,6025,9472
25405,KEPULAUAN RIAU,25429,KEPULAUAN ANAMBAS,25430,SIANTAN,1505,3738,5243
25405,KEPULAUAN RIAU,25746,KOTA BATAM,25772,BULANG,2299,3173,5472
25405,KEPULAUAN RIAU,25746,KOTA BATAM,25747,BELAKANG PADANG,5232,4839,10071
25405,KEPULAUAN RIAU,25683,LINGGA,25727,LINGGA UTARA,1757,3567,5324
25405,KEPULAUAN RIAU,25746,KOTA BATAM,25754,BATU AMPAR,11830,15001,26831
25405,KEPULAUAN RIAU,25429,KEPULAUAN ANAMBAS,25459,JEMAJA,813,2073,2886
25405,KEPULAUAN RIAU,25746,KOTA BATAM,25759,SEKUPANG,26582,24665,51247
25823,DKI JAKARTA,25833,JAKARTA PUSAT,25841,SAWAH BESAR,20833,46016,66849
25405,KEPULAUAN RIAU,25683,LINGGA,83517,SINGKEP PESISIR,636,1643,2279
25405,KEPULAUAN RIAU,25406,KOTA TANJUNGPINANG,25412,TANJUNG PINANG TIMUR,15927,17881,33808
25405,KEPULAUAN RIAU,25746,KOTA BATAM,25811,SAGULUNG,33442,41770,75212
25823,DKI JAKARTA,25833,JAKARTA PUSAT,25834,GAMBIR,20496,30787,51283
25405,KEPULAUAN RIAU,25746,KOTA BATAM,25779,LUBUK BAJA,11558,25337,36895
25405,KEPULAUAN RIAU,25746,KOTA BATAM,25804,BATAM KOTA,31612,45129,76741
25823,DKI JAKARTA,25824,KEPULAUAN SERIBU,25829,KEPULAUAN SERIBU SELATAN,2222,3112,5334
25405,KEPULAUAN RIAU,25746,KOTA BATAM,25790,GALANG,3555,4248,7803
25823,DKI JAKARTA,25833,JAKARTA PUSAT,25867,MENTENG,24676,22392,47068
25405,KEPULAUAN RIAU,25406,KOTA TANJUNGPINANG,25418,TANJUNG PINANG KOTA,2848,6745,9593
25823,DKI JAKARTA,25824,KEPULAUAN SERIBU,25825,KEPULAUAN SERIBU UTARA,4684,4977,9661
25405,KEPULAUAN RIAU,25406,KOTA TANJUNGPINANG,25407,TANJUNG PINANG BARAT,9135,14998,24133
25823,DKI JAKARTA,25886,JAKARTA UTARA,25901,KOJA,76160,79492,155652
25823,DKI JAKARTA,25886,JAKARTA UTARA,25893,TANJUNG PRIOK,81605,119515,201120
25823,DKI JAKARTA,25833,JAKARTA PUSAT,25881,JOHAR BARU,33646,36654,70300
25405,KEPULAUAN RIAU,25406,KOTA TANJUNGPINANG,25423,BUKIT BESTARI,10354,15397,25751
25405,KEPULAUAN RIAU,25746,KOTA BATAM,25767,NONGSA,13019,13796,26815
25823,DKI JAKARTA,25886,JAKARTA UTARA,25920,KELAPA GADING,22434,54308,76742
25405,KEPULAUAN RIAU,25746,KOTA BATAM,25818,BATU AJI,24713,33715,58428
25823,DKI JAKARTA,25924,JAKARTA BARAT,25961,KEBON JERUK,81193,94976,176169
25823,DKI JAKARTA,25924,JAKARTA BARAT,25940,TAMAN SARI,22009,46806,68815
25823,DKI JAKARTA,25886,JAKARTA UTARA,25887,PENJARINGAN,43759,114244,158003
25823,DKI JAKARTA,25833,JAKARTA PUSAT,25847,KEMAYORAN,57222,70723,127945
25823,DKI JAKARTA,25924,JAKARTA BARAT,25969,KALIDERES,82413,117760,200173
25823,DKI JAKARTA,25924,JAKARTA BARAT,25932,GROGOL PETAMBURAN,34891,89315,124206
25823,DKI JAKARTA,25886,JAKARTA UTARA,25908,CILINCING,93382,93794,187176
25823,DKI JAKARTA,25989,JAKARTA SELATAN,25990,TEBET,73056,56072,129128
25823,DKI JAKARTA,25989,JAKARTA SELATAN,26052,JAGAKARSA,93772,74947,168719
25823,DKI JAKARTA,25833,JAKARTA PUSAT,25856,SENEN,31210,33278,64488
25823,DKI JAKARTA,25924,JAKARTA BARAT,25949,TAMBORA,47244,87464,134708
25823,DKI JAKARTA,25989,JAKARTA SELATAN,26028,CILANDAK,53703,59416,113119
25823,DKI JAKARTA,25924,JAKARTA BARAT,25975,PAL MERAH,56840,56627,113467
25823,DKI JAKARTA,25833,JAKARTA PUSAT,25863,CEMPAKA PUTIH,26630,26216,52846
25823,DKI JAKARTA,25924,JAKARTA BARAT,25982,KEMBANGAN,61233,79413,140646
25823,DKI JAKARTA,25989,JAKARTA SELATAN,26045,PANCORAN,53147,36630,89777
25823,DKI JAKARTA,25833,JAKARTA PUSAT,25873,TANAH ABANG,44003,42600,86603
25823,DKI JAKARTA,26065,JAKARTA TIMUR,26112,DUREN SAWIT,117132,105800,222932
25823,DKI JAKARTA,26065,JAKARTA TIMUR,26104,CAKUNG,140363,112921,253284
25823,DKI JAKARTA,26065,JAKARTA TIMUR,26090,KRAMATJATI,84430,65653,150083
25823,DKI JAKARTA,25886,JAKARTA UTARA,25916,PADEMANGAN,25556,56042,81598
25823,DKI JAKARTA,25989,JAKARTA SELATAN,26007,MAMPANG PRAPATAN,46816,37005,83821
25823,DKI JAKARTA,25924,JAKARTA BARAT,25925,CENGKARENG,93992,169742,263734
25823,DKI JAKARTA,25989,JAKARTA SELATAN,26013,PASAR MINGGU,85216,78402,163618
25823,DKI JAKARTA,26065,JAKARTA TIMUR,26098,PASAR REBO,61182,45274,106456
26141,JAWA BARAT,26142,BOGOR,26143,CIBINONG,107445,58743,166188
25823,DKI JAKARTA,25989,JAKARTA SELATAN,26034,KEBAYORAN BARU,37528,46443,83971
25823,DKI JAKARTA,25989,JAKARTA SELATAN,26059,PESANGGRAHAN,60660,62202,122862
26141,JAWA BARAT,26142,BOGOR,26460,MEGAMENDUNG,36197,15185,51382
25823,DKI JAKARTA,25989,JAKARTA SELATAN,25998,SETIABUDI,32339,32354,64693
26141,JAWA BARAT,26142,BOGOR,26507,DRAMAGA,33786,23243,57029
26141,JAWA BARAT,26142,BOGOR,26472,CARINGIN,43721,15682,59403
25823,DKI JAKARTA,25989,JAKARTA SELATAN,26021,KEBAYORAN LAMA,76241,84957,161198
25823,DKI JAKARTA,26065,JAKARTA TIMUR,26126,CIRACAS,78752,69201,147953
25823,DKI JAKARTA,26065,JAKARTA TIMUR,26081,JATINEGARA,91053,82591,173644
25823,DKI JAKARTA,26065,JAKARTA TIMUR,26132,CIPAYUNG,72928,56525,129453
25823,DKI JAKARTA,26065,JAKARTA TIMUR,26066,MATRAMAN,51239,45677,96916
26141,JAWA BARAT,26142,BOGOR,26425,TENJO,18445,12889,31334
26141,JAWA BARAT,26142,BOGOR,26409,CIGUDEG,33298,21573,54871
26141,JAWA BARAT,26142,BOGOR,26495,CIOMAS,53243,27936,81179
25823,DKI JAKARTA,26065,JAKARTA TIMUR,26120,MAKASAR,56742,51362,108104
26141,JAWA BARAT,26142,BOGOR,26595,LEUWISADENG,24764,9906,34670
25823,DKI JAKARTA,26065,JAKARTA TIMUR,26073,PULOGADUNG,74138,81732,155870
26141,JAWA BARAT,26142,BOGOR,26485,CIJERUK,25985,11818,37803
26141,JAWA BARAT,26142,BOGOR,26556,SUKAJAYA,23045,11893,34938
26141,JAWA BARAT,26142,BOGOR,26435,CIAWI,38803,15353,54156
26141,JAWA BARAT,26142,BOGOR,26234,CARIU,23549,6800,30349
26141,JAWA BARAT,26142,BOGOR,26577,TAJURHALANG,31562,21230,52792
26141,JAWA BARAT,26142,BOGOR,26566,TANJUNGSARI,22245,7669,29914
26141,JAWA BARAT,26142,BOGOR,26398,NANGGUNG,27599,16992,44591
26141,JAWA BARAT,26142,BOGOR,26537,CISEENG,31951,21509,53460
26141,JAWA BARAT,26142,BOGOR,26182,SUKARAJA,61972,28474,90446
26141,JAWA BARAT,26142,BOGOR,26548,RANCA BUNGUR,17186,11940,29126
26141,JAWA BARAT,26142,BOGOR,26449,CISARUA,44885,17662,62547
26141,JAWA BARAT,26142,BOGOR,26221,CILEUNGSI,83013,39646,122659
26141,JAWA BARAT,26142,BOGOR,26518,TAMANSARI,31331,20948,52279
26141,JAWA BARAT,26142,BOGOR,26266,GUNUNG SINDUR,30396,24732,55128
26141,JAWA BARAT,26142,BOGOR,26206,JONGGOL,54417,16908,71325
26141,JAWA BARAT,26142,BOGOR,26585,CIGOMBONG,31090,13430,44520
26141,JAWA BARAT,26142,BOGOR,26527,KLAPANUNGGAL,43103,11655,54758
26141,JAWA BARAT,26142,BOGOR,26323,CIBUNGBULANG,43046,24243,67289
26141,JAWA BARAT,26142,BOGOR,26256,PARUNG,38083,24181,62264
26141,JAWA BARAT,26142,BOGOR,26604,TENJOLAYA,18412,11081,29493
26141,JAWA BARAT,26142,BOGOR,26277,KEMANG,29337,21546,50883
26141,JAWA BARAT,26142,BOGOR,26386,PARUNG PANJANG,29093,26034,55127
26141,JAWA BARAT,26142,BOGOR,26309,CIAMPEA,47438,32069,79507
26141,JAWA BARAT,26142,BOGOR,26196,BABAKAN MADANG,39316,12789,52105
26141,JAWA BARAT,26611,SUKABUMI,26883,KADUDAMPIT,23036,4405,27441
26141,JAWA BARAT,26142,BOGOR,26297,LEUWILIANG,40257,17777,58034
26141,JAWA BARAT,26142,BOGOR,26156,GUNUNG PUTRI,96077,45519,141596
26141,JAWA BARAT,26611,SUKABUMI,26920,KEBON PEDES,12296,3605,15901
26141,JAWA BARAT,26142,BOGOR,26245,SUKAMAKMUR,28131,10448,38579
26141,JAWA BARAT,26142,BOGOR,26167,CITEUREUP,70371,28569,98940
26141,JAWA BARAT,26611,SUKABUMI,26869,CISAAT,49493,13342,62835
26141,JAWA BARAT,26142,BOGOR,26287,BOJONG GEDE,72754,48959,121713
26141,JAWA BARAT,26142,BOGOR,26369,JASINGA,28354,16557,44911
26141,JAWA BARAT,26142,BOGOR,26355,RUMPIN,37497,26711,64208
26141,JAWA BARAT,26142,BOGOR,26339,PAMIJAHAN,44937,22589,67526
26141,JAWA BARAT,26611,SUKABUMI,26910,SUKARAJA,29368,11969,41337
26141,JAWA BARAT,26611,SUKABUMI,26893,CARINGIN,17089,4643,21732
26141,JAWA BARAT,26611,SUKABUMI,26844,CIRACAP,12743,12957,25700
26141,JAWA BARAT,26611,SUKABUMI,27020,CIAMBAR,14021,4480,18501
26141,JAWA BARAT,26611,SUKABUMI,26986,CURUG KEMBAR,8977,6652,15629
26141,JAWA BARAT,26611,SUKABUMI,27013,CIMANGGU,7518,2940,10458
26141,JAWA BARAT,26611,SUKABUMI,26999,CIDADAP,5974,4702,10676
26141,JAWA BARAT,26611,SUKABUMI,26932,SUKALARANG,10061,7749,17810
26141,JAWA BARAT,26611,SUKABUMI,26903,SUKABUMI,19933,6929,26862
26141,JAWA BARAT,26611,SUKABUMI,26926,CIREUNGHAS,11934,3966,15900
26141,JAWA BARAT,26611,SUKABUMI,26966,GEGER BITUNG,13345,6643,19988
26141,JAWA BARAT,26611,SUKABUMI,26837,CIBITUNG,7843,4725,12568
26141,JAWA BARAT,26611,SUKABUMI,26861,CICANTAYAN,22413,6537,28950
26141,JAWA BARAT,26611,SUKABUMI,26993,CIDOLOG,5690,4355,10045
26141,JAWA BARAT,26611,SUKABUMI,26947,PURABAYA,12734,7994,20728
26141,JAWA BARAT,26611,SUKABUMI,26955,NYALINDUNG,17027,8251,25278
26141,JAWA BARAT,26611,SUKABUMI,26853,GUNUNG GURUH,16696,10206,26902
26141,JAWA BARAT,26611,SUKABUMI,26825,SURADE,22275,13833,36108
26141,JAWA BARAT,26611,SUKABUMI,27004,TEGALBULEUD,10384,8152,18536
26141,JAWA BARAT,26611,SUKABUMI,26939,PABUARAN,13497,5910,19407
26141,JAWA BARAT,26611,SUKABUMI,26699,CIKEMBAR,30001,14115,44116
26141,JAWA BARAT,26611,SUKABUMI,26688,WARUNG KIARA,19109,9274,28383
26141,JAWA BARAT,26611,SUKABUMI,26817,KALIBUNDER,9238,3862,13100
26141,JAWA BARAT,26611,SUKABUMI,26974,SAGARANTEN,16677,9050,25727
26141,JAWA BARAT,26611,SUKABUMI,26645,CISOLOK,17889,14646,32535
26141,JAWA BARAT,26611,SUKABUMI,26676,JAMPANG TENGAH,21654,12415,34069
26141,JAWA BARAT,26611,SUKABUMI,26776,KALAPA NUNGGAL,17602,4919,22521
26141,JAWA BARAT,26611,SUKABUMI,26637,BANTAR GADUNG,10444,5410,15854
26141,JAWA BARAT,26611,SUKABUMI,26746,PARAKAN SALAK,16409,4586,20995
26141,JAWA BARAT,26611,SUKABUMI,26628,CIKAKAK,10342,7104,17446
26141,JAWA BARAT,26611,SUKABUMI,26621,SIMPENAN,16730,9556,26286
26141,JAWA BARAT,26611,SUKABUMI,26657,CIKIDANG,16104,9787,25891
26141,JAWA BARAT,26611,SUKABUMI,26791,WALURAN,8082,5091,13173
26141,JAWA BARAT,27026,CIANJUR,27261,TANGGEUNG,13459,8823,22282
26141,JAWA BARAT,26611,SUKABUMI,26612,PELABUHAN RATU,31467,18743,50210
26141,JAWA BARAT,27026,CIANJUR,27288,SINDANGBARANG,12606,13112,25718
26141,JAWA BARAT,26611,SUKABUMI,26720,NAGRAK,27516,15483,42999
26141,JAWA BARAT,26611,SUKABUMI,26808,CIEMAS,13933,10864,24797
26141,JAWA BARAT,26611,SUKABUMI,26797,JAMPANG KULON,14634,6655,21289
26141,JAWA BARAT,27026,CIANJUR,27027,CIANJUR,53353,32961,86314
26141,JAWA BARAT,26611,SUKABUMI,26767,CIDAHU,23638,6806,30444
26141,JAWA BARAT,26611,SUKABUMI,26670,LENGKONG,8482,4949,13431
26141,JAWA BARAT,26611,SUKABUMI,26784,KABANDUNGAN,11733,5710,17443
26141,JAWA BARAT,27026,CIANJUR,27323,NARINGGUL,9805,12395,22200
26141,JAWA BARAT,27026,CIANJUR,27334,CAMPAKAMULYA,7441,4714,12155
26141,JAWA BARAT,26611,SUKABUMI,26709,CIBADAK,38418,16815,55233
26141,JAWA BARAT,26611,SUKABUMI,26740,BOJONG GENTENG,14540,3557,18097
26141,JAWA BARAT,27026,CIANJUR,27274,CIBINONG,15048,15197,30245
26141,JAWA BARAT,26611,SUKABUMI,26731,PARUNG KUDA,25828,9301,35129
26141,JAWA BARAT,27026,CIANJUR,27389,HAURWANGI,16611,11790,28401
26141,JAWA BARAT,27026,CIANJUR,27350,GEKBRONG,13597,9585,23182
26141,JAWA BARAT,27026,CIANJUR,27233,KADUPANDAK,11380,11873,23253
26141,JAWA BARAT,26611,SUKABUMI,26753,CICURUG,44985,19284,64269
26141,JAWA BARAT,27026,CIANJUR,27247,PAGELARAN,21456,13752,35208
26141,JAWA BARAT,27026,CIANJUR,27359,CIPANAS,30883,20033,50916
26141,JAWA BARAT,27026,CIANJUR,27223,TAKOKAK,11551,13525,25076
26141,JAWA BARAT,27026,CIANJUR,27070,CILAKU,30811,17588,48399
26141,JAWA BARAT,27026,CIANJUR,27152,CUGENANG,27871,20606,48477
26141,JAWA BARAT,27026,CIANJUR,27298,AGRABINTA,9703,9297,19000
26141,JAWA BARAT,27026,CIANJUR,27309,CIDAUN,13558,17069,30627
26141,JAWA BARAT,27026,CIANJUR,27340,CIKADU,7121,9959,17080
26141,JAWA BARAT,27026,CIANJUR,27188,SUKARESMI,23812,14344,38156
26141,JAWA BARAT,27026,CIANJUR,27051,CIBEBER,38806,19237,58043
26141,JAWA BARAT,27026,CIANJUR,27103,KARANGTENGAH,46088,21769,67857
26141,JAWA BARAT,27026,CIANJUR,27377,LELES,11169,6663,17832
26141,JAWA BARAT,27407,BANDUNG,27566,CIPARAY,62511,24786,87297
26141,JAWA BARAT,27026,CIANJUR,27169,CIKALONGKULON,28477,16459,44936
26141,JAWA BARAT,27026,CIANJUR,27398,PASIRKUDA,10868,7376,18244
26141,JAWA BARAT,27026,CIANJUR,27039,WARUNGKONDANG,21282,11044,32326
26141,JAWA BARAT,27026,CIANJUR,27081,CIRANJANG,22548,16298,38846
26141,JAWA BARAT,27026,CIANJUR,27367,CIJATI,8011,7515,15526
26141,JAWA BARAT,27407,BANDUNG,27581,PACET,35103,18341,53444
26141,JAWA BARAT,27026,CIANJUR,27120,MANDE,20692,13211,33903
26141,JAWA BARAT,27026,CIANJUR,27200,SUKANAGARA,14793,10014,24807
26141,JAWA BARAT,27026,CIANJUR,27211,CAMPAKA,19389,11422,30811
26141,JAWA BARAT,27026,CIANJUR,27144,PACET,27971,18529,46500
26141,JAWA BARAT,27026,CIANJUR,27091,BOJONGPICUNG,22425,13512,35937
26141,JAWA BARAT,27407,BANDUNG,27669,PASIRJAMBU,27468,19645,47113
26141,JAWA BARAT,27407,BANDUNG,27603,BALEENDAH,82926,41624,124550
26141,JAWA BARAT,27407,BANDUNG,27603,BALEENDAH,82926,41624,124550
26141,JAWA BARAT,27026,CIANJUR,27133,SUKALUYU,21137,13150,34287
26141,JAWA BARAT,27407,BANDUNG,27694,CANGKUANG,23589,16224,39813
26141,JAWA BARAT,27407,BANDUNG,27415,CIMENYAN,33979,26828,60807
26141,JAWA BARAT,27407,BANDUNG,27612,MAJALAYA,53547,34445,87992
26141,JAWA BARAT,27407,BANDUNG,27624,SOLOKANJERUK,28651,18712,47363
26141,JAWA BARAT,27407,BANDUNG,27408,CILEUNYI,59862,27140,87002
26141,JAWA BARAT,27407,BANDUNG,27658,SOREANG,39922,21431,61353
26141,JAWA BARAT,27407,BANDUNG,27680,CIWIDEY,25975,18848,44823
26141,JAWA BARAT,27407,BANDUNG,27552,RANCAEKEK,69199,22799,91998
26141,JAWA BARAT,27407,BANDUNG,27425,CILENGKRANG,17007,9743,26750
26141,JAWA BARAT,27407,BANDUNG,27645,IBUN,22914,22882,45796
26141,JAWA BARAT,27407,BANDUNG,27595,KERTASARI,30452,9076,39528
26141,JAWA BARAT,27407,BANDUNG,27432,BOJONGSOANG,38930,17308,56238
26141,JAWA BARAT,27407,BANDUNG,27688,RANCABALI,16601,11857,28458
26141,JAWA BARAT,27407,BANDUNG,27632,PASEH,35816,31428,67244
26141,JAWA BARAT,27407,BANDUNG,27542,CIKANCUNG,28918,14776,43694
26141,JAWA BARAT,27407,BANDUNG,27467,BANJARAN,44649,22642,67291
26141,JAWA BARAT,27407,BANDUNG,27535,NAGREG,17994,9503,27497
26141,JAWA BARAT,27407,BANDUNG,27439,MARGAHAYU,35764,28405,64169
26141,JAWA BARAT,27407,BANDUNG,27445,MARGAASIH,42175,32381,74556
26141,JAWA BARAT,27714,GARUT,28067,CIKELET,14860,5883,20743
26141,JAWA BARAT,27407,BANDUNG,27452,KATAPANG,35809,25306,61115
26141,JAWA BARAT,27407,BANDUNG,27460,DAYEUHKOLOT,37072,21079,58151
26141,JAWA BARAT,27407,BANDUNG,27479,PAMEUNGPEUK,30339,11092,41431
26141,JAWA BARAT,27407,BANDUNG,27702,KUTAWARINGIN,34797,18895,53692
26141,JAWA BARAT,27714,GARUT,28095,PAKENJENG,22614,9327,31941
26141,JAWA BARAT,27714,GARUT,28174,SUCINARAJA,9707,4407,14114
26141,JAWA BARAT,27407,BANDUNG,27500,ARJASARI,34134,16384,50518
26141,JAWA BARAT,27714,GARUT,28024,CIHURIP,5364,3368,8732
26141,JAWA BARAT,27714,GARUT,28036,PAMEUNGPEUK,16415,4952,21367
26141,JAWA BARAT,27714,GARUT,28044,CISOMPET,15431,10583,26014
26141,JAWA BARAT,27714,GARUT,28151,SELAAWI,13690,6021,19711
26141,JAWA BARAT,27714,GARUT,28114,CISEWU,13258,6407,19665
26141,JAWA BARAT,27714,GARUT,28108,PAMULIHAN,6468,2753,9221
26141,JAWA BARAT,27714,GARUT,28029,PEUNDEUY,7306,2360,9666
26141,JAWA BARAT,27714,GARUT,28090,MEKARMUKTI,4901,3469,8370
26141,JAWA BARAT,27714,GARUT,28014,SINGAJAYA,14071,6259,20330
26141,JAWA BARAT,27407,BANDUNG,27486,PANGALENGAN,56347,25684,82031
26141,JAWA BARAT,27407,BANDUNG,27522,CICALENGKA,44238,16492,60730
26141,JAWA BARAT,27407,BANDUNG,27512,CIMAUNG,24421,19288,43709
26141,JAWA BARAT,27714,GARUT,27989,CIKAJANG,29211,11156,40367
26141,JAWA BARAT,27714,GARUT,28002,BANJARWANGI,18282,7485,25767
26141,JAWA BARAT,27714,GARUT,28159,CIBIUK,9768,3975,13743
26141,JAWA BARAT,27714,GARUT,28056,CIBALONG,12961,9929,22890
26141,JAWA BARAT,27714,GARUT,28128,TALEGONG,9988,6735,16723
26141,JAWA BARAT,27714,GARUT,27748,WANARAJA,16373,6532,22905
26141,JAWA BARAT,27714,GARUT,28077,BUNGBULANG,19611,9770,29381
26141,JAWA BARAT,27714,GARUT,27982,SUKARESMI,13396,4486,17882
26141,JAWA BARAT,27714,GARUT,27863,CIBATU,25295,8170,33465
26141,JAWA BARAT,27714,GARUT,27784,BANYURESMI,32595,9763,42358
26141,JAWA BARAT,27714,GARUT,28165,PANGATIKAN,13844,3388,17232
26141,JAWA BARAT,27714,GARUT,27839,KADUNGORA,31164,14989,46153
26141,JAWA BARAT,27714,GARUT,27813,PASIRWANGI,25155,8343,33498
26141,JAWA BARAT,27714,GARUT,27854,LEUWIGOONG,14634,6402,21036
26141,JAWA BARAT,27714,GARUT,27917,KARANGTENGAH,5092,2056,7148
26141,JAWA BARAT,27714,GARUT,28122,CARINGIN,9271,6273,15544
26141,JAWA BARAT,27714,GARUT,27800,SAMARANG,27174,9363,36537
26141,JAWA BARAT,27714,GARUT,27922,BAYONGBONG,32872,13104,45976
26141,JAWA BARAT,27714,GARUT,27881,MALANGBONG,40140,14810,54950
26141,JAWA BARAT,28182,TASIKMALAYA,28420,SINGAPARNA,24243,11663,35906
26141,JAWA BARAT,27714,GARUT,27946,CILAWU,38972,15508,54480
26141,JAWA BARAT,27714,GARUT,27757,TAROGONG KALER,34797,13985,48782
26141,JAWA BARAT,27714,GARUT,27771,TAROGONG KIDUL,43410,15069,58479
26141,JAWA BARAT,27714,GARUT,27826,LELES,26191,13945,40136
26141,JAWA BARAT,27714,GARUT,27727,KARANGPAWITAN,46147,17689,63836
26141,JAWA BARAT,27714,GARUT,27965,CISURUPAN,29731,17503,47234
26141,JAWA BARAT,28182,TASIKMALAYA,28462,LEUWISARI,13799,5599,19398
26141,JAWA BARAT,28182,TASIKMALAYA,28399,MANONJAYA,25975,8483,34458
26141,JAWA BARAT,28182,TASIKMALAYA,28438,SUKARAME,15518,4767,20285
26141,JAWA BARAT,28182,TASIKMALAYA,28183,CIPATUJAH,19862,15457,35319
26141,JAWA BARAT,28182,TASIKMALAYA,28508,SUKAHENING,9122,6232,15354
26141,JAWA BARAT,27714,GARUT,27940,CIGEDUG,12059,5757,17816
26141,JAWA BARAT,28182,TASIKMALAYA,28485,SUKARATU,16205,7228,23433
26141,JAWA BARAT,28182,TASIKMALAYA,28412,GUNUNG TANJUNG,11912,3273,15185
26141,JAWA BARAT,27714,GARUT,27905,SUKAWENING,18554,5816,24370
26141,JAWA BARAT,28182,TASIKMALAYA,28525,JAMANIS,12367,4476,16843
26141,JAWA BARAT,28182,TASIKMALAYA,28383,CINEAM,12674,7706,20380
26141,JAWA BARAT,28182,TASIKMALAYA,28199,KARANGNUNGGAL,28840,15904,44744
26141,JAWA BARAT,27714,GARUT,27715,GARUT KOTA,46288,24890,71178
26141,JAWA BARAT,28182,TASIKMALAYA,28470,PADAKEMBANG,13269,6229,19498
26141,JAWA BARAT,27714,GARUT,27875,KERSAMANAH,13528,4000,17528
26141,JAWA BARAT,28182,TASIKMALAYA,28445,CIGALONTANG,27924,9978,37902
26141,JAWA BARAT,28182,TASIKMALAYA,28431,MANGUNREJA,14149,5986,20135
26141,JAWA BARAT,28182,TASIKMALAYA,28394,KARANG JAYA,4317,3356,7673
26141,JAWA BARAT,28182,TASIKMALAYA,28494,CISAYONG,18425,11092,29517
26141,JAWA BARAT,28182,TASIKMALAYA,28240,CIKATOMAS,19550,7739,27289
26141,JAWA BARAT,28182,TASIKMALAYA,28371,JATIWARAS,18085,6046,24131
26141,JAWA BARAT,28182,TASIKMALAYA,28516,RAJAPOLAH,17618,6936,24554
26141,JAWA BARAT,28182,TASIKMALAYA,28476,SARIWANGI,12961,3259,16220
26141,JAWA BARAT,28182,TASIKMALAYA,28228,PANCA TENGAH,18620,5382,24002
26141,JAWA BARAT,28182,TASIKMALAYA,28312,TARAJU,12523,7120,19643
26141,JAWA BARAT,28182,TASIKMALAYA,28546,KADIPATEN,13792,3098,16890
26141,JAWA BARAT,28182,TASIKMALAYA,28266,BANTARKALONG,14565,4525,19090
26141,JAWA BARAT,28182,TASIKMALAYA,28257,PARUNGPONTENG,15518,3423,18941
26141,JAWA BARAT,28182,TASIKMALAYA,28553,PAGERAGEUNG,21939,6145,28084
26141,JAWA BARAT,28182,TASIKMALAYA,28299,SODONGHILIR,27537,5986,33523
26141,JAWA BARAT,28182,TASIKMALAYA,28352,SUKARAJA,19855,7461,27316
26141,JAWA BARAT,28182,TASIKMALAYA,28534,CIAWI,20339,10823,31162
26141,JAWA BARAT,28182,TASIKMALAYA,28344,TANJUNGJAYA,17264,5271,22535
26141,JAWA BARAT,28182,TASIKMALAYA,28275,BOJONGASIH,7889,2490,10379
26141,JAWA BARAT,28573,CIAMIS,28796,PADAHERANG,15464,20394,35858
26141,JAWA BARAT,28182,TASIKMALAYA,28214,CIKALONG,23505,10269,33774
26141,JAWA BARAT,28573,CIAMIS,28830,SIDAMULIH,6563,11076,17639
26141,JAWA BARAT,28182,TASIKMALAYA,28322,SALAWU,22298,9920,32218
26141,JAWA BARAT,28573,CIAMIS,28821,PANGANDARAN,11991,20180,32171
26141,JAWA BARAT,28182,TASIKMALAYA,28564,SUKARESIK,14160,3843,18003
26141,JAWA BARAT,28182,TASIKMALAYA,28335,PUSPAHIANG,9132,9192,18324
26141,JAWA BARAT,28573,CIAMIS,28869,CIGUGUR,7632,4469,12101
26141,JAWA BARAT,28182,TASIKMALAYA,28288,BOJONGGAMBIR,14580,5705,20285
26141,JAWA BARAT,28573,CIAMIS,28574,CIAMIS,37756,19860,57616
26141,JAWA BARAT,28182,TASIKMALAYA,28250,CIBALONG,12418,6320,18738
26141,JAWA BARAT,28182,TASIKMALAYA,28282,CULAMEGA,9884,2500,12384
26141,JAWA BARAT,28573,CIAMIS,28838,PARIGI,11667,16578,28245
26141,JAWA BARAT,28573,CIAMIS,28849,CIJULANG,9149,8403,17552
26141,JAWA BARAT,28182,TASIKMALAYA,28361,SALOPA,15122,7686,22808
26141,JAWA BARAT,28573,CIAMIS,28782,PAMARICAN,17606,20395,38001
26141,JAWA BARAT,28573,CIAMIS,28944,PURWADADI,9277,11038,20315
26141,JAWA BARAT,28573,CIAMIS,28897,CISAGA,11348,11562,22910
26141,JAWA BARAT,28573,CIAMIS,28618,CIDOLOG,6259,4978,11237
26141,JAWA BARAT,28573,CIAMIS,28811,KALIPUCANG,9417,11748,21165
26141,JAWA BARAT,28573,CIAMIS,28929,SUKAMANTRI,5969,4905,10874
26141,JAWA BARAT,28573,CIAMIS,28857,CIMERAK,13281,13636,26917
26141,JAWA BARAT,28573,CIAMIS,28688,CIPAKU,20747,13552,34299
26141,JAWA BARAT,28573,CIAMIS,28587,CIKONENG,18785,11320,30105
26141,JAWA BARAT,28573,CIAMIS,28625,CIHAURBEUTI,18575,7821,26396
26141,JAWA BARAT,28573,CIAMIS,28637,PANUMBANGAN,17570,13589,31159
26141,JAWA BARAT,28573,CIAMIS,28673,PANAWANGAN,13025,15081,28106
26141,JAWA BARAT,28573,CIAMIS,28609,SADANANYA,12168,8641,20809
26141,JAWA BARAT,28573,CIAMIS,28760,BANJARSARI,29787,29626,59413
26141,JAWA BARAT,28573,CIAMIS,28877,LANGKAPLANCAR,13348,14281,27629
26141,JAWA BARAT,28573,CIAMIS,28891,CIMARAGAS,4629,4943,9572
26141,JAWA BARAT,28573,CIAMIS,28935,LUMBUNG,11570,4842,16412
26141,JAWA BARAT,28573,CIAMIS,28597,CIJEUNGJING,20137,10517,30654
26141,JAWA BARAT,28573,CIAMIS,28909,SINDANGKASIH,17694,9266,26960
26141,JAWA BARAT,28573,CIAMIS,28919,BAREGBEG,14128,10411,24539
26141,JAWA BARAT,28573,CIAMIS,28728,RANCAH,18807,14138,32945
26141,JAWA BARAT,28573,CIAMIS,28702,JATINAGARA,8632,5310,13942
26141,JAWA BARAT,28960,KUNINGAN,29206,CIGUGUR,15165,11091,26256
26141,JAWA BARAT,28960,KUNINGAN,28961,KADUGEDE,8638,6066,14704
26141,JAWA BARAT,28573,CIAMIS,28742,TAMBAKSARI,4711,9111,13822
26141,JAWA BARAT,28960,KUNINGAN,29273,CIMAHI,5934,8582,14516
26141,JAWA BARAT,28573,CIAMIS,28661,KAWALI,15345,8295,23640
26141,JAWA BARAT,28960,KUNINGAN,29237,CIPICUNG,6167,6571,12738
26141,JAWA BARAT,28573,CIAMIS,28954,MANGUNJAYA,7900,9041,16941
26141,JAWA BARAT,28573,CIAMIS,28652,PANJALU,15200,7271,22471
26141,JAWA BARAT,28573,CIAMIS,28749,LAKBOK,10546,17619,28165
26141,JAWA BARAT,28573,CIAMIS,28721,SUKADANA,7465,6769,14234
26141,JAWA BARAT,28573,CIAMIS,28709,RAJADESA,18742,7839,26581
26141,JAWA BARAT,28960,KUNINGAN,29292,HANTARA,3871,3643,7514
26141,JAWA BARAT,28960,KUNINGAN,29248,PANCALANG,6370,5577,11947
26141,JAWA BARAT,28960,KUNINGAN,29317,KARANG KANCANA,4947,4503,9450
26141,JAWA BARAT,28960,KUNINGAN,29301,KALIMANGGIS,5271,5278,10549
26141,JAWA BARAT,28960,KUNINGAN,29005,CIBINGBIN,9633,8669,18302
26141,JAWA BARAT,28960,KUNINGAN,29228,NUSAHERANG,4992,5644,10636
26141,JAWA BARAT,28960,KUNINGAN,28974,CINIRU,6094,3681,9775
26141,JAWA BARAT,28960,KUNINGAN,29186,DARMA,14967,9838,24805
26141,JAWA BARAT,28960,KUNINGAN,29171,KRAMATMULYA,11438,10574,22012
26141,JAWA BARAT,28960,KUNINGAN,29262,JAPARA,4781,5740,10521
26141,JAWA BARAT,28960,KUNINGAN,28984,SUBANG,7343,1763,9106
26141,JAWA BARAT,28960,KUNINGAN,29217,PASAWAHAN,5991,6443,12434
26141,JAWA BARAT,28960,KUNINGAN,29284,CILEBAK,3887,2589,6476
26141,JAWA BARAT,28960,KUNINGAN,29308,CIBEUREUM,4879,5551,10430
26141,JAWA BARAT,28960,KUNINGAN,29150,MANDIRANCAN,7015,5121,12136
26141,JAWA BARAT,29369,CIREBON,29370,WALED,7538,15533,23071
26141,JAWA BARAT,28960,KUNINGAN,29047,GARAWANGI,11905,8335,20240
26141,JAWA BARAT,28960,KUNINGAN,29344,SINDANG AGUNG,9800,8197,17997
26141,JAWA BARAT,28960,KUNINGAN,29136,CILIMUS,14394,11998,26392
26141,JAWA BARAT,28960,KUNINGAN,29327,MALEBER,13430,6444,19874
26141,JAWA BARAT,28960,KUNINGAN,28992,CIWARU,8230,6220,14450
26141,JAWA BARAT,28960,KUNINGAN,29033,LEBAKWANGI,10753,10202,20955
26141,JAWA BARAT,28960,KUNINGAN,29016,LURAGUNG,13046,9025,22071
26141,JAWA BARAT,29369,CIREBON,29712,KALIWEDI,8168,9979,18147
26141,JAWA BARAT,28960,KUNINGAN,29065,KUNINGAN,35885,21691,57576
26141,JAWA BARAT,28960,KUNINGAN,29163,SELAJAMBE,4323,3705,8028
26141,JAWA BARAT,28960,KUNINGAN,29082,CIAWIGEBANG,22506,17356,39862
26141,JAWA BARAT,29369,CIREBON,29722,GEBANG,8678,22672,31350
26141,JAWA BARAT,29369,CIREBON,29633,KAPETAKAN,10745,16487,27232
26141,JAWA BARAT,29369,CIREBON,29684,SUSUKAN,11369,20285,31654
26141,JAWA BARAT,28960,KUNINGAN,29120,JALAKSANA,11950,13142,25092
26141,JAWA BARAT,29369,CIREBON,29697,GEGESIK,15500,18798,34298
26141,JAWA BARAT,29369,CIREBON,29653,ARJAWINANGUN,14579,19608,34187
26141,JAWA BARAT,28960,KUNINGAN,29107,CIDAHU,10327,9357,19684
26141,JAWA BARAT,28960,KUNINGAN,29357,CIGANDAMEKAR,8070,7560,15630
26141,JAWA BARAT,29369,CIREBON,29643,KLANGENAN,8728,16123,24851
26141,JAWA BARAT,29369,CIREBON,29675,CIWARINGIN,7755,11197,18952
26141,JAWA BARAT,29369,CIREBON,29457,SUSUKAN LEBAK,5487,12611,18098
26141,JAWA BARAT,29369,CIREBON,29665,PANGURAGAN,9007,10494,19501
26141,JAWA BARAT,29369,CIREBON,29608,KEDAWUNG,14586,18019,32605
26141,JAWA BARAT,29369,CIREBON,29804,GREGED,8598,11674,20272
26141,JAWA BARAT,29369,CIREBON,29443,LEMAHABANG,10776,14888,25664
26141,JAWA BARAT,29369,CIREBON,29471,SEDONG,5959,11819,17778
26141,JAWA BARAT,29369,CIREBON,29795,GEMPOL,8811,14151,22962
26141,JAWA BARAT,29369,CIREBON,29736,DEPOK,11732,20515,32247
26141,JAWA BARAT,29369,CIREBON,29617,GUNUNG JATI,20705,23481,44186
26141,JAWA BARAT,29369,CIREBON,29757,PABUARAN,5536,13280,18816
26141,JAWA BARAT,29369,CIREBON,29419,BABAKAN,9756,23583,33339
26141,JAWA BARAT,29369,CIREBON,29405,PABEDILAN,8678,19385,28063
26141,JAWA BARAT,29369,CIREBON,29815,SURANENGGALA,9593,14309,23902
26141,JAWA BARAT,29369,CIREBON,29434,KARANGSEMBUNG,6493,11353,17846
26141,JAWA BARAT,29369,CIREBON,29784,PLERED,9317,19213,28530
26141,JAWA BARAT,29369,CIREBON,29775,TENGAH TANI,9005,13933,22938
26141,JAWA BARAT,29369,CIREBON,29749,PASALEMAN,4466,7111,11577
26141,JAWA BARAT,29369,CIREBON,29383,CILEDUG,10078,13216,23294
26141,JAWA BARAT,29369,CIREBON,29765,KARANGWARENG,3734,10083,13817
26141,JAWA BARAT,29369,CIREBON,29504,MUNDU,15338,21179,36517
26141,JAWA BARAT,29369,CIREBON,29582,PLUMBON,15970,26697,42667
26141,JAWA BARAT,29369,CIREBON,29517,BEBER,8210,10023,18233
26141,JAWA BARAT,29834,MAJALENGKA,30059,LIGUNG,0,0,0
26141,JAWA BARAT,29369,CIREBON,29394,LOSARI,9989,17005,26994
26141,JAWA BARAT,29369,CIREBON,29494,PANGENAN,7001,12415,19416
26141,JAWA BARAT,29369,CIREBON,29540,SUMBER,17921,25894,43815
26141,JAWA BARAT,29369,CIREBON,29569,PALIMANAN,12916,18582,31498
26141,JAWA BARAT,29834,MAJALENGKA,30079,SUMBERJAYA,0,0,0
26141,JAWA BARAT,29369,CIREBON,29528,TALUN,14149,17092,31241
26141,JAWA BARAT,29834,MAJALENGKA,30043,JATITUJUH,0,0,0
26141,JAWA BARAT,29369,CIREBON,29482,ASTANAJAPURA,14839,16940,31779
26141,JAWA BARAT,29834,MAJALENGKA,30139,BANJARAN,0,0,0
26141,JAWA BARAT,29369,CIREBON,29555,DUKUPUNTANG,13604,19718,33322
26141,JAWA BARAT,29834,MAJALENGKA,30117,CIGASONG,0,0,0
26141,JAWA BARAT,29834,MAJALENGKA,30153,CINGAMBUL,0,0,0
26141,JAWA BARAT,29369,CIREBON,29598,WERU,14443,21069,35512
26141,JAWA BARAT,29369,CIREBON,29825,JAMBLANG,5760,13273,19033
26141,JAWA BARAT,29834,MAJALENGKA,30128,SINDANGWANGI,0,0,0
26141,JAWA BARAT,29834,MAJALENGKA,29914,MAJA,0,0,0
26141,JAWA BARAT,29834,MAJALENGKA,30093,PANYINGKIRAN,0,0,0
26141,JAWA BARAT,29834,MAJALENGKA,30020,KADIPATEN,0,0,0
26141,JAWA BARAT,29834,MAJALENGKA,29866,CIKIJING,0,0,0
26141,JAWA BARAT,29834,MAJALENGKA,29835,LEMAHSUGIH,0,0,0
26141,JAWA BARAT,29834,MAJALENGKA,30103,PALASAH,0,0,0
26141,JAWA BARAT,29834,MAJALENGKA,29948,SUKAHAJI,0,0,0
26141,JAWA BARAT,29834,MAJALENGKA,30167,KASOKANDEL,0,0,0
26141,JAWA BARAT,29834,MAJALENGKA,30028,KERTAJATI,0,0,0
26141,JAWA BARAT,30197,SUMEDANG,30198,WADO,13472,9410,22882
26141,JAWA BARAT,29834,MAJALENGKA,29899,ARGAPURA,0,0,0
26141,JAWA BARAT,29834,MAJALENGKA,29962,RAJAGALUH,0,0,0
26141,JAWA BARAT,29834,MAJALENGKA,29852,BANTARUJEG,0,0,0
26141,JAWA BARAT,29834,MAJALENGKA,30178,SINDANG,0,0,0
26141,JAWA BARAT,29834,MAJALENGKA,29933,MAJALENGKA,0,0,0
26141,JAWA BARAT,30197,SUMEDANG,30364,JATINANGOR,37890,14635,52525
26141,JAWA BARAT,29834,MAJALENGKA,29882,TALAGA,0,0,0
26141,JAWA BARAT,30197,SUMEDANG,30447,CIMALAKA,20547,13680,34227
26141,JAWA BARAT,29834,MAJALENGKA,29991,JATIWANGI,0,0,0
26141,JAWA BARAT,29834,MAJALENGKA,29976,LEUWIMUNDING,0,0,0
26141,JAWA BARAT,30197,SUMEDANG,30388,SUMEDANG SELATAN,31073,15435,46508
26141,JAWA BARAT,30197,SUMEDANG,30210,JATINUNGGAL,14850,9438,24288
26141,JAWA BARAT,30197,SUMEDANG,30245,CISITU,8903,7274,16177
26141,JAWA BARAT,30197,SUMEDANG,30340,PAMULIHAN,20302,12927,33229
26141,JAWA BARAT,30197,SUMEDANG,30417,GANEAS,8583,5009,13592
26141,JAWA BARAT,29834,MAJALENGKA,30186,MALAUSMA,0,0,0
26141,JAWA BARAT,30197,SUMEDANG,30425,TANJUNGKERTA,12391,8037,20428
26141,JAWA BARAT,30197,SUMEDANG,30352,CIMANGGUNG,37363,9987,47350
26141,JAWA BARAT,29834,MAJALENGKA,30008,DAWUAN,0,0,0
26141,JAWA BARAT,30197,SUMEDANG,30295,SURIAN,3244,4012,7256
26141,JAWA BARAT,30197,SUMEDANG,30220,DARMARAJA,11863,9235,21098
26141,JAWA BARAT,30197,SUMEDANG,30256,SITURAJA,14367,8144,22511
26141,JAWA BARAT,30197,SUMEDANG,30403,SUMEDANG UTARA,33312,19340,52652
26141,JAWA BARAT,30197,SUMEDANG,30377,RANCAKALONG,13189,10775,23964
26141,JAWA BARAT,30197,SUMEDANG,30271,CONGGEANG,8921,10081,19002
26141,JAWA BARAT,30197,SUMEDANG,30480,UJUNGJAYA,8559,10523,19082
26141,JAWA BARAT,30197,SUMEDANG,30462,CISARUA,4985,5547,10532
26141,JAWA BARAT,30197,SUMEDANG,30437,TANJUNGMEDAR,7977,7326,15303
26141,JAWA BARAT,30503,INDRAMAYU,30707,LOHBENER,10425,19395,29820
26141,JAWA BARAT,30197,SUMEDANG,30490,JATIGEDE,8211,7324,15535
26141,JAWA BARAT,30197,SUMEDANG,30237,CIBUGEL,6688,4613,11301
26141,JAWA BARAT,30197,SUMEDANG,30470,TOMO,7338,7831,15169
26141,JAWA BARAT,30503,INDRAMAYU,30504,HAURGEULIS,19672,23661,43333
26141,JAWA BARAT,30503,INDRAMAYU,30756,BONGAS,10345,15694,26039
26141,JAWA BARAT,30197,SUMEDANG,30332,SUKASARI,13736,6357,20093
26141,JAWA BARAT,30197,SUMEDANG,30284,PASEH,10476,11184,21660
26141,JAWA BARAT,30197,SUMEDANG,30304,BUAHDUA,10136,10231,20367
26141,JAWA BARAT,30503,INDRAMAYU,30720,ARAHAN,6235,10834,17069
26141,JAWA BARAT,30503,INDRAMAYU,30788,GANTAR,15996,14124,30120
26141,JAWA BARAT,30503,INDRAMAYU,30765,ANJATAN,15780,29609,45389
26141,JAWA BARAT,30503,INDRAMAYU,30729,LOSARANG,11448,17000,28448
26141,JAWA BARAT,30503,INDRAMAYU,30515,KROYA,12121,20605,32726
26141,JAWA BARAT,30197,SUMEDANG,30319,TANJUNGSARI,33471,13838,47309
26141,JAWA BARAT,30503,INDRAMAYU,30805,SUKAGUMIWANG,9282,8363,17645
26141,JAWA BARAT,30503,INDRAMAYU,30688,SINDANG,11934,15742,27676
26141,JAWA BARAT,30503,INDRAMAYU,30813,KEDOKAN BUNDER,10162,13842,24004
26141,JAWA BARAT,30503,INDRAMAYU,30779,SUKRA,8612,15622,24234
26141,JAWA BARAT,30503,INDRAMAYU,30525,GABUSWETAN,11602,19176,30778
26141,JAWA BARAT,30503,INDRAMAYU,30742,KANDANGHAUR,16269,27197,43466
26141,JAWA BARAT,30503,INDRAMAYU,30556,BANGODUA,6050,8654,14704
26141,JAWA BARAT,30503,INDRAMAYU,30544,LELEA,11034,15901,26935
26141,JAWA BARAT,30503,INDRAMAYU,30699,CANTIGI,3563,9434,12997
26141,JAWA BARAT,30503,INDRAMAYU,30795,TRISI,14216,16730,30946
26141,JAWA BARAT,30503,INDRAMAYU,30627,SLIYEG,12422,22184,34606
26141,JAWA BARAT,30503,INDRAMAYU,30828,TUKDANA,14669,13602,28271
26141,JAWA BARAT,30503,INDRAMAYU,30565,WIDASARI,7665,12359,20024
26141,JAWA BARAT,30503,INDRAMAYU,30642,JATIBARANG,14193,25565,39758
26141,JAWA BARAT,30503,INDRAMAYU,30821,PASEKAN,4037,8899,12936
26141,JAWA BARAT,30851,SUBANG,31007,CIBOGO,11659,13304,24963
26141,JAWA BARAT,30503,INDRAMAYU,30669,INDRAMAYU,26417,32843,59260
26141,JAWA BARAT,30503,INDRAMAYU,30842,PATROL,8916,19410,28326
26141,JAWA BARAT,30851,SUBANG,31017,CIPUNAGARA,13023,21641,34664
26141,JAWA BARAT,30503,INDRAMAYU,30590,KRANGKENG,13640,19495,33135
26141,JAWA BARAT,30851,SUBANG,31028,CIJAMBE,12697,10681,23378
26141,JAWA BARAT,30503,INDRAMAYU,30576,KERTASEMAYA,11547,17620,29167
26141,JAWA BARAT,30503,INDRAMAYU,30658,BALONGAN,10005,11049,21054
26141,JAWA BARAT,30503,INDRAMAYU,30536,CIKEDUNG,12042,11563,23605
26141,JAWA BARAT,30851,SUBANG,31118,CIATER,10547,6396,16943
26141,JAWA BARAT,30503,INDRAMAYU,30614,JUNTINYUAT,18674,24118,42792
26141,JAWA BARAT,30851,SUBANG,31053,CIKAUM,0,0,0
26141,JAWA BARAT,30851,SUBANG,31037,CIPEUNDUEY,13169,12726,25895
26141,JAWA BARAT,30851,SUBANG,31045,LEGONKULON,5194,7827,13021
26141,JAWA BARAT,30851,SUBANG,30852,SAGALAHERANG,10843,7024,17867
26141,JAWA BARAT,30503,INDRAMAYU,30602,KARANGAMPEL,12071,20542,32613
26141,JAWA BARAT,30851,SUBANG,31097,DAWUAN,12038,11779,23817
26141,JAWA BARAT,30851,SUBANG,31108,PAGADEN BARAT,10978,12013,22991
26141,JAWA BARAT,30851,SUBANG,30987,COMPRENG,8636,16198,24834
26141,JAWA BARAT,30851,SUBANG,30879,KALIJATI,18424,15716,34140
26141,JAWA BARAT,30851,SUBANG,31078,TAMBAKDAHAN,9266,16125,25391
26141,JAWA BARAT,30851,SUBANG,31088,KASOMALANG,15433,7116,22549
26141,JAWA BARAT,30851,SUBANG,31070,SUKASARI,8463,14947,23410
26141,JAWA BARAT,30851,SUBANG,31063,SERANGPANJANG,6993,7502,14495
26141,JAWA BARAT,30851,SUBANG,30931,CIASEM,24950,31011,55961
26141,JAWA BARAT,30851,SUBANG,30921,BINONG,10487,16397,26884
26141,JAWA BARAT,30851,SUBANG,30860,CISALAK,14383,7405,21788
26141,JAWA BARAT,30851,SUBANG,30996,PATOKBEUSI,23878,19507,43385
26141,JAWA BARAT,30851,SUBANG,30958,JALANCAGAK,14437,10464,24901
26141,JAWA BARAT,30851,SUBANG,30890,PABUARAN,18201,16083,34284
26141,JAWA BARAT,30851,SUBANG,30949,PAMANUKAN,12292,19202,31494
26141,JAWA BARAT,30851,SUBANG,30910,PAGADEN,17480,17404,34884
26141,JAWA BARAT,30851,SUBANG,30976,TANJUNGSIANG,14835,11258,26093
26141,JAWA BARAT,31135,PURWAKARTA,31136,PURWAKARTA,66104,27283,93387
26141,JAWA BARAT,30851,SUBANG,30870,SUBANG,39761,31952,71713
26141,JAWA BARAT,30851,SUBANG,30941,PUSAKANAGARA,6908,14810,21718
26141,JAWA BARAT,30851,SUBANG,30966,BLANAKAN,12619,21173,33792
26141,JAWA BARAT,31135,PURWAKARTA,31240,WANAYASA,15844,6393,22237
26141,JAWA BARAT,31135,PURWAKARTA,31294,BUNGURSARI,20520,8634,29154
26141,JAWA BARAT,31135,PURWAKARTA,31169,PLERED,28673,8135,36808
26141,JAWA BARAT,30851,SUBANG,30899,PURWADADI,15399,18221,33620
26141,JAWA BARAT,30851,SUBANG,31126,PUSAKAJAYA,9059,16042,25101
26141,JAWA BARAT,31135,PURWAKARTA,31256,PASAWAHAN,18701,7078,25779
26141,JAWA BARAT,31135,PURWAKARTA,31226,TEGALWARU,18564,5632,24196
26141,JAWA BARAT,31135,PURWAKARTA,31217,MANIIS,9378,5677,15055
26141,JAWA BARAT,31135,PURWAKARTA,31158,JATILUHUR,25653,9773,35426
26141,JAWA BARAT,31135,PURWAKARTA,31269,BOJONG,18528,6826,25354
26141,JAWA BARAT,31135,PURWAKARTA,31322,PONDOKSALAM,11799,4409,16208
26141,JAWA BARAT,31135,PURWAKARTA,31316,SUKASARI,5497,1952,7449
26141,JAWA BARAT,31345,KARAWANG,31567,TEMPURAN,20067,15617,35684
26141,JAWA BARAT,31135,PURWAKARTA,31284,BABAKANCIKAO,18929,10049,28978
26141,JAWA BARAT,31135,PURWAKARTA,31305,CIBATU,11603,6094,17697
26141,JAWA BARAT,31135,PURWAKARTA,31186,SUKATANI,25873,8689,34562
26141,JAWA BARAT,31345,KARAWANG,31541,RAWAMERTA,18536,11045,29581
26141,JAWA BARAT,31135,PURWAKARTA,31147,CAMPAKA,17318,7361,24679
26141,JAWA BARAT,31135,PURWAKARTA,31201,DARANGDAN,24669,9197,33866
26141,JAWA BARAT,31345,KARAWANG,31599,CILAMAYA KULON,0,0,0
26141,JAWA BARAT,31345,KARAWANG,31644,TELUKJAMBE BARAT,19937,10094,30031
26141,JAWA BARAT,31345,KARAWANG,31612,BANYUSARI,0,0,0
26141,JAWA BARAT,31345,KARAWANG,31346,KARAWANG BARAT,0,0,0
26141,JAWA BARAT,31345,KARAWANG,31526,TELAGASARI,24019,13403,37422
26141,JAWA BARAT,31345,KARAWANG,31555,LEMAHABANG,24144,12579,36723
26141,JAWA BARAT,31135,PURWAKARTA,31334,KIARAPEDES,9606,5075,14681
26141,JAWA BARAT,31345,KARAWANG,31590,JAYAKERTA,16466,13440,29906
26141,JAWA BARAT,31345,KARAWANG,31396,RENGASDENGKLOK,0,0,0
26141,JAWA BARAT,31345,KARAWANG,31635,KARAWANG TIMUR,37638,26956,64594
26141,JAWA BARAT,31345,KARAWANG,31582,MAJALAYA,16638,9427,26065
26141,JAWA BARAT,31345,KARAWANG,31406,KUTAWALUYA,17271,14119,31390
26141,JAWA BARAT,31345,KARAWANG,31625,KOTA BARU,39077,24144,63221
26141,JAWA BARAT,31345,KARAWANG,31442,PEDES,17848,19276,37124
26141,JAWA BARAT,31345,KARAWANG,31455,CIBUAYA,14042,11461,25503
26141,JAWA BARAT,31345,KARAWANG,31665,PURWASARI,0,0,0
26141,JAWA BARAT,31345,KARAWANG,31655,TEGALWARU,14777,4671,19448
26141,JAWA BARAT,31345,KARAWANG,31502,CILAMAYA WETAN,0,0,0
26141,JAWA BARAT,31345,KARAWANG,31467,PAKISJAYA,0,0,0
26141,JAWA BARAT,31685,BEKASI,31821,SUKATANI,0,0,0
26141,JAWA BARAT,31345,KARAWANG,31374,CIAMPEL,0,0,0
26141,JAWA BARAT,31345,KARAWANG,31355,PANGKALAN,0,0,0
26141,JAWA BARAT,31345,KARAWANG,31430,TIRTAJAYA,19590,15152,34742
26141,JAWA BARAT,31345,KARAWANG,31515,TIRTAMULYA,18591,9294,27885
26141,JAWA BARAT,31685,BEKASI,31829,CABANGBUNGIN,0,0,0
26141,JAWA BARAT,31345,KARAWANG,31674,CILEBAR,0,0,0
26141,JAWA BARAT,31685,BEKASI,31872,SERANG BARU,0,0,0
26141,JAWA BARAT,31345,KARAWANG,31382,KLARI,0,0,0
26141,JAWA BARAT,31345,KARAWANG,31364,TELUKJAMBE TIMUR,39307,23257,62564
26141,JAWA BARAT,31685,BEKASI,31865,CIKARANG PUSAT,0,0,0
26141,JAWA BARAT,31345,KARAWANG,31476,CIKAMPEK,0,0,0
26141,JAWA BARAT,31685,BEKASI,31799,PEBAYURAN,0,0,0
26141,JAWA BARAT,31345,KARAWANG,31419,BATUJAYA,22550,15006,37556
26141,JAWA BARAT,31685,BEKASI,31838,MUARAGEMBONG,0,0,0
26141,JAWA BARAT,31685,BEKASI,31845,SETU,0,0,0
26141,JAWA BARAT,31685,BEKASI,31705,SUKAWANGI,0,0,0
26141,JAWA BARAT,31685,BEKASI,31686,TARUMAJAYA,0,0,0
26141,JAWA BARAT,31685,BEKASI,31721,TAMBUN UTARA,0,0,0
26141,JAWA BARAT,31685,BEKASI,31695,BABELAN,0,0,0
26141,JAWA BARAT,31685,BEKASI,31713,TAMBELANG,0,0,0
26141,JAWA BARAT,31685,BEKASI,31813,SUKAKARYA,16022,9970,25992
26141,JAWA BARAT,31345,KARAWANG,31487,JATISARI,0,0,0
26141,JAWA BARAT,31685,BEKASI,31791,KEDUNG WARINGIN,0,0,0
26141,JAWA BARAT,31685,BEKASI,31782,CIKARANG TIMUR,0,0,0
26141,JAWA BARAT,31685,BEKASI,31857,CIKARANG SELATAN,0,0,0
26141,JAWA BARAT,31685,BEKASI,31881,CIBARUSAH,0,0,0
26141,JAWA BARAT,31896,BANDUNG BARAT,31994,BATUJAJAR,37174,14817,51991
26141,JAWA BARAT,31896,BANDUNG BARAT,32055,SINDANGKERTA,21517,12037,33554
26141,JAWA BARAT,31896,BANDUNG BARAT,32046,RONGGA,17851,9433,27284
26141,JAWA BARAT,31685,BEKASI,31761,CIKARANG UTARA,0,0,0
26141,JAWA BARAT,31896,BANDUNG BARAT,32008,CIHAMPELAS,38947,20765,59712
26141,JAWA BARAT,31896,BANDUNG BARAT,31897,LEMBANG,61223,46661,107884
26141,JAWA BARAT,31896,BANDUNG BARAT,32031,CIPONGKOR,27612,13537,41149
26141,JAWA BARAT,31896,BANDUNG BARAT,31970,CIPATAT,39499,28711,68210
26141,JAWA BARAT,31685,BEKASI,31749,CIKARANG BARAT,0,0,0
26141,JAWA BARAT,31896,BANDUNG BARAT,31983,PADALARANG,64064,29378,93442
26141,JAWA BARAT,31685,BEKASI,31773,KARANG BAHAGIA,33777,19916,53693
26141,JAWA BARAT,31896,BANDUNG BARAT,31914,PARONGPONG,30776,28530,59306
26141,JAWA BARAT,31685,BEKASI,31889,BOJONGMANGU,0,0,0
26141,JAWA BARAT,31896,BANDUNG BARAT,83521,SAGULING,9229,6993,16222
26141,JAWA BARAT,31685,BEKASI,31730,TAMBUN SELATAN,0,0,0
26141,JAWA BARAT,31685,BEKASI,31741,CIBITUNG,0,0,0
26141,JAWA BARAT,32077,KOTA BOGOR,32078,BOGOR SELATAN,63572,40203,103775
26141,JAWA BARAT,32152,KOTA SUKABUMI,32171,WARUDOYONG,19123,11009,30132
26141,JAWA BARAT,31896,BANDUNG BARAT,32067,GUNUNGHALU,24211,12846,37057
26141,JAWA BARAT,31896,BANDUNG BARAT,32019,CILILIN,29662,16597,46259
26141,JAWA BARAT,31896,BANDUNG BARAT,31945,CIPEUNDEUY,27189,14595,41784
26141,JAWA BARAT,32152,KOTA SUKABUMI,32165,CITAMIANG,19578,7873,27451
26141,JAWA BARAT,31896,BANDUNG BARAT,31931,CIKALONGWETAN,38236,25677,63913
26141,JAWA BARAT,32152,KOTA SUKABUMI,32153,GUNUNG PUYUH,17890,6826,24716
26141,JAWA BARAT,32077,KOTA BOGOR,32095,BOGOR TIMUR,30962,24809,55771
26141,JAWA BARAT,32077,KOTA BOGOR,32131,BOGOR UTARA,59389,35076,94465
26141,JAWA BARAT,31896,BANDUNG BARAT,31922,CISARUA,22605,19403,42008
26141,JAWA BARAT,32152,KOTA SUKABUMI,32158,CIKOLE,21602,11405,33007
26141,JAWA BARAT,32077,KOTA BOGOR,32140,TANAH SAREAL,70359,40038,110397
26141,JAWA BARAT,31896,BANDUNG BARAT,31958,NGAMPRAH,57936,32105,90041
26141,JAWA BARAT,32152,KOTA SUKABUMI,32182,LEMBURSITU,13643,6666,20309
26141,JAWA BARAT,32077,KOTA BOGOR,32114,BOGOR BARAT,80800,45640,126440
26141,JAWA BARAT,32077,KOTA BOGOR,32102,BOGOR TENGAH,35204,24812,60016
26141,JAWA BARAT,32193,KOTA BANDUNG,32324,BANDUNG KIDUL,18936,12553,31489
26141,JAWA BARAT,32193,KOTA BANDUNG,32309,CIBEUNYING KALER,22881,15770,38651
26141,JAWA BARAT,32193,KOTA BANDUNG,32329,BUAHBATU,33299,20405,53704
26141,JAWA BARAT,32193,KOTA BANDUNG,32314,SUMUR BANDUNG,11017,8609,19626
26141,JAWA BARAT,32193,KOTA BANDUNG,32319,ANTAPANI,25917,16876,42793
26141,JAWA BARAT,32152,KOTA SUKABUMI,32188,CIBEUREUM,14888,4928,19816
26141,JAWA BARAT,32152,KOTA SUKABUMI,32177,BAROS,13394,4363,17757
26141,JAWA BARAT,32193,KOTA BANDUNG,32334,RANCASARI,26610,16022,42632
26141,JAWA BARAT,32193,KOTA BANDUNG,32206,BABAKAN CIPARAY,36500,35783,72283
26141,JAWA BARAT,32193,KOTA BANDUNG,32339,ARCAMANIK,23917,16172,40089
26141,JAWA BARAT,32193,KOTA BANDUNG,32219,ANDIR,28655,27537,56192
26141,JAWA BARAT,32193,KOTA BANDUNG,32226,CICENDO,28996,25276,54272
26141,JAWA BARAT,32193,KOTA BANDUNG,32213,BOJONGLOA KALER,34855,32257,67112
26141,JAWA BARAT,32193,KOTA BANDUNG,32194,SUKASARI,25632,18094,43726
26141,JAWA BARAT,32193,KOTA BANDUNG,32365,CINAMBO,8496,4349,12845
26141,JAWA BARAT,32193,KOTA BANDUNG,32302,BOJONGLOA KIDUL,24017,23318,47335
26141,JAWA BARAT,32193,KOTA BANDUNG,32295,KIARACONDONG,44161,28147,72308
26141,JAWA BARAT,32193,KOTA BANDUNG,32286,BANDUNG KULON,41286,30696,71982
26141,JAWA BARAT,32193,KOTA BANDUNG,32199,COBLONG,38984,25687,64671
26141,JAWA BARAT,32193,KOTA BANDUNG,32355,GEDEBAGE,13205,6428,19633
26141,JAWA BARAT,32193,KOTA BANDUNG,32360,PANYILEUKAN,14204,6699,20903
26141,JAWA BARAT,32375,KOTA CIREBON,32386,HARJAMUKTI,28150,28698,56848
26141,JAWA BARAT,32375,KOTA CIREBON,32381,LEMAH WUNGKUK,12261,18542,30803
26141,JAWA BARAT,32193,KOTA BANDUNG,32262,BATUNUNGGAL,40037,27050,67087
26141,JAWA BARAT,32403,KOTA BEKASI,32456,JATI SEMPURNA,26884,23834,50718
26141,JAWA BARAT,32375,KOTA CIREBON,32392,PEKALIPAN,6264,11358,17622
26141,JAWA BARAT,32193,KOTA BANDUNG,32349,UJUNG BERUNG,28181,14642,42823
26141,JAWA BARAT,32193,KOTA BANDUNG,32344,CIBIRU,25092,12619,37711
26141,JAWA BARAT,32193,KOTA BANDUNG,32370,MANDALAJATI,23030,14068,37098
26141,JAWA BARAT,32193,KOTA BANDUNG,32271,LENGKONG,22918,17045,39963
26141,JAWA BARAT,32193,KOTA BANDUNG,32279,CIBEUNYING KIDUL,36894,24708,61602
26141,JAWA BARAT,32375,KOTA CIREBON,32376,KEJAKSAN,12058,12504,24562
26141,JAWA BARAT,32403,KOTA BEKASI,32443,PONDOK GEDE,66618,56454,123072
26141,JAWA BARAT,32193,KOTA BANDUNG,32247,ASTANA ANYAR,20059,21995,42054
26141,JAWA BARAT,32403,KOTA BEKASI,32433,MEDAN SATRIA,43566,38727,82293
26141,JAWA BARAT,32375,KOTA CIREBON,32397,KESAMBI,19626,19977,39603
26141,JAWA BARAT,32193,KOTA BANDUNG,32239,CIDADAP,16777,13729,30506
26141,JAWA BARAT,32193,KOTA BANDUNG,32233,SUKAJADI,31762,24987,56749
26141,JAWA BARAT,32472,KOTA DEPOK,32473,PANCORAN MAS,65651,55245,120896
26141,JAWA BARAT,32193,KOTA BANDUNG,32243,BANDUNG WETAN,8692,7826,16518
26141,JAWA BARAT,32193,KOTA BANDUNG,32254,REGOL,23693,21675,45368
26141,JAWA BARAT,32403,KOTA BEKASI,32462,MUSTIKA JAYA,49876,36325,86201
26141,JAWA BARAT,32403,KOTA BEKASI,32409,BEKASI BARAT,79543,67270,146813
26141,JAWA BARAT,32472,KOTA DEPOK,32531,TAPOS,77207,50247,127454
26141,JAWA BARAT,32403,KOTA BEKASI,32438,BANTAR GEBANG,27707,14303,42010
26141,JAWA BARAT,32472,KOTA DEPOK,32539,BOJONGSARI,33956,23710,57666
26141,JAWA BARAT,32403,KOTA BEKASI,32415,BEKASI UTARA,96021,73139,169160
26141,JAWA BARAT,32403,KOTA BEKASI,32404,BEKASI TIMUR,73480,64815,138295
26141,JAWA BARAT,32472,KOTA DEPOK,32507,BEJI,46679,35554,82233
26141,JAWA BARAT,32403,KOTA BEKASI,32449,JATIASIH,62360,44480,106840
26141,JAWA BARAT,32403,KOTA BEKASI,32467,PONDOK MELATI,34176,35050,69226
26141,JAWA BARAT,32403,KOTA BEKASI,32428,RAWA LUMBU,54573,50487,105060
26141,JAWA BARAT,32566,KOTA TASIKMALAYA,32567,CIHIDEUNG,25963,16277,42240
26141,JAWA BARAT,32403,KOTA BEKASI,32422,BEKASI SELATAN,56601,50641,107242
26141,JAWA BARAT,32472,KOTA DEPOK,32514,CIPAYUNG,42982,28859,71841
26141,JAWA BARAT,32472,KOTA DEPOK,32520,CILODONG,41539,28362,69901
26141,JAWA BARAT,32472,KOTA DEPOK,32495,LIMO,24486,21754,46240
26141,JAWA BARAT,32472,KOTA DEPOK,32487,SAWANGAN,45597,27542,73139
26141,JAWA BARAT,32547,KOTA CIMAHI,32548,CIMAHI SELATAN,85382,43134,128516
26141,JAWA BARAT,32547,KOTA CIMAHI,32561,CIMAHI UTARA,53456,32237,85693
26141,JAWA BARAT,32646,KOTA BANJAR,32655,PATARUMAN,17984,15160,33144
26141,JAWA BARAT,32472,KOTA DEPOK,32500,SUKMAJAYA,72187,58823,131010
26141,JAWA BARAT,32472,KOTA DEPOK,32480,CIMANGGIS,67903,57582,125485
26141,JAWA BARAT,32646,KOTA BANJAR,32647,BANJAR,18978,13087,32065
26141,JAWA BARAT,32566,KOTA TASIKMALAYA,32585,INDIHIANG,22235,6874,29109
26141,JAWA BARAT,32566,KOTA TASIKMALAYA,32592,KAWALU,38167,11917,50084
26141,JAWA BARAT,32472,KOTA DEPOK,32526,CINERE,25097,25017,50114
26141,JAWA BARAT,32566,KOTA TASIKMALAYA,32631,BUNGURSARI,20866,7088,27954
32676,JAWA TENGAH,32677,CILACAP,83527,DAYEUHLUHUR,0,0,0
26141,JAWA BARAT,32646,KOTA BANJAR,32664,PURWAHARJA,7099,5856,12955
32676,JAWA TENGAH,32677,CILACAP,83529,CIPARI,0,0,0
32676,JAWA TENGAH,32677,CILACAP,83530,PATIMUAN,0,0,0
26141,JAWA BARAT,32566,KOTA TASIKMALAYA,32579,TAWANG,26321,11037,37358
32676,JAWA TENGAH,32677,CILACAP,83526,WANAREJA,0,0,0
32676,JAWA TENGAH,32677,CILACAP,83525,JERUKLEGI,0,0,0
26141,JAWA BARAT,32547,KOTA CIMAHI,32554,CIMAHI TENGAH,59660,28868,88528
26141,JAWA BARAT,32566,KOTA TASIKMALAYA,32603,CIBEUREUM,28649,8063,36712
26141,JAWA BARAT,32566,KOTA TASIKMALAYA,32613,TAMANSARI,28315,8268,36583
26141,JAWA BARAT,32566,KOTA TASIKMALAYA,32622,MANGKUBUMI,38334,12700,51034
32676,JAWA TENGAH,32677,CILACAP,83533,CILACAP TENGAH,0,0,0
32676,JAWA TENGAH,32677,CILACAP,83534,CILACAP UTARA,0,0,0
26141,JAWA BARAT,32646,KOTA BANJAR,32669,LANGEN SARI,12508,15561,28069
32676,JAWA TENGAH,32677,CILACAP,32690,KESUGIHAN,0,0,0
32676,JAWA TENGAH,32677,CILACAP,83524,MAOS,0,0,0
32676,JAWA TENGAH,32677,CILACAP,83531,BANTARSARI,0,0,0
26141,JAWA BARAT,32566,KOTA TASIKMALAYA,32574,CIPEDES,33848,11706,45554
32676,JAWA TENGAH,32677,CILACAP,83528,SAMPANG,0,0,0
26141,JAWA BARAT,32566,KOTA TASIKMALAYA,32639,PURBARATU,18967,5377,24344
32676,JAWA TENGAH,32677,CILACAP,32842,KARANGPUCUNG,0,0,0
32676,JAWA TENGAH,32677,CILACAP,83532,CILACAP SELATAN,0,0,0
32676,JAWA TENGAH,32677,CILACAP,32707,ADIPALA,0,0,0
32676,JAWA TENGAH,32677,CILACAP,32724,BINANGUN,0,0,0
32676,JAWA TENGAH,32986,BANYUMAS,33249,KEMBARAN,0,0,0
32676,JAWA TENGAH,32986,BANYUMAS,33216,KARANG LEWAS,0,0,0
32676,JAWA TENGAH,32677,CILACAP,83522,KEDUNGREJA,0,0,0
32676,JAWA TENGAH,32677,CILACAP,83523,KROYA,0,0,0
32676,JAWA TENGAH,32677,CILACAP,32803,KAWUNGANTEN,0,0,0
32676,JAWA TENGAH,32677,CILACAP,32816,GANDRUNGMANGU,0,0,0
32676,JAWA TENGAH,32677,CILACAP,32873,MAJENANG,0,0,0
32676,JAWA TENGAH,32677,CILACAP,32857,CIMANGGU,0,0,0
32676,JAWA TENGAH,32986,BANYUMAS,33195,CILONGOK,0,0,0
32676,JAWA TENGAH,32986,BANYUMAS,33178,PEKUNCEN,0,0,0
32676,JAWA TENGAH,32986,BANYUMAS,33330,PURWOKERTO TIMUR,0,0,0
32676,JAWA TENGAH,32986,BANYUMAS,33286,BATURADEN,0,0,0
32676,JAWA TENGAH,32677,CILACAP,32742,NUSAWUNGU,0,0,0
32676,JAWA TENGAH,32986,BANYUMAS,33322,PURWOKERTO BARAT,0,0,0
32676,JAWA TENGAH,32677,CILACAP,32831,SIDAREJA,0,0,0
32676,JAWA TENGAH,32677,CILACAP,83535,KAMPUNG LAUT,0,0,0
32676,JAWA TENGAH,32986,BANYUMAS,33314,PURWOKERTO SELATAN,0,0,0
32676,JAWA TENGAH,32986,BANYUMAS,33062,SUMPIUH,0,0,0
32676,JAWA TENGAH,32986,BANYUMAS,33023,RAWALO,0,0,0
32676,JAWA TENGAH,32986,BANYUMAS,33011,JATILAWANG,0,0,0
32676,JAWA TENGAH,32986,BANYUMAS,32987,LUMBIR,0,0,0
32676,JAWA TENGAH,32986,BANYUMAS,33151,AJIBARANG,0,0,0
32676,JAWA TENGAH,32986,BANYUMAS,32998,WANGON,0,0,0
32676,JAWA TENGAH,32986,BANYUMAS,33337,PURWOKERTO UTARA,0,0,0
32676,JAWA TENGAH,32986,BANYUMAS,33299,KEDUNG BANTENG,0,0,0
32676,JAWA TENGAH,33345,PURBALINGGA,33346,KEMANGKON,13931,19774,33705
32676,JAWA TENGAH,32986,BANYUMAS,33230,SOKARAJA,0,0,0
32676,JAWA TENGAH,32986,BANYUMAS,33033,KEBASEN,0,0,0
32676,JAWA TENGAH,33345,PURBALINGGA,33532,REMBANG,8720,23459,32179
32676,JAWA TENGAH,32986,BANYUMAS,33266,SUMBANG,0,0,0
32676,JAWA TENGAH,32986,BANYUMAS,33167,GUMELAR,0,0,0
32676,JAWA TENGAH,32986,BANYUMAS,33077,TAMBAK,0,0,0
32676,JAWA TENGAH,33345,PURBALINGGA,33506,KARANGANYAR,6964,11818,18782
32676,JAWA TENGAH,32986,BANYUMAS,33126,PATIKRAJA,0,0,0
32676,JAWA TENGAH,32986,BANYUMAS,33046,KEMRANJEN,0,0,0
32676,JAWA TENGAH,32986,BANYUMAS,33140,PURWOJATI,0,0,0
32676,JAWA TENGAH,32986,BANYUMAS,33100,KALIBAGOR,0,0,0
32676,JAWA TENGAH,32986,BANYUMAS,33090,SOMAGEDE,0,0,0
32676,JAWA TENGAH,33345,PURBALINGGA,33414,PURBALINGGA,15054,18887,33941
32676,JAWA TENGAH,33345,PURBALINGGA,33574,PENGADEGAN,5974,14530,20504
32676,JAWA TENGAH,33345,PURBALINGGA,33461,MREBET,13984,24042,38026
32676,JAWA TENGAH,33345,PURBALINGGA,33481,BOBOTSARI,12439,15550,27989
32676,JAWA TENGAH,33345,PURBALINGGA,33559,PADAMARA,9478,14890,24368
32676,JAWA TENGAH,33345,PURBALINGGA,33584,KARANGJAMBU,3463,9131,12594
32676,JAWA TENGAH,33345,PURBALINGGA,33498,KARANGREJA,7491,14615,22106
32676,JAWA TENGAH,32986,BANYUMAS,33113,BANYUMAS,0,0,0
32676,JAWA TENGAH,33345,PURBALINGGA,33428,KALIMANAH,12142,19189,31331
32676,JAWA TENGAH,33345,PURBALINGGA,33446,KUTASARI,11227,21440,32667
32676,JAWA TENGAH,33603,BANJARNEGARA,33883,PANDANARUM,2995,8403,11398
32676,JAWA TENGAH,33345,PURBALINGGA,33520,KARANGMONCOL,9902,17958,27860
32676,JAWA TENGAH,33345,PURBALINGGA,33366,BUKATEJA,14990,24535,39525
32676,JAWA TENGAH,33345,PURBALINGGA,33545,BOJONGSARI,12041,20961,33002
32676,JAWA TENGAH,33603,BANJARNEGARA,33804,PAGENTAN,9118,11668,20786
32676,JAWA TENGAH,33603,BANJARNEGARA,33760,RAKIT,11091,16787,27878
32676,JAWA TENGAH,33603,BANJARNEGARA,33748,WANADADI,8648,8755,17403
32676,JAWA TENGAH,33603,BANJARNEGARA,33629,MANDIRAJA,10397,28500,38897
32676,JAWA TENGAH,33603,BANJARNEGARA,33646,PURWONEGORO,12581,27956,40537
32676,JAWA TENGAH,33603,BANJARNEGARA,33839,BATUR,9298,11097,20395
32676,JAWA TENGAH,33345,PURBALINGGA,33395,KALIGONDANG,12111,22273,34384
32676,JAWA TENGAH,33345,PURBALINGGA,33381,KEJOBONG,7690,17272,24962
32676,JAWA TENGAH,33603,BANJARNEGARA,33604,SUSUKAN,8424,21251,29675
32676,JAWA TENGAH,33603,BANJARNEGARA,33660,BAWANG,13130,19371,32501
32676,JAWA TENGAH,33603,BANJARNEGARA,33772,PUNGGELAN,13062,25992,39054
32676,JAWA TENGAH,33603,BANJARNEGARA,33620,PURWOREJO KLAMPOK,7931,16308,24239
32676,JAWA TENGAH,33603,BANJARNEGARA,33866,KALIBENING,8477,14232,22709
32676,JAWA TENGAH,33603,BANJARNEGARA,33821,PEJAWARAN,11927,11288,23215
32676,JAWA TENGAH,33345,PURBALINGGA,33591,KERTANEGARA,6272,10380,16652
32676,JAWA TENGAH,33902,KEBUMEN,34209,ADIMULYO,9066,11729,20795
32676,JAWA TENGAH,33902,KEBUMEN,34268,SEMPOR,10001,22363,32364
32676,JAWA TENGAH,33603,BANJARNEGARA,33848,WANAYASA,11278,15366,26644
32676,JAWA TENGAH,33603,BANJARNEGARA,33790,KARANGKOBAR,7129,9373,16502
32676,JAWA TENGAH,33902,KEBUMEN,34300,KARANGANYAR,7625,11814,19439
32676,JAWA TENGAH,33603,BANJARNEGARA,33892,PAGEDONGAN,5590,13914,19504
32676,JAWA TENGAH,33902,KEBUMEN,34285,GOMBONG,12332,15076,27408
32676,JAWA TENGAH,33902,KEBUMEN,34340,BONOROWO,5504,5349,10853
32676,JAWA TENGAH,33603,BANJARNEGARA,33730,BANJARMANGU,10445,14949,25394
32676,JAWA TENGAH,33902,KEBUMEN,34332,SADANG,2220,6951,9171
32676,JAWA TENGAH,33902,KEBUMEN,33922,BUAYAN,8410,22801,31211
32676,JAWA TENGAH,33902,KEBUMEN,34362,PONCOWARNO,3246,5397,8643
32676,JAWA TENGAH,33902,KEBUMEN,33903,AYAH,10641,23694,34335
32676,JAWA TENGAH,33603,BANJARNEGARA,33709,MADUKARA,11070,15521,26591
32676,JAWA TENGAH,33603,BANJARNEGARA,33679,BANJARNEGARA,17746,20147,37893
32676,JAWA TENGAH,33902,KEBUMEN,34173,PEJAGOAN,10655,16232,26887
32676,JAWA TENGAH,33902,KEBUMEN,34312,KARANGGAYAM,6107,20798,26905
32676,JAWA TENGAH,33902,KEBUMEN,34014,BULUSPESANTREN,13136,17686,30822
32676,JAWA TENGAH,33902,KEBUMEN,34256,ROWOKELE,8509,15511,24020
32676,JAWA TENGAH,33603,BANJARNEGARA,33693,SIGALUH,6561,11520,18081
32676,JAWA TENGAH,33902,KEBUMEN,33967,PETANAHAN,12904,19186,32090
32676,JAWA TENGAH,33902,KEBUMEN,33989,KLIRONG,13143,20913,34056
32676,JAWA TENGAH,33902,KEBUMEN,34106,KUTOWINANGUN,11153,14001,25154
32676,JAWA TENGAH,33902,KEBUMEN,34233,KUWARASAN,10067,15930,25997
32676,JAWA TENGAH,33902,KEBUMEN,33943,PURING,10742,20932,31674
32676,JAWA TENGAH,33902,KEBUMEN,34187,SRUWENG,10424,19320,29744
32676,JAWA TENGAH,34389,PURWOREJO,34823,GEBANG,8798,14459,23257
32676,JAWA TENGAH,33902,KEBUMEN,34092,PREMBUN,6738,8532,15270
32676,JAWA TENGAH,33902,KEBUMEN,34126,ALIAN,11453,17734,29187
32676,JAWA TENGAH,33902,KEBUMEN,34352,PADURESO,3261,4863,8124
32676,JAWA TENGAH,33902,KEBUMEN,34143,KEBUMEN,30788,36174,66962
32676,JAWA TENGAH,34389,PURWOREJO,34849,LOANO,7521,13671,21192
32676,JAWA TENGAH,33902,KEBUMEN,34069,MIRIT,10378,15578,25956
32676,JAWA TENGAH,34389,PURWOREJO,34540,KALIGESING,6164,12561,18725
32676,JAWA TENGAH,33902,KEBUMEN,34374,KARANGSAMBUNG,6506,13853,20359
32676,JAWA TENGAH,34389,PURWOREJO,34423,NGOMBOL,9261,10759,20020
32676,JAWA TENGAH,34389,PURWOREJO,34763,KEMIRI,12240,20532,32772
32676,JAWA TENGAH,34389,PURWOREJO,34671,BUTUH,11133,13463,24596
32676,JAWA TENGAH,34389,PURWOREJO,34804,BRUNO,8499,15908,24407
32676,JAWA TENGAH,33902,KEBUMEN,34036,AMBAL,12297,20296,32593
32676,JAWA TENGAH,34900,WONOSOBO,35101,MOJOTENGAH,0,0,0
32676,JAWA TENGAH,34900,WONOSOBO,35137,KEJAJAR,0,0,0
32676,JAWA TENGAH,34389,PURWOREJO,34522,BAGELEN,6328,11504,17832
32676,JAWA TENGAH,34900,WONOSOBO,35154,SUKOHARJO,0,0,0
32676,JAWA TENGAH,34389,PURWOREJO,34616,BAYAN,12064,15807,27871
32676,JAWA TENGAH,34900,WONOSOBO,34901,WADASLINTANG,0,0,0
32676,JAWA TENGAH,34900,WONOSOBO,35021,KALIKAJAR,0,0,0
32676,JAWA TENGAH,34389,PURWOREJO,34643,KUTOARJO,12953,22397,35350
32676,JAWA TENGAH,34900,WONOSOBO,35041,KERTEK,0,0,0
32676,JAWA TENGAH,34389,PURWOREJO,34588,BANYU URIP,11057,13138,24195
32676,JAWA TENGAH,34389,PURWOREJO,34713,PITURUH,11661,17261,28922
32676,JAWA TENGAH,34389,PURWOREJO,34871,BENER,9630,21076,30706
32676,JAWA TENGAH,34389,PURWOREJO,34390,GRABAG,10894,16055,26949
32676,JAWA TENGAH,34900,WONOSOBO,34941,SAPURAN,0,0,0
32676,JAWA TENGAH,34389,PURWOREJO,34562,PURWOREJO,18554,30028,48582
32676,JAWA TENGAH,34900,WONOSOBO,35121,GARUNG,0,0,0
32676,JAWA TENGAH,34389,PURWOREJO,34481,PURWODADI,9433,13627,23060
32676,JAWA TENGAH,34900,WONOSOBO,34981,LEKSONO,0,0,0
32676,JAWA TENGAH,35181,MAGELANG,35511,TEGALREJO,13883,18847,32730
32676,JAWA TENGAH,34900,WONOSOBO,35084,WATUMALANG,0,0,0
32676,JAWA TENGAH,35181,MAGELANG,35424,CANDIMULYO,11691,17803,29494
32676,JAWA TENGAH,35181,MAGELANG,35444,PAKIS,12748,22325,35073
32676,JAWA TENGAH,34900,WONOSOBO,34919,KEPIL,0,0,0
32676,JAWA TENGAH,34900,WONOSOBO,34996,SELOMERTO,0,0,0
32676,JAWA TENGAH,34900,WONOSOBO,34959,KALIWIRO,0,0,0
32676,JAWA TENGAH,35181,MAGELANG,35342,TEMPURAN,12774,15842,28616
32676,JAWA TENGAH,35181,MAGELANG,35224,NGLUWAR,9337,10753,20090
32676,JAWA TENGAH,34900,WONOSOBO,35063,WONOSOBO,0,0,0
32676,JAWA TENGAH,35181,MAGELANG,35233,SALAM,13752,14992,28744
32676,JAWA TENGAH,35181,MAGELANG,35533,SECANG,20741,24914,45655
32676,JAWA TENGAH,34900,WONOSOBO,35172,KALIBAWANG,0,0,0
32676,JAWA TENGAH,35181,MAGELANG,35182,SALAMAN,17373,23159,40532
32676,JAWA TENGAH,35181,MAGELANG,35358,KAJORAN,13389,18419,31808
32676,JAWA TENGAH,35181,MAGELANG,35409,BANDONGAN,17942,15428,33370
32676,JAWA TENGAH,35181,MAGELANG,35203,BOROBUDUR,15105,21472,36577
32676,JAWA TENGAH,35181,MAGELANG,35482,GRABAG,19900,32681,52581
32676,JAWA TENGAH,35181,MAGELANG,35264,DUKUN,14303,14673,28976
32676,JAWA TENGAH,35575,BOYOLALI,35576,SELO,0,0,0
32676,JAWA TENGAH,35181,MAGELANG,35388,KALIANGKRIK,15494,15799,31293
32676,JAWA TENGAH,35575,BOYOLALI,35818,KEMUSU,0,0,0
32676,JAWA TENGAH,35181,MAGELANG,35465,NGABLAK,9563,17025,26588
32676,JAWA TENGAH,35181,MAGELANG,35328,MERTOYUDAN,33186,30995,64181
32676,JAWA TENGAH,35575,BOYOLALI,35742,NOGOSARI,0,0,0
32676,JAWA TENGAH,35181,MAGELANG,35246,SRUMBUNG,16696,13113,29809
32676,JAWA TENGAH,35575,BOYOLALI,35832,WONOSEGORO,0,0,0
32676,JAWA TENGAH,35575,BOYOLALI,35712,SAMBI,0,0,0
32676,JAWA TENGAH,35575,BOYOLALI,35787,KLEGO,0,0,0
32676,JAWA TENGAH,35575,BOYOLALI,35669,TERAS,0,0,0
32676,JAWA TENGAH,35575,BOYOLALI,35770,KARANGGEDE,0,0,0
32676,JAWA TENGAH,35575,BOYOLALI,35801,ANDONG,0,0,0
32676,JAWA TENGAH,35181,MAGELANG,35296,MUNTILAN,22031,26459,48490
32676,JAWA TENGAH,35575,BOYOLALI,35608,CEPOGO,0,0,0
32676,JAWA TENGAH,35181,MAGELANG,35280,SAWANGAN,17488,18322,35810
32676,JAWA TENGAH,35862,KLATEN,36109,WONOSARI,8479,29319,37798
32676,JAWA TENGAH,35181,MAGELANG,35554,WINDUSARI,13455,14745,28200
32676,JAWA TENGAH,35575,BOYOLALI,35756,SIMO,0,0,0
32676,JAWA TENGAH,35575,BOYOLALI,35696,BANYUDONO,0,0,0
32676,JAWA TENGAH,35181,MAGELANG,35311,MUNGKID,24554,19692,44246
32676,JAWA TENGAH,35575,BOYOLALI,35645,BOYOLALI,0,0,0
32676,JAWA TENGAH,35575,BOYOLALI,35655,MOJOSONGO,0,0,0
32676,JAWA TENGAH,35575,BOYOLALI,35729,NGEMPLAK,0,0,0
32676,JAWA TENGAH,35575,BOYOLALI,35587,AMPEL,0,0,0
32676,JAWA TENGAH,35575,BOYOLALI,35683,SAWIT,0,0,0
32676,JAWA TENGAH,35575,BOYOLALI,35624,MUSUK,0,0,0
32676,JAWA TENGAH,35862,KLATEN,36184,TULUNG,8231,22597,30828
32676,JAWA TENGAH,35862,KLATEN,36236,NGAWEN,9630,17000,26630
32676,JAWA TENGAH,35575,BOYOLALI,35851,JUWANGI,0,0,0
32676,JAWA TENGAH,35862,KLATEN,35917,BAYAT,6099,29007,35106
32676,JAWA TENGAH,35862,KLATEN,36203,JATINOM,10251,24032,34283
32676,JAWA TENGAH,35862,KLATEN,36222,KEMALANG,4732,17473,22205
32676,JAWA TENGAH,35862,KLATEN,36250,KALIKOTES,4765,15657,20422
32676,JAWA TENGAH,35862,KLATEN,36258,KLATEN UTARA,8653,19462,28115
32676,JAWA TENGAH,35862,KLATEN,36145,POLANHARJO,6885,17727,24612
32676,JAWA TENGAH,35862,KLATEN,35863,PRAMBANAN,9270,21236,30506
32676,JAWA TENGAH,35862,KLATEN,35880,GANTIWARNO,5769,17131,22900
32676,JAWA TENGAH,35862,KLATEN,36128,DELANGGU,7808,18067,25875
32676,JAWA TENGAH,35862,KLATEN,35897,WEDI,7174,22879,30053
32676,JAWA TENGAH,35862,KLATEN,36267,KLATEN TENGAH,6523,18523,25046
32676,JAWA TENGAH,35862,KLATEN,36164,KARANGANOM,8006,19403,27409
32676,JAWA TENGAH,35862,KLATEN,35957,TRUCUK,10171,35820,45991
32676,JAWA TENGAH,35862,KLATEN,36054,PEDAN,5420,23192,28612
32676,JAWA TENGAH,35862,KLATEN,36089,JUWIRING,8739,26529,35268
32676,JAWA TENGAH,35862,KLATEN,35936,CAWAS,6257,28114,34371
32676,JAWA TENGAH,35862,KLATEN,36035,CEPER,9106,29853,38959
32676,JAWA TENGAH,36290,SUKOHARJO,36331,SUKOHARJO,11529,43070,54599
32676,JAWA TENGAH,35862,KLATEN,36003,MANISRENGGO,6896,19169,26065
32676,JAWA TENGAH,35862,KLATEN,36069,KARANGDOWO,6134,20527,26661
32676,JAWA TENGAH,36290,SUKOHARJO,36396,MOJOLABAN,11426,43611,55037
32676,JAWA TENGAH,35862,KLATEN,36277,KLATEN SELATAN,7312,18090,25402
32676,JAWA TENGAH,36290,SUKOHARJO,36363,BENDOSARI,6937,28495,35432
32676,JAWA TENGAH,35862,KLATEN,35984,JOGONALAN,7895,26771,34666
32676,JAWA TENGAH,36290,SUKOHARJO,36427,BAKI,7721,34193,41914
32676,JAWA TENGAH,36290,SUKOHARJO,36305,BULU,3086,17874,20960
32676,JAWA TENGAH,35862,KLATEN,35976,KEBONARUM,3429,8561,11990
32676,JAWA TENGAH,36290,SUKOHARJO,36457,KARTASURA,16335,46712,63047
32676,JAWA TENGAH,36290,SUKOHARJO,36442,GATAK,6873,24498,31371
32676,JAWA TENGAH,36290,SUKOHARJO,36291,WERU,7190,25137,32327
32676,JAWA TENGAH,36290,SUKOHARJO,36378,POLOKARTO,9654,39609,49263
32676,JAWA TENGAH,35862,KLATEN,36020,KARANGNONGKO,5401,16492,21893
32676,JAWA TENGAH,36290,SUKOHARJO,36318,TAWANGSARI,5419,25354,30773
32676,JAWA TENGAH,36470,WONOGIRI,36741,JATIPURNO,0,0,0
32676,JAWA TENGAH,36290,SUKOHARJO,36346,NGUTER,6397,24346,30743
32676,JAWA TENGAH,36470,WONOGIRI,36774,PARANGGUPITO,0,0,0
32676,JAWA TENGAH,36470,WONOGIRI,36490,GIRITONTRO,0,0,0
32676,JAWA TENGAH,36470,WONOGIRI,36626,NGADIROJO,0,0,0
32676,JAWA TENGAH,36290,SUKOHARJO,36412,GROGOL,13250,58599,71849
32676,JAWA TENGAH,36470,WONOGIRI,36651,JATIROTO,0,0,0
32676,JAWA TENGAH,36470,WONOGIRI,36768,KARANGTENGAH,0,0,0
32676,JAWA TENGAH,36470,WONOGIRI,36471,PRACIMANTORO,0,0,0
32676,JAWA TENGAH,36470,WONOGIRI,36551,BATURETNO,0,0,0
32676,JAWA TENGAH,36470,WONOGIRI,36539,NGUNTORONADI,0,0,0
32676,JAWA TENGAH,36470,WONOGIRI,36753,GIRIMARTO,0,0,0
32676,JAWA TENGAH,36470,WONOGIRI,36678,PURWANTORO,0,0,0
32676,JAWA TENGAH,36470,WONOGIRI,36705,SLOGOHIMO,0,0,0
32676,JAWA TENGAH,36470,WONOGIRI,36581,WURYANTORO,0,0,0
32676,JAWA TENGAH,36470,WONOGIRI,36515,BATUWARNO,0,0,0
32676,JAWA TENGAH,36470,WONOGIRI,36667,KISMANTORO,0,0,0
32676,JAWA TENGAH,36470,WONOGIRI,36694,BULUKERTO,0,0,0
32676,JAWA TENGAH,36470,WONOGIRI,36565,EROMOKO,0,0,0
32676,JAWA TENGAH,36470,WONOGIRI,36498,GIRIWOYO,0,0,0
32676,JAWA TENGAH,36470,WONOGIRI,36723,JATISRONO,0,0,0
32676,JAWA TENGAH,36470,WONOGIRI,36610,WONOGIRI,0,0,0
32676,JAWA TENGAH,36790,KARANGANYAR,36904,JATEN,14067,35499,49566
32676,JAWA TENGAH,36790,KARANGANYAR,36925,GONDANGREJO,9237,37052,46289
32676,JAWA TENGAH,36790,KARANGANYAR,36964,KERJO,5938,15807,21745
32676,JAWA TENGAH,36470,WONOGIRI,36524,TIRTOMOYO,0,0,0
32676,JAWA TENGAH,36790,KARANGANYAR,36858,NGARGOYOSO,5936,15203,21139
32676,JAWA TENGAH,36790,KARANGANYAR,36791,JATIPURO,5041,15091,20132
32676,JAWA TENGAH,36470,WONOGIRI,36638,SIDOARJO,0,0,0
32676,JAWA TENGAH,36790,KARANGANYAR,36880,KARANGANYAR,15636,33038,48674
32676,JAWA TENGAH,36790,KARANGANYAR,36913,COLOMADU,9659,29553,39212
32676,JAWA TENGAH,36790,KARANGANYAR,36950,MOJOGEDANG,10628,28389,39017
32676,JAWA TENGAH,36985,SRAGEN,36986,KALIJAMBE,6955,21888,28843
32676,JAWA TENGAH,36790,KARANGANYAR,36812,JUMAPOLO,5192,18740,23932
32676,JAWA TENGAH,36790,KARANGANYAR,36825,JUMANTONO,7001,20883,27884
32676,JAWA TENGAH,36790,KARANGANYAR,36837,MATESIH,8547,17353,25900
32676,JAWA TENGAH,36470,WONOGIRI,36590,MANYARAN,0,0,0
32676,JAWA TENGAH,36470,WONOGIRI,36598,SELOGIRI,0,0,0
32676,JAWA TENGAH,36470,WONOGIRI,36783,PUHPELEM,0,0,0
32676,JAWA TENGAH,36790,KARANGANYAR,36893,TASIKMADU,12679,24697,37376
32676,JAWA TENGAH,36790,KARANGANYAR,36802,JATIYOSO,5870,18143,24013
32676,JAWA TENGAH,36790,KARANGANYAR,36847,TAWANGMANGU,7771,19101,26872
32676,JAWA TENGAH,36985,SRAGEN,37102,SIDOHARJO,8627,24429,33056
32676,JAWA TENGAH,36790,KARANGANYAR,36939,KEBAKKRAMAT,11593,27950,39543
32676,JAWA TENGAH,36790,KARANGANYAR,36868,KARANGPANDAN,6132,19212,25344
32676,JAWA TENGAH,36985,SRAGEN,37190,GESI,2482,10120,12602
32676,JAWA TENGAH,36985,SRAGEN,37115,TANON,7401,24706,32107
32676,JAWA TENGAH,36985,SRAGEN,37158,SUMBERLAWANG,5418,22456,27874
32676,JAWA TENGAH,36985,SRAGEN,37082,KARANGMALANG,11753,27460,39213
32676,JAWA TENGAH,36985,SRAGEN,37018,MASARAN,12587,31576,44163
32676,JAWA TENGAH,36985,SRAGEN,37053,GONDANG,6765,19745,26510
32676,JAWA TENGAH,36985,SRAGEN,37147,MIRI,4092,16251,20343
32676,JAWA TENGAH,36790,KARANGANYAR,36975,JENAWI,4628,11445,16073
32676,JAWA TENGAH,36985,SRAGEN,37132,GEMOLONG,7463,21287,28750
32676,JAWA TENGAH,36985,SRAGEN,37206,JENAR,3148,13503,16651
32676,JAWA TENGAH,36985,SRAGEN,37180,SUKODONO,4950,13747,18697
32676,JAWA TENGAH,36985,SRAGEN,37043,SAMBIREJO,4598,16842,21440
32676,JAWA TENGAH,36985,SRAGEN,37032,KEDAWUNG,8015,28446,36461
32676,JAWA TENGAH,36985,SRAGEN,37170,MONDOKAN,3017,16991,20008
32676,JAWA TENGAH,36985,SRAGEN,37063,SAMBUNGMACAN,6830,21354,28184
32676,JAWA TENGAH,36985,SRAGEN,37198,TANGEN,3721,12285,16006
32676,JAWA TENGAH,36985,SRAGEN,37073,NGRAMPAL,5900,18235,24135
32676,JAWA TENGAH,36985,SRAGEN,37093,SRAGEN,11832,29784,41616
32676,JAWA TENGAH,37214,GROBOGAN,37434,GODONG,13901,28913,42814
32676,JAWA TENGAH,37214,GROBOGAN,37357,WIROSARI,12161,36063,48224
32676,JAWA TENGAH,37214,GROBOGAN,37424,KLAMBU,5873,13065,18938
32676,JAWA TENGAH,37214,GROBOGAN,37485,TEGOWANU,0,0,0
32676,JAWA TENGAH,36985,SRAGEN,37001,PLUPUH,5491,23320,28811
32676,JAWA TENGAH,37214,GROBOGAN,37414,BRATI,6648,18786,25434
32676,JAWA TENGAH,37214,GROBOGAN,37463,GUBUG,14325,26451,40776
32676,JAWA TENGAH,37214,GROBOGAN,37228,KARANGRAYUNG,9705,36188,45893
32676,JAWA TENGAH,37214,GROBOGAN,37372,TAWANGHARJO,6580,20819,27399
32676,JAWA TENGAH,37214,GROBOGAN,37215,KEDUNGJATI,7492,14829,22321
32676,JAWA TENGAH,37214,GROBOGAN,37300,PULOKULON,11612,42594,54206
32676,JAWA TENGAH,37514,BLORA,37766,TODANAN,8624,28624,37248
32676,JAWA TENGAH,37514,BLORA,37672,TUNJUNGAN,8613,17922,26535
32676,JAWA TENGAH,37214,GROBOGAN,37248,PENAWANGAN,0,0,0
32676,JAWA TENGAH,37214,GROBOGAN,37396,PURWODADI,21586,50862,72448
32676,JAWA TENGAH,37214,GROBOGAN,37314,KRADENAN,0,0,0
32676,JAWA TENGAH,37214,GROBOGAN,37344,NGARINGAN,9803,26044,35847
32676,JAWA TENGAH,37214,GROBOGAN,37504,TANGGUNGHARJO,5959,15222,21181
32676,JAWA TENGAH,37514,BLORA,37792,BOGOREJO,4608,10353,14961
32676,JAWA TENGAH,37514,BLORA,37617,JEPON,11059,25040,36099
32676,JAWA TENGAH,37214,GROBOGAN,37269,TOROH,13613,45775,59388
32676,JAWA TENGAH,37514,BLORA,37576,CEPU,17183,26112,43295
32676,JAWA TENGAH,37514,BLORA,37709,NGAWEN,9861,22473,32334
32676,JAWA TENGAH,37214,GROBOGAN,37383,GROBOGAN,0,0,0
32676,JAWA TENGAH,37214,GROBOGAN,37286,GEYER,7805,28142,35947
32676,JAWA TENGAH,37214,GROBOGAN,37329,GABUS,7148,31642,38790
32676,JAWA TENGAH,37514,BLORA,37594,SAMBONG,6789,9135,15924
32676,JAWA TENGAH,37514,BLORA,37515,JATI,7985,20211,28196
32676,JAWA TENGAH,37514,BLORA,37605,JIKEN,8277,14033,22310
32676,JAWA TENGAH,37826,REMBANG,38012,REMBANG,16407,36968,53375
32676,JAWA TENGAH,37826,REMBANG,37942,PAMOTAN,10768,16246,27014
32676,JAWA TENGAH,37514,BLORA,37688,BANJAREJO,9915,23146,33061
32676,JAWA TENGAH,37826,REMBANG,37966,SULANG,6463,17008,23471
32676,JAWA TENGAH,37826,REMBANG,37827,SUMBER,5634,16868,22502
32676,JAWA TENGAH,37826,REMBANG,38048,PANCUR,6739,10696,17435
32676,JAWA TENGAH,37826,REMBANG,38072,KRAGAN,10997,27224,38221
32676,JAWA TENGAH,37514,BLORA,37558,KEDUNGTUBAN,12561,19001,31562
32676,JAWA TENGAH,37514,BLORA,37643,BLORA,17306,36975,54281
32676,JAWA TENGAH,37514,BLORA,37547,KRADENAN,8749,14372,23121
32676,JAWA TENGAH,37514,BLORA,37739,KUNDURAN,10510,26782,37292
32676,JAWA TENGAH,37514,BLORA,37807,JAPAH,5611,14762,20373
32676,JAWA TENGAH,37826,REMBANG,38115,LASEM,9135,18839,27974
32676,JAWA TENGAH,37826,REMBANG,37988,KALIORI,5943,19617,25560
32676,JAWA TENGAH,37826,REMBANG,37863,GUNEM,4882,9641,14523
32676,JAWA TENGAH,37826,REMBANG,37880,SALE,7307,14943,22250
32676,JAWA TENGAH,37514,BLORA,37528,RANDUBLATUNG,17055,26235,43290
32676,JAWA TENGAH,37826,REMBANG,37920,SEDAN,14521,15279,29800
32676,JAWA TENGAH,38136,PATI,38424,TLOGOWUNGU,0,0,0
32676,JAWA TENGAH,37826,REMBANG,37846,BULU,4549,12279,16828
32676,JAWA TENGAH,37826,REMBANG,38100,SLUKE,4362,11608,15970
32676,JAWA TENGAH,38136,PATI,38412,GEMBONG,0,0,0
32676,JAWA TENGAH,38136,PATI,38440,WEDARIJAKSA,0,0,0
32676,JAWA TENGAH,38136,PATI,38512,TAYU,0,0,0
32676,JAWA TENGAH,38136,PATI,38137,SUKOLILO,0,0,0
32676,JAWA TENGAH,38136,PATI,38534,DUKUHSETI,0,0,0
32676,JAWA TENGAH,38136,PATI,38498,CLUWAK,0,0,0
32676,JAWA TENGAH,38136,PATI,38338,PATI,0,0,0
32676,JAWA TENGAH,38136,PATI,38222,PUCAKWANGI,0,0,0
32676,JAWA TENGAH,38136,PATI,38191,WINONG,0,0,0
32676,JAWA TENGAH,38136,PATI,38172,TAMBAKROMO,0,0,0
32676,JAWA TENGAH,38136,PATI,38314,JAKENAN,0,0,0
32676,JAWA TENGAH,38136,PATI,38284,JUWANA,0,0,0
32676,JAWA TENGAH,38136,PATI,38393,MARGOREJO,0,0,0
32676,JAWA TENGAH,38136,PATI,38265,BATANGAN,0,0,0
32676,JAWA TENGAH,38136,PATI,38368,GABUS,0,0,0
32676,JAWA TENGAH,38136,PATI,38459,MARGOYOSO,0,0,0
32676,JAWA TENGAH,38136,PATI,38547,TRANGKIL,0,0,0
32676,JAWA TENGAH,38136,PATI,38482,GUNUNGWUNGKAL,0,0,0
32676,JAWA TENGAH,38136,PATI,38154,KAYEN,0,0,0
32676,JAWA TENGAH,38706,JEPARA,38899,DONOROJO,8575,23119,31694
32676,JAWA TENGAH,38564,KUDUS,38664,BAE,18224,20862,39086
32676,JAWA TENGAH,37826,REMBANG,37896,SARANG,18747,18177,36924
32676,JAWA TENGAH,38564,KUDUS,38675,GEBOG,20288,30483,50771
32676,JAWA TENGAH,38564,KUDUS,38565,KALIWUNGU,23864,27994,51858
32676,JAWA TENGAH,38136,PATI,38243,JAKEN,0,0,0
32676,JAWA TENGAH,38564,KUDUS,38651,JEKULO,28108,31031,59139
32676,JAWA TENGAH,38564,KUDUS,38622,UNDAAN,16934,23930,40864
32676,JAWA TENGAH,38564,KUDUS,38607,JATI,26868,33698,60566
32676,JAWA TENGAH,38706,JEPARA,38858,NALUMSARI,11362,23815,35177
32676,JAWA TENGAH,38706,JEPARA,38812,BANGSRI,12216,39188,51404
32676,JAWA TENGAH,38564,KUDUS,38581,KUDUS,22734,31777,54511
32676,JAWA TENGAH,38564,KUDUS,38687,DAWE,19856,35716,55572
32676,JAWA TENGAH,38706,JEPARA,38842,TAHUNAN,13514,44946,58460
32676,JAWA TENGAH,38706,JEPARA,38707,KEDUNG,11714,25211,36925
32676,JAWA TENGAH,38564,KUDUS,38639,MEJOBO,18295,24893,43188
32676,JAWA TENGAH,38706,JEPARA,38874,KALINYAMATAN,13022,19165,32187
32676,JAWA TENGAH,38706,JEPARA,38755,MAYONG,15329,31047,46376
32676,JAWA TENGAH,38706,JEPARA,38887,KEMBANG,9721,29304,39025
32676,JAWA TENGAH,38917,DEMAK,39087,MIJEN,7974,19891,27865
32676,JAWA TENGAH,38917,DEMAK,38918,MRANGGEN,33483,53744,87227
32676,JAWA TENGAH,38706,JEPARA,38908,PAKIS AJI,8124,22394,30518
32676,JAWA TENGAH,38706,JEPARA,38803,MLONGGO,12133,30670,42803
32676,JAWA TENGAH,38706,JEPARA,38786,JEPARA,12818,31196,44014
32676,JAWA TENGAH,38706,JEPARA,38838,KARIMUN JAWA,988,3728,4716
32676,JAWA TENGAH,38706,JEPARA,38825,KELING,8011,27254,35265
32676,JAWA TENGAH,38917,DEMAK,38993,KARANGTENGAH,11281,21573,32854
32676,JAWA TENGAH,38706,JEPARA,38774,BATEALIT,14389,29415,43804
32676,JAWA TENGAH,38706,JEPARA,38739,WELAHAN,13474,27142,40616
32676,JAWA TENGAH,38917,DEMAK,39123,BONANG,17262,31864,49126
32676,JAWA TENGAH,38917,DEMAK,38938,KARANGAWEN,21766,28299,50065
32676,JAWA TENGAH,38917,DEMAK,39103,DEMAK,23527,34470,57997
32676,JAWA TENGAH,38917,DEMAK,39166,KEBONAGUNG,7504,13234,20738
32676,JAWA TENGAH,38917,DEMAK,39050,GAJAH,10882,15342,26224
32676,JAWA TENGAH,39181,SEMARANG,39182,GETASAN,10042,22729,32771
32676,JAWA TENGAH,38917,DEMAK,39033,DEMPET,11194,18571,29765
32676,JAWA TENGAH,38917,DEMAK,39145,WEDUNG,13575,23916,37491
32676,JAWA TENGAH,38706,JEPARA,38726,PECANGAAN,15351,28816,44167
32676,JAWA TENGAH,38917,DEMAK,39069,KARANGANYAR,12057,24775,36832
32676,JAWA TENGAH,38917,DEMAK,38972,SAYUNG,23464,32286,55750
32676,JAWA TENGAH,39181,SEMARANG,39290,JAMBU,9185,15169,24354
32676,JAWA TENGAH,39181,SEMARANG,39402,UNGARAN BARAT,0,0,0
32676,JAWA TENGAH,39181,SEMARANG,39318,AMBARAWA,11319,26255,37574
32676,JAWA TENGAH,38917,DEMAK,39011,WONOSALAM,13927,26713,40640
32676,JAWA TENGAH,39181,SEMARANG,39370,PRINGAPUS,11579,17931,29510
32676,JAWA TENGAH,39181,SEMARANG,39356,BERGAS,17081,22598,39679
32676,JAWA TENGAH,39181,SEMARANG,39390,KALIWUNGU,4651,13254,17905
32676,JAWA TENGAH,38917,DEMAK,38951,GUNTUR,16180,25048,41228
32676,JAWA TENGAH,39181,SEMARANG,39279,BANYUBIRU,10196,15343,25539
32676,JAWA TENGAH,39181,SEMARANG,39414,UNGARAN TIMUR,18054,22367,40421
32676,JAWA TENGAH,39181,SEMARANG,39329,BAWEN,12609,20824,33433
32676,JAWA TENGAH,39181,SEMARANG,39380,BANCAK,0,0,0
32676,JAWA TENGAH,39181,SEMARANG,39244,PABELAN,9308,15980,25288
32676,JAWA TENGAH,39181,SEMARANG,39196,TENGARAN,16397,24177,40574
32676,JAWA TENGAH,39436,TEMANGGUNG,39638,KRANGGAN,10216,18722,28938
32676,JAWA TENGAH,39181,SEMARANG,39339,BRINGIN,10165,15684,25849
32676,JAWA TENGAH,39436,TEMANGGUNG,39721,WONOBOYO,6252,9757,16009
32676,JAWA TENGAH,39436,TEMANGGUNG,39652,TLOGOMULYO,3440,11397,14837
32676,JAWA TENGAH,39436,TEMANGGUNG,39706,BEJEN,4610,8161,12771
32676,JAWA TENGAH,39436,TEMANGGUNG,39437,BULU,10895,19248,30143
32676,JAWA TENGAH,39181,SEMARANG,39301,SUMOWONO,8657,10658,19315
32676,JAWA TENGAH,39436,TEMANGGUNG,39692,KLEDUNG,4990,11960,16950
32676,JAWA TENGAH,39436,TEMANGGUNG,39623,CANDIROTO,6064,14113,20177
32676,JAWA TENGAH,39181,SEMARANG,39212,SUSUKAN,10269,16543,26812
32676,JAWA TENGAH,39436,TEMANGGUNG,39471,TEMANGGUNG,20538,28791,49329
32676,JAWA TENGAH,39181,SEMARANG,39425,BANDUNGAN,13504,20685,34189
32676,JAWA TENGAH,39436,TEMANGGUNG,39544,KEDU,14170,20595,34765
32676,JAWA TENGAH,39181,SEMARANG,39262,TUNTANG,14732,24114,38846
32676,JAWA TENGAH,39181,SEMARANG,39226,SURUH,15181,22460,37641
32676,JAWA TENGAH,39746,KENDAL,39912,WELERI,12702,22469,35171
32676,JAWA TENGAH,39436,TEMANGGUNG,39611,TRETEP,3881,9132,13013
32676,JAWA TENGAH,39746,KENDAL,39929,CEPIRING,12680,16947,29627
32676,JAWA TENGAH,39436,TEMANGGUNG,39597,JUMO,5997,12856,18853
32676,JAWA TENGAH,39746,KENDAL,39985,ROWOSARI,9254,19098,28352
32676,JAWA TENGAH,39436,TEMANGGUNG,39457,TEMBARAK,6729,11013,17742
32676,JAWA TENGAH,39436,TEMANGGUNG,39665,SELOPAMPANG,5737,6112,11849
32676,JAWA TENGAH,39436,TEMANGGUNG,39678,BANSARI,2509,13190,15699
32676,JAWA TENGAH,39436,TEMANGGUNG,39527,KANDANGAN,11985,18354,30339
32676,JAWA TENGAH,39746,KENDAL,39895,GEMUH,9810,18419,28229
32676,JAWA TENGAH,39436,TEMANGGUNG,39559,PARAKAN,11289,20857,32146
32676,JAWA TENGAH,39746,KENDAL,39945,PATEBON,14226,19499,33725
32676,JAWA TENGAH,39746,KENDAL,39747,PLANTUNGAN,6437,9941,16378
32676,JAWA TENGAH,39436,TEMANGGUNG,39512,KALORAN,9958,17319,27277
32676,JAWA TENGAH,39436,TEMANGGUNG,39576,NGADIREJO,8857,25266,34123
32676,JAWA TENGAH,39746,KENDAL,39794,PATEAN,10922,18843,29765
32676,JAWA TENGAH,39746,KENDAL,40018,RINGINARUM,6427,13844,20271
32676,JAWA TENGAH,39436,TEMANGGUNG,39497,PRINGSURAT,11300,19903,31203
32676,JAWA TENGAH,39436,TEMANGGUNG,39735,GEMAWANG,7795,12372,20167
32676,JAWA TENGAH,39746,KENDAL,39859,KALIWUNGU,17245,18495,35740
32676,JAWA TENGAH,39746,KENDAL,39823,LIMBANGAN,10447,10122,20569
32676,JAWA TENGAH,39746,KENDAL,39964,KENDAL,16157,16732,32889
32676,JAWA TENGAH,39746,KENDAL,39775,SUKOREJO,13853,20273,34126
32676,JAWA TENGAH,39746,KENDAL,39760,PAGERUYUNG,7826,12020,19846
32676,JAWA TENGAH,39746,KENDAL,40031,NGAMPEL,7251,11861,19112
32676,JAWA TENGAH,39746,KENDAL,40002,KANGKUNG,9276,17177,26453
32676,JAWA TENGAH,39746,KENDAL,39809,SINGOROJO,11692,17006,28698
32676,JAWA TENGAH,39746,KENDAL,39869,BRANGSONG,11991,15921,27912
32676,JAWA TENGAH,40053,BATANG,40221,TULIS,6546,14175,20721
32676,JAWA TENGAH,39746,KENDAL,39882,PEGANDON,8490,12393,20883
32676,JAWA TENGAH,40053,BATANG,40127,BAWANG,9845,19271,29116
32676,JAWA TENGAH,40053,BATANG,40294,PECALUNGAN,6124,11138,17262
32676,JAWA TENGAH,39746,KENDAL,39840,BOJA,20544,22772,43316
32676,JAWA TENGAH,39746,KENDAL,40044,KALIWUNGU SELATAN,11478,15649,27127
32676,JAWA TENGAH,40053,BATANG,40185,LIMPUNG,8581,16141,24722
32676,JAWA TENGAH,40053,BATANG,40203,SUBAH,9782,21225,31007
32676,JAWA TENGAH,40317,PEKALONGAN,40598,KARANGDADAP,5066,14802,19868
32676,JAWA TENGAH,40053,BATANG,40261,WARUNGASEM,8196,19604,27800
32676,JAWA TENGAH,40053,BATANG,40054,WONOTUNGGAL,7244,11974,19218
32676,JAWA TENGAH,40053,BATANG,40280,KANDEMAN,7706,19191,26897
32676,JAWA TENGAH,40053,BATANG,40088,BLADO,8343,14243,22586
32676,JAWA TENGAH,40053,BATANG,40070,BANDAR,11790,22628,34418
32676,JAWA TENGAH,40317,PEKALONGAN,40318,KANDANGSERANG,5388,11494,16882
32676,JAWA TENGAH,40317,PEKALONGAN,40550,TIRTO,10309,27694,38003
32676,JAWA TENGAH,40317,PEKALONGAN,40439,KESESI,11207,22725,33932
32676,JAWA TENGAH,40053,BATANG,40239,BATANG,26277,46083,72360
32676,JAWA TENGAH,40317,PEKALONGAN,40539,BUARAN,8427,16765,25192
32676,JAWA TENGAH,40317,PEKALONGAN,40504,WONOPRINGGO,7341,16203,23544
32676,JAWA TENGAH,40053,BATANG,40107,REBAN,7790,13289,21079
32676,JAWA TENGAH,40053,BATANG,40169,GRINGSING,11492,22122,33614
32676,JAWA TENGAH,40317,PEKALONGAN,40382,DORO,6561,15336,21897
32676,JAWA TENGAH,40317,PEKALONGAN,40333,PANINGGARAN,6528,11584,18112
32676,JAWA TENGAH,40317,PEKALONGAN,40519,KEDUNGWUNI,18124,34767,52891
32676,JAWA TENGAH,40053,BATANG,40148,TERSONO,9443,13338,22781
32676,JAWA TENGAH,40317,PEKALONGAN,40567,WIRADESA,11949,20788,32737
32676,JAWA TENGAH,40053,BATANG,40305,BANYUPUTIH,5860,14284,20144
32676,JAWA TENGAH,40317,PEKALONGAN,40371,TALUN,4520,10028,14548
32676,JAWA TENGAH,40317,PEKALONGAN,40361,PETUNGKRIYONO,2105,4886,6991
32676,JAWA TENGAH,40317,PEKALONGAN,40610,WONOKERTO,5019,17005,22024
32676,JAWA TENGAH,40317,PEKALONGAN,40584,SIWALAN,5028,15551,20579
32676,JAWA TENGAH,40317,PEKALONGAN,40481,BOJONG,9744,26604,36348
32676,JAWA TENGAH,40622,PEMALANG,40733,PEMALANG,36843,61976,98819
32676,JAWA TENGAH,40317,PEKALONGAN,40349,LEBAKBARANG,1516,4156,5672
32676,JAWA TENGAH,40622,PEMALANG,40660,WATUKUMPUL,9018,24996,34014
32676,JAWA TENGAH,40622,PEMALANG,40833,ULUJAMI,14131,42849,56980
32676,JAWA TENGAH,40317,PEKALONGAN,40413,KAJEN,13019,20409,33428
32676,JAWA TENGAH,40317,PEKALONGAN,40463,SRAGI,9207,23629,32836
32676,JAWA TENGAH,40622,PEMALANG,40623,MOGA,16932,13775,30707
32676,JAWA TENGAH,40622,PEMALANG,40676,BODEH,9093,20539,29632
32676,JAWA TENGAH,40859,TEGAL,41141,WARUREJA,10329,20342,30671
32676,JAWA TENGAH,40317,PEKALONGAN,40397,KARANGANYAR,7534,13819,21353
32676,JAWA TENGAH,40622,PEMALANG,40634,PULOSARI,13131,15417,28548
32676,JAWA TENGAH,40622,PEMALANG,40814,COMAL,14910,33516,48426
32676,JAWA TENGAH,40622,PEMALANG,40754,TAMAN,30608,55755,86363
32676,JAWA TENGAH,40622,PEMALANG,40776,PETARUKAN,24473,54920,79393
32676,JAWA TENGAH,40859,TEGAL,41068,DUKUHTURI,19389,26580,45969
32676,JAWA TENGAH,40622,PEMALANG,40852,WARUNGPRING,5630,12705,18335
32676,JAWA TENGAH,40622,PEMALANG,40797,AMPELGADING,10478,24394,34872
32676,JAWA TENGAH,40859,TEGAL,40932,PAGERBARANG,8323,19173,27496
32676,JAWA TENGAH,40859,TEGAL,41129,SURADADI,14611,28976,43587
32676,JAWA TENGAH,40622,PEMALANG,40714,RANDUDONGKAL,20286,30936,51222
32676,JAWA TENGAH,40859,TEGAL,41015,SLAWI,18385,22878,41263
32676,JAWA TENGAH,40622,PEMALANG,40696,BANTARBOLANG,11943,25472,37415
32676,JAWA TENGAH,40859,TEGAL,40991,PANGKAH,24861,31440,56301
32676,JAWA TENGAH,40859,TEGAL,41108,KRAMAT,20621,37785,58406
32676,JAWA TENGAH,40859,TEGAL,40860,MARGASARI,19655,29269,48924
32676,JAWA TENGAH,40622,PEMALANG,40647,BELIK,15217,36218,51435
32676,JAWA TENGAH,40859,TEGAL,41087,TARUB,14990,24449,39439
32676,JAWA TENGAH,41165,BREBES,41166,SALEM,14237,18963,33200
32676,JAWA TENGAH,40859,TEGAL,41026,ADIWERNA,25109,40877,65986
32676,JAWA TENGAH,40859,TEGAL,40962,JATINEGARA,11341,15294,26635
32676,JAWA TENGAH,40859,TEGAL,40946,LEBAKSIU,15347,26150,41497
32676,JAWA TENGAH,40859,TEGAL,40911,BALAPULANG,17672,23726,41398
32676,JAWA TENGAH,40859,TEGAL,41154,DUKUHWARU,10892,21175,32067
32676,JAWA TENGAH,41165,BREBES,41420,LARANGAN,22164,56845,79009
32676,JAWA TENGAH,40859,TEGAL,40980,KEDUNGBANTENG,8217,13124,21341
32676,JAWA TENGAH,40859,TEGAL,41048,TALANG,21883,31342,53225
32676,JAWA TENGAH,41165,BREBES,41250,TONJONG,16354,16615,32969
32676,JAWA TENGAH,41165,BREBES,41207,BUMIAYU,24154,29444,53598
32676,JAWA TENGAH,41165,BREBES,41400,BULAKAMBA,22243,55794,78037
32676,JAWA TENGAH,41165,BREBES,41223,PAGUYANGAN,16461,33550,50011
32676,JAWA TENGAH,40859,TEGAL,40874,BUMIJAWA,20600,21796,42396
32676,JAWA TENGAH,41165,BREBES,41344,KERSANA,10020,23549,33569
32676,JAWA TENGAH,41165,BREBES,41236,SIRAMPOG,14264,16062,30326
32676,JAWA TENGAH,41165,BREBES,41288,WANASARI,22596,54137,76733
32676,JAWA TENGAH,40859,TEGAL,40893,BOJONG,15625,17585,33210
32676,JAWA TENGAH,41165,BREBES,41358,LOSARI,19741,44362,64103
32676,JAWA TENGAH,41165,BREBES,41432,KETANGGUNGAN,26046,42651,68697
32676,JAWA TENGAH,41480,KOTA MAGELANG,41494,MAGELANG TENGAH,10687,17662,28349
32676,JAWA TENGAH,41501,KOTA SURAKARTA,41532,JEBRES,11173,77733,88906
32676,JAWA TENGAH,41501,KOTA SURAKARTA,41522,PASAR KLIWON,9992,40553,50545
32676,JAWA TENGAH,41501,KOTA SURAKARTA,41502,LAWEYAN,11424,47610,59034
32676,JAWA TENGAH,41165,BREBES,41381,TANJUNG,12520,35281,47801
32676,JAWA TENGAH,41165,BREBES,41265,JATIBARANG,16384,26810,43194
32676,JAWA TENGAH,41558,KOTA SALATIGA,41580,SIDOMUKTI,9218,15535,24753
32676,JAWA TENGAH,41501,KOTA SURAKARTA,41544,BANJARSARI,15354,90761,106115
32676,JAWA TENGAH,41165,BREBES,41333,SONGGOM,11284,25903,37187
32676,JAWA TENGAH,41480,KOTA MAGELANG,41481,MAGELANG SELATAN,10589,13871,24460
32676,JAWA TENGAH,41165,BREBES,41309,BREBES,30887,53922,84809
32676,JAWA TENGAH,41165,BREBES,41188,BANTARKAWUNG,19423,28090,47513
32676,JAWA TENGAH,41480,KOTA MAGELANG,41488,MAGELANG UTARA,10897,10523,21420
32676,JAWA TENGAH,41585,KOTA SEMARANG,41586,SEMARANG TENGAH,7745,29858,37603
32676,JAWA TENGAH,41165,BREBES,41454,BANJARHARJO,19197,39128,58325
32676,JAWA TENGAH,41558,KOTA SALATIGA,41559,SIDOREJO,10885,19723,30608
32676,JAWA TENGAH,41585,KOTA SEMARANG,41658,SEMARANG SELATAN,12467,29157,41624
32676,JAWA TENGAH,41585,KOTA SEMARANG,41760,NGALIYAN,31692,45356,77048
32676,JAWA TENGAH,41585,KOTA SEMARANG,41602,SEMARANG UTARA,16759,53375,70134
32676,JAWA TENGAH,41558,KOTA SALATIGA,41573,ARGOMULYO,9905,16292,26197
32676,JAWA TENGAH,41585,KOTA SEMARANG,41623,GAYAM SARI,11293,29708,41001
32676,JAWA TENGAH,41585,KOTA SEMARANG,41645,PEDURUNGAN,33160,71319,104479
32676,JAWA TENGAH,41501,KOTA SURAKARTA,41514,SERENGAN,4760,27542,32302
32676,JAWA TENGAH,41585,KOTA SEMARANG,41745,MIJEN,15573,19602,35175
32676,JAWA TENGAH,41558,KOTA SALATIGA,41566,TINGKIR,8620,17114,25734
32676,JAWA TENGAH,41585,KOTA SEMARANG,41677,GAJAH MUNGKUR,11294,23001,34295
32676,JAWA TENGAH,41585,KOTA SEMARANG,41711,GUNUNGPATI,20928,29560,50488
32676,JAWA TENGAH,41779,KOTA PEKALONGAN,41808,PEKALONGAN UTARA,17342,26262,43604
32676,JAWA TENGAH,41585,KOTA SEMARANG,41728,SEMARANG BARAT,25016,65319,90335
32676,JAWA TENGAH,41779,KOTA PEKALONGAN,41819,PEKALONGAN SELATAN,11589,20383,31972
32676,JAWA TENGAH,41585,KOTA SEMARANG,41631,GENUK,18179,37678,55857
32676,JAWA TENGAH,41585,KOTA SEMARANG,41771,TUGU,8304,9716,18020
32676,JAWA TENGAH,41585,KOTA SEMARANG,41699,BANYUMANIK,28471,49308,77779
32676,JAWA TENGAH,41585,KOTA SEMARANG,41669,CANDISARI,13810,33069,46879
32676,JAWA TENGAH,41585,KOTA SEMARANG,41686,TEMBALANG,28756,63864,92620
32676,JAWA TENGAH,41831,KOTA TEGAL,41840,TEGAL TIMUR,19531,23428,42959
32676,JAWA TENGAH,41585,KOTA SEMARANG,41612,SEMARANG TIMUR,9049,34399,43448
41863,DAERAH ISTIMEWA YOGYAKARTA,41864,KULON PROGO,41952,SAMIGALUH,7711,9633,17344
32676,JAWA TENGAH,41779,KOTA PEKALONGAN,41794,PEKALONGAN TIMUR,15273,21727,37000
41863,DAERAH ISTIMEWA YOGYAKARTA,41864,KULON PROGO,41940,GIRIMULYO,6704,8515,15219
41863,DAERAH ISTIMEWA YOGYAKARTA,41864,KULON PROGO,41926,PENGASIH,14963,15224,30187
41863,DAERAH ISTIMEWA YOGYAKARTA,41864,KULON PROGO,41865,TEMON,8037,8308,16345
41863,DAERAH ISTIMEWA YOGYAKARTA,41864,KULON PROGO,41934,KOKAP,9084,12178,21262
32676,JAWA TENGAH,41779,KOTA PEKALONGAN,41780,PEKALONGAN BARAT,20534,31442,51976
32676,JAWA TENGAH,41831,KOTA TEGAL,41855,MARGADANA,8131,13944,22075
32676,JAWA TENGAH,41831,KOTA TEGAL,41832,TEGAL BARAT,13286,22593,35879
41863,DAERAH ISTIMEWA YOGYAKARTA,41965,BANTUL,42033,PLERET,14595,14050,28645
32676,JAWA TENGAH,41831,KOTA TEGAL,41846,TEGAL SELATAN,14964,18810,33774
41863,DAERAH ISTIMEWA YOGYAKARTA,41864,KULON PROGO,41917,SENTOLO,14700,15069,29769
41863,DAERAH ISTIMEWA YOGYAKARTA,41965,BANTUL,41966,SRANDAKAN,8983,10818,19801
41863,DAERAH ISTIMEWA YOGYAKARTA,41864,KULON PROGO,41945,NANGGULAN,9414,9160,18574
41863,DAERAH ISTIMEWA YOGYAKARTA,41965,BANTUL,42008,IMOGIRI,17068,21086,38154
41863,DAERAH ISTIMEWA YOGYAKARTA,41864,KULON PROGO,41960,KALIBAWANG,8069,10190,18259
41863,DAERAH ISTIMEWA YOGYAKARTA,41965,BANTUL,42039,PIYUNGAN,14949,17163,32112
41863,DAERAH ISTIMEWA YOGYAKARTA,41864,KULON PROGO,41881,WATES,13880,15035,28915
41863,DAERAH ISTIMEWA YOGYAKARTA,41864,KULON PROGO,41910,LENDAH,12493,12934,25427
41863,DAERAH ISTIMEWA YOGYAKARTA,41864,KULON PROGO,41890,PANJATAN,11131,11557,22688
41863,DAERAH ISTIMEWA YOGYAKARTA,41965,BANTUL,42003,JETIS,16802,19291,36093
41863,DAERAH ISTIMEWA YOGYAKARTA,41864,KULON PROGO,41902,GALUR,10959,9078,20037
41863,DAERAH ISTIMEWA YOGYAKARTA,41965,BANTUL,42017,DLINGO,8570,15742,24312
41863,DAERAH ISTIMEWA YOGYAKARTA,41965,BANTUL,42043,SEWON,27703,34081,61784
41863,DAERAH ISTIMEWA YOGYAKARTA,42058,GUNUNGKIDUL,42200,GIRISUBO,5073,10338,15411
41863,DAERAH ISTIMEWA YOGYAKARTA,41965,BANTUL,42024,BANGUNTAPAN,31177,35058,66235
41863,DAERAH ISTIMEWA YOGYAKARTA,42058,GUNUNGKIDUL,42184,GEDANGSARI,5959,15997,21956
41863,DAERAH ISTIMEWA YOGYAKARTA,41965,BANTUL,41993,PAJANGAN,11335,10788,22123
41863,DAERAH ISTIMEWA YOGYAKARTA,41965,BANTUL,42053,SEDAYU,16185,13078,29263
41863,DAERAH ISTIMEWA YOGYAKARTA,41965,BANTUL,42048,KASIHAN,29222,35376,64598
41863,DAERAH ISTIMEWA YOGYAKARTA,42058,GUNUNGKIDUL,42135,KARANGMOJO,11499,21820,33319
41863,DAERAH ISTIMEWA YOGYAKARTA,41965,BANTUL,41988,PANDAK,14072,19020,33092
41863,DAERAH ISTIMEWA YOGYAKARTA,42058,GUNUNGKIDUL,42209,TANJUNGSARI,8243,10562,18805
41863,DAERAH ISTIMEWA YOGYAKARTA,41965,BANTUL,41984,BAMBANGLIPURO,11585,14330,25915
41863,DAERAH ISTIMEWA YOGYAKARTA,41965,BANTUL,41997,BANTUL,18303,21892,40195
41863,DAERAH ISTIMEWA YOGYAKARTA,42058,GUNUNGKIDUL,42059,WONOSARI,22398,31101,53499
41863,DAERAH ISTIMEWA YOGYAKARTA,42058,GUNUNGKIDUL,42116,PANGGANG,8173,9669,17842
41863,DAERAH ISTIMEWA YOGYAKARTA,42058,GUNUNGKIDUL,42123,TEPUS,10484,11824,22308
41863,DAERAH ISTIMEWA YOGYAKARTA,42058,GUNUNGKIDUL,42129,SEMANU,13007,23330,36337
41863,DAERAH ISTIMEWA YOGYAKARTA,42058,GUNUNGKIDUL,42108,PALIYAN,9713,9452,19165
41863,DAERAH ISTIMEWA YOGYAKARTA,41965,BANTUL,41969,SANDEN,11478,9242,20720
41863,DAERAH ISTIMEWA YOGYAKARTA,42058,GUNUNGKIDUL,42177,NGAWEN,5269,15028,20297
41863,DAERAH ISTIMEWA YOGYAKARTA,42058,GUNUNGKIDUL,42157,RONGKOP,5673,13179,18852
41863,DAERAH ISTIMEWA YOGYAKARTA,42058,GUNUNGKIDUL,42192,SAPTOSARI,12112,11430,23542
41863,DAERAH ISTIMEWA YOGYAKARTA,42058,GUNUNGKIDUL,42166,SEMIN,9097,23175,32272
41863,DAERAH ISTIMEWA YOGYAKARTA,41965,BANTUL,41974,KRETEK,9583,9976,19559
41863,DAERAH ISTIMEWA YOGYAKARTA,41965,BANTUL,41980,PUNDONG,9925,12392,22317
41863,DAERAH ISTIMEWA YOGYAKARTA,42221,SLEMAN,42275,KALASAN,19563,28393,47956
41863,DAERAH ISTIMEWA YOGYAKARTA,42221,SLEMAN,42222,GAMPING,25451,31468,56919
41863,DAERAH ISTIMEWA YOGYAKARTA,42058,GUNUNGKIDUL,42145,PONJONG,11529,22255,33784
41863,DAERAH ISTIMEWA YOGYAKARTA,42058,GUNUNGKIDUL,42215,PURWOSARI,5972,6697,12669
41863,DAERAH ISTIMEWA YOGYAKARTA,42221,SLEMAN,42253,MLATI,24638,33318,57956
41863,DAERAH ISTIMEWA YOGYAKARTA,42221,SLEMAN,42286,NGAGLIK,24966,33453,58419
41863,DAERAH ISTIMEWA YOGYAKARTA,42058,GUNUNGKIDUL,42082,PLAYEN,14709,22005,36714
41863,DAERAH ISTIMEWA YOGYAKARTA,42221,SLEMAN,42313,PAKEM,10709,12803,23512
41863,DAERAH ISTIMEWA YOGYAKARTA,42221,SLEMAN,42259,DEPOK,30186,48189,78375
41863,DAERAH ISTIMEWA YOGYAKARTA,42221,SLEMAN,42293,SLEMAN,20163,21812,41975
41863,DAERAH ISTIMEWA YOGYAKARTA,42221,SLEMAN,42263,BERBAH,14513,17812,32325
41863,DAERAH ISTIMEWA YOGYAKARTA,42221,SLEMAN,42236,MOYUDAN,13727,8127,21854
41863,DAERAH ISTIMEWA YOGYAKARTA,42221,SLEMAN,42268,PRAMBANAN,15005,17018,32023
41863,DAERAH ISTIMEWA YOGYAKARTA,42058,GUNUNGKIDUL,42096,PATUK,9112,11423,20535
41863,DAERAH ISTIMEWA YOGYAKARTA,42221,SLEMAN,42247,SEYEGAN,15947,15002,30949
41863,DAERAH ISTIMEWA YOGYAKARTA,42221,SLEMAN,42299,TEMPEL,18729,14968,33697
41863,DAERAH ISTIMEWA YOGYAKARTA,42221,SLEMAN,42319,CANGKRINGAN,9108,10086,19194
41863,DAERAH ISTIMEWA YOGYAKARTA,42058,GUNUNGKIDUL,42074,NGLIPAR,8779,10825,19604
41863,DAERAH ISTIMEWA YOGYAKARTA,42221,SLEMAN,42280,NGEMPLAK,17016,20268,37284
41863,DAERAH ISTIMEWA YOGYAKARTA,42325,KOTA YOGYAKARTA,42363,GONDOMANAN,3646,5848,9494
41863,DAERAH ISTIMEWA YOGYAKARTA,42325,KOTA YOGYAKARTA,42373,UMBULHARJO,18563,21583,40146
41863,DAERAH ISTIMEWA YOGYAKARTA,42325,KOTA YOGYAKARTA,42326,TEGALREJO,7783,14307,22090
41863,DAERAH ISTIMEWA YOGYAKARTA,42221,SLEMAN,42308,TURI,12594,10309,22903
41863,DAERAH ISTIMEWA YOGYAKARTA,42325,KOTA YOGYAKARTA,42341,DANUREJAN,4581,8127,12708
41863,DAERAH ISTIMEWA YOGYAKARTA,42325,KOTA YOGYAKARTA,42355,MANTRIJERON,8782,12333,21115
41863,DAERAH ISTIMEWA YOGYAKARTA,42221,SLEMAN,42241,MINGGIR,10452,10471,20923
41863,DAERAH ISTIMEWA YOGYAKARTA,42325,KOTA YOGYAKARTA,42345,GEDONGTENGEN,3465,8842,12307
41863,DAERAH ISTIMEWA YOGYAKARTA,42325,KOTA YOGYAKARTA,42351,WIROBRAJAN,6422,9629,16051
41863,DAERAH ISTIMEWA YOGYAKARTA,42325,KOTA YOGYAKARTA,42366,PAKUALAMAN,2362,4628,6990
41863,DAERAH ISTIMEWA YOGYAKARTA,42325,KOTA YOGYAKARTA,42381,KOTAGEDE,10404,9285,19689
41863,DAERAH ISTIMEWA YOGYAKARTA,42325,KOTA YOGYAKARTA,42359,KRATON,5407,7760,13167
41863,DAERAH ISTIMEWA YOGYAKARTA,42221,SLEMAN,42228,GODEAN,20653,22478,43131
42385,JAWA TIMUR,42386,PACITAN,42540,NGADIROJO,17139,9779,26918
41863,DAERAH ISTIMEWA YOGYAKARTA,42325,KOTA YOGYAKARTA,42335,GONDOKUSUMAN,8896,17113,26009
41863,DAERAH ISTIMEWA YOGYAKARTA,42325,KOTA YOGYAKARTA,42348,NGAMPILAN,4916,6038,10954
41863,DAERAH ISTIMEWA YOGYAKARTA,42325,KOTA YOGYAKARTA,42369,MERGANGSAN,7990,11255,19245
42385,JAWA TIMUR,42570,PONOROGO,42771,BADEGAN,8115,9204,17319
41863,DAERAH ISTIMEWA YOGYAKARTA,42325,KOTA YOGYAKARTA,42331,JETIS,5224,11152,16376
42385,JAWA TIMUR,42386,PACITAN,42502,BANDAR,15693,8153,23846
42385,JAWA TIMUR,42386,PACITAN,42511,TEGALOMBO,17277,8915,26192
42385,JAWA TIMUR,42570,PONOROGO,42794,SUKOREJO,15545,16161,31706
42385,JAWA TIMUR,42386,PACITAN,42492,NAWANGAN,14975,10887,25862
42385,JAWA TIMUR,42570,PONOROGO,42813,BABADAN,14499,24784,39283
42385,JAWA TIMUR,42386,PACITAN,42387,DONOROJO,9123,11467,20590
42385,JAWA TIMUR,42386,PACITAN,42523,TULAKAN,26475,16301,42776
42385,JAWA TIMUR,42570,PONOROGO,42829,PONOROGO,18820,25393,44213
42385,JAWA TIMUR,42386,PACITAN,42454,KEBONAGUNG,19865,7227,27092
42385,JAWA TIMUR,42386,PACITAN,42474,ARJOSARI,15613,6540,22153
42385,JAWA TIMUR,42386,PACITAN,42559,SUDIMORO,8628,9057,17685
42385,JAWA TIMUR,42570,PONOROGO,42571,SLAHUNG,14996,14666,29662
42385,JAWA TIMUR,42386,PACITAN,42414,PUNUNG,13649,7683,21332
42385,JAWA TIMUR,42570,PONOROGO,42714,SIMAN,12521,12897,25418
42385,JAWA TIMUR,42570,PONOROGO,42849,JENANGAN,16777,16221,32998
42385,JAWA TIMUR,42570,PONOROGO,42733,BALONG,14788,11562,26350
42385,JAWA TIMUR,42570,PONOROGO,42782,SAMPUNG,10632,12323,22955
42385,JAWA TIMUR,42386,PACITAN,42400,PRINGKUKU,12521,6407,18928
42385,JAWA TIMUR,42386,PACITAN,42428,PACITAN,34407,9916,44323
42385,JAWA TIMUR,42570,PONOROGO,42699,JETIS,9724,8563,18287
42385,JAWA TIMUR,42570,PONOROGO,42754,KAUMAN,12564,12829,25393
42385,JAWA TIMUR,42570,PONOROGO,42642,SAWOO,15828,16810,32638
42385,JAWA TIMUR,42897,TRENGGALEK,43021,TRENGGALEK,17039,21062,38101
42385,JAWA TIMUR,42570,PONOROGO,42657,SOOKO,6203,8336,14539
42385,JAWA TIMUR,42897,TRENGGALEK,42979,KAMPAK,5902,16058,21960
42385,JAWA TIMUR,42570,PONOROGO,42594,NGRAYUN,12722,21510,34232
42385,JAWA TIMUR,42570,PONOROGO,42626,SAMBIT,9681,11922,21603
42385,JAWA TIMUR,42897,TRENGGALEK,43046,DURENAN,11930,17569,29499
42385,JAWA TIMUR,42897,TRENGGALEK,43000,BENDUNGAN,5583,9649,15232
42385,JAWA TIMUR,42570,PONOROGO,42867,NGEBEL,5685,6621,12306
42385,JAWA TIMUR,42897,TRENGGALEK,42950,TUGU,12137,14949,27086
42385,JAWA TIMUR,42570,PONOROGO,42876,JAMBON,11309,12064,23373
42385,JAWA TIMUR,42897,TRENGGALEK,42916,MUNJUNGAN,7575,22342,29917
42385,JAWA TIMUR,42570,PONOROGO,42606,BUNGKAL,11809,10734,22543
42385,JAWA TIMUR,42897,TRENGGALEK,42966,KARANGAN,12466,15590,28056
42385,JAWA TIMUR,42570,PONOROGO,42664,PULUNG,12483,17518,30001
42385,JAWA TIMUR,42897,TRENGGALEK,42898,PANGGUL,11137,28641,39778
42385,JAWA TIMUR,42570,PONOROGO,42890,PUDAK,2970,2712,5682
42385,JAWA TIMUR,42897,TRENGGALEK,43035,POGALAN,11172,18201,29373
42385,JAWA TIMUR,42570,PONOROGO,42683,MLARAK,12714,7859,20573
42385,JAWA TIMUR,43069,TULUNGAGUNG,43292,BESUKI,7599,13921,21520
42385,JAWA TIMUR,43069,TULUNGAGUNG,43257,REJOTANGAN,14204,28079,42283
42385,JAWA TIMUR,43069,TULUNGAGUNG,43303,CAMPURDARAT,9374,24051,33425
42385,JAWA TIMUR,42897,TRENGGALEK,43009,GANDUSARI,11734,19249,30983
42385,JAWA TIMUR,42897,TRENGGALEK,42987,WATULIMO,10066,29747,39813
42385,JAWA TIMUR,43069,TULUNGAGUNG,43332,PAKEL,11449,19477,30926
42385,JAWA TIMUR,43069,TULUNGAGUNG,43313,BANDUNG,9980,17779,27759
42385,JAWA TIMUR,42897,TRENGGALEK,42928,PULE,10538,19744,30282
42385,JAWA TIMUR,43069,TULUNGAGUNG,43070,TULUNGAGUNG,14699,23191,37890
42385,JAWA TIMUR,43069,TULUNGAGUNG,43228,NGUNUT,13040,32010,45050
42385,JAWA TIMUR,42897,TRENGGALEK,42939,DONGKO,7825,25603,33428
42385,JAWA TIMUR,43069,TULUNGAGUNG,43175,KARANGREJO,9904,14804,24708
42385,JAWA TIMUR,43069,TULUNGAGUNG,43085,BOYOLANGU,16835,30131,46966
42385,JAWA TIMUR,43069,TULUNGAGUNG,43247,PUCANGLABAN,4458,9089,13547
42385,JAWA TIMUR,43069,TULUNGAGUNG,43163,SENDANG,10865,16273,27138
42385,JAWA TIMUR,43069,TULUNGAGUNG,43189,GONDANG,14908,19048,33956
42385,JAWA TIMUR,43069,TULUNGAGUNG,43210,SUMBERGEMPOL,11481,26470,37951
42385,JAWA TIMUR,42897,TRENGGALEK,43061,SURUH,5876,9368,15244
42385,JAWA TIMUR,43069,TULUNGAGUNG,43103,KEDUNGWARU,16708,35162,51870
42385,JAWA TIMUR,43360,BLITAR,43361,WONODADI,8057,18884,26941
42385,JAWA TIMUR,43360,BLITAR,43515,PANGGUNGREJO,7064,17912,24976
42385,JAWA TIMUR,43069,TULUNGAGUNG,43123,NGANTRU,8797,23505,32302
42385,JAWA TIMUR,43360,BLITAR,43610,SELOREJO,6331,15215,21546
42385,JAWA TIMUR,43360,BLITAR,43601,WATES,3815,13359,17174
42385,JAWA TIMUR,43069,TULUNGAGUNG,43151,PAGERWOJO,8214,10649,18863
42385,JAWA TIMUR,43360,BLITAR,43569,WLINGI,0,0,0
42385,JAWA TIMUR,43069,TULUNGAGUNG,43274,KALIDAWIR,11955,28310,40265
42385,JAWA TIMUR,43069,TULUNGAGUNG,43137,KAUMAN,11950,18955,30905
42385,JAWA TIMUR,43360,BLITAR,43493,GARUM,10446,26506,36952
42385,JAWA TIMUR,43069,TULUNGAGUNG,43352,TANGGUNGGUNUNG,4552,10578,15130
42385,JAWA TIMUR,43360,BLITAR,43541,GANDUSARI,12196,28264,40460
42385,JAWA TIMUR,43360,BLITAR,43556,BINANGUN,8245,18144,26389
42385,JAWA TIMUR,43360,BLITAR,43446,SANANKULON,9157,22855,32012
42385,JAWA TIMUR,43360,BLITAR,43386,SRENGAT,10398,27138,37536
42385,JAWA TIMUR,43360,BLITAR,43503,SUTOJAYAN,8719,19216,27935
42385,JAWA TIMUR,43360,BLITAR,43526,TALUN,11594,24578,36172
42385,JAWA TIMUR,43360,BLITAR,43373,UDANAWU,7205,16559,23764
42385,JAWA TIMUR,43360,BLITAR,43480,KANIGORO,0,0,0
42385,JAWA TIMUR,43630,KEDIRI,43860,PLEMAHAN,12677,21906,34583
42385,JAWA TIMUR,43630,KEDIRI,43888,KEPUNG,13876,32364,46240
42385,JAWA TIMUR,43360,BLITAR,43590,KESAMBEN,7735,21964,29699
42385,JAWA TIMUR,43360,BLITAR,43579,DOKO,6599,17159,23758
42385,JAWA TIMUR,43360,BLITAR,43459,WONOTIRTO,0,0,0
42385,JAWA TIMUR,43630,KEDIRI,43899,KANDANGAN,8494,19369,27863
42385,JAWA TIMUR,43360,BLITAR,43468,NGLEGOK,11279,30777,42056
42385,JAWA TIMUR,43360,BLITAR,43430,PONGGOK,0,0,0
42385,JAWA TIMUR,43360,BLITAR,43402,KADEMANGAN,10670,28945,39615
42385,JAWA TIMUR,43360,BLITAR,43418,BAKUNG,5519,10952,16471
42385,JAWA TIMUR,43630,KEDIRI,43631,SEMEN,9707,20914,30621
42385,JAWA TIMUR,43630,KEDIRI,43836,PURWOASRI,11936,21501,33437
42385,JAWA TIMUR,43360,BLITAR,43621,SELOPURO,7810,16741,24551
42385,JAWA TIMUR,43630,KEDIRI,43878,PARE,20674,37748,58422
42385,JAWA TIMUR,43630,KEDIRI,43682,NGADILUWIH,13208,31739,44947
42385,JAWA TIMUR,43630,KEDIRI,43818,PAPAR,10871,18902,29773
42385,JAWA TIMUR,43630,KEDIRI,43912,TAROKAN,9554,22442,31996
42385,JAWA TIMUR,43630,KEDIRI,43923,KUNJANG,8254,12992,21246
42385,JAWA TIMUR,43630,KEDIRI,43936,BANYAKAN,11505,22148,33653
42385,JAWA TIMUR,43630,KEDIRI,43958,KAYEN KIDUL,9247,18699,27946
42385,JAWA TIMUR,43630,KEDIRI,43808,GROGOL,9367,16467,25834
42385,JAWA TIMUR,43630,KEDIRI,43971,NGASEM,13247,25408,38655
42385,JAWA TIMUR,43630,KEDIRI,43724,NGANCAR,5982,21727,27709
42385,JAWA TIMUR,43630,KEDIRI,43946,RINGINREJO,9061,21873,30934
42385,JAWA TIMUR,43630,KEDIRI,43735,PUNCU,10074,25737,35811
42385,JAWA TIMUR,43993,MALANG,44246,PAKISAJI,17836,31259,49095
42385,JAWA TIMUR,43630,KEDIRI,43984,BADAS,14019,21740,35759
42385,JAWA TIMUR,43630,KEDIRI,43644,MOJO,16808,26336,43144
42385,JAWA TIMUR,43630,KEDIRI,43665,KRAS,10200,25411,35611
42385,JAWA TIMUR,43630,KEDIRI,43744,PLOSOKLATEN,11969,29200,41169
42385,JAWA TIMUR,43630,KEDIRI,43699,KANDAT,9252,25869,35121
42385,JAWA TIMUR,43630,KEDIRI,43712,WATES,13465,38746,52211
42385,JAWA TIMUR,43993,MALANG,44259,NGAJUNG,10923,17569,28492
42385,JAWA TIMUR,43993,MALANG,44334,PUJON,17902,21338,39240
42385,JAWA TIMUR,43993,MALANG,44269,WAGIR,14463,34501,48964
42385,JAWA TIMUR,43630,KEDIRI,43796,GAMPENGREJO,7366,12518,19884
42385,JAWA TIMUR,43993,MALANG,44293,KARANG PLOSO,16550,26544,43094
42385,JAWA TIMUR,43630,KEDIRI,43782,PAGU,8230,15183,23413
42385,JAWA TIMUR,43630,KEDIRI,43760,GURAH,15386,32517,47903
42385,JAWA TIMUR,43993,MALANG,43994,DONOMULYO,8124,28058,36182
42385,JAWA TIMUR,43993,MALANG,44389,KROMENGAN,8705,14408,23113
42385,JAWA TIMUR,43993,MALANG,44359,KASEMBON,6467,10756,17223
42385,JAWA TIMUR,43993,MALANG,44366,GEDANGAN,10392,19496,29888
42385,JAWA TIMUR,43993,MALANG,44282,DAU,14642,23245,37887
42385,JAWA TIMUR,43993,MALANG,44054,AMPELGADING,11041,20283,31324
