ProvinceName,KabupatenName,KecamatanName,PrabowoHattaVotes,JokowiKallaVotes,TotalVotes
ACEH,ACEH SELATAN,TRUMON TIMUR,0,0,0
ACEH,ACEH SELATAN,KLUET TENGAH,0,0,0
ACEH,ACEH SELATAN,KOTA BAHAGIA,1172,1389,2561
ACEH,ACEH SELATAN,BAKONGAN,0,0,0
ACEH,ACEH SELATAN,LABUHAN HAJI TIMUR,0,0,0
ACEH,ACEH SELATAN,LABUHAN HAJI BARAT,3584,3200,6784
ACEH,ACEH SELATAN,BAKONGAN TIMUR,1027,1230,2257
ACEH,ACEH SELATAN,KLUET TIMUR,2552,1689,4241
ACEH,ACEH SELATAN,SAMADUA,6333,2476,8809
ACEH,ACEH SELATAN,SAWANG,4676,2743,7419
ACEH,ACEH SELATAN,MEUKEK,5016,3676,8692
ACEH,ACEH SELATAN,TAPAKTUAN,7752,3401,11153
ACEH,ACEH SELATAN,KLUET UTARA,5194,5108,10302
ACEH,ACEH SELATAN,PASIE RAJA,3470,2925,6395
ACEH,ACEH SELATAN,TRUMON,950,1174,2124
ACEH,ACEH TENGGARA,TANOH ALAS,1398,881,2279
ACEH,ACEH SELATAN,KLUET SELATAN,2779,3259,6038
ACEH,ACEH TENGGARA,DELENG POKHKISEN,0,0,0
ACEH,ACEH SELATAN,LABUHAN HAJI,0,0,0
ACEH,ACEH TENGGARA,LAWE ALAS,7473,2030,9503
ACEH,ACEH TENGGARA,SEMADAM,0,0,0
ACEH,ACEH SELATAN,TRUMON TENGAH,0,0,0
ACEH,ACEH TENGGARA,LAWE BULAN,6165,2590,8755
ACEH,ACEH TENGGARA,LAWE SUMUR,0,0,0
ACEH,ACEH TENGGARA,BABUL RAHMAH,0,0,0
ACEH,ACEH TENGGARA,KETAMBE,3705,2347,6052
ACEH,ACEH TENGGARA,BUKIT TUSAM,0,0,0
ACEH,ACEH TENGGARA,DARUL HASANAH,0,0,0
ACEH,ACEH TIMUR,BANDA ALAM,960,1731,2691
ACEH,ACEH TENGGARA,BAMBEL,7774,2528,10302
ACEH,ACEH TENGGARA,BABUL MAKMUR,0,0,0
ACEH,ACEH TENGGARA,BABUSSALAM,0,0,0
ACEH,ACEH TIMUR,DARUL AMAN,2354,3297,5651
ACEH,ACEH TENGGARA,BADAR,0,0,0
ACEH,ACEH TIMUR,DARUL IHSAN,1155,1195,2350
ACEH,ACEH TIMUR,PEUDAWA,1637,1673,3310
ACEH,ACEH TENGGARA,LEUSER,0,0,0
ACEH,ACEH TIMUR,INDRA MAKMU,4063,1733,5796
ACEH,ACEH TIMUR,MADAT,3393,3941,7334
ACEH,ACEH TIMUR,IDI TUNONG,1746,1748,3494
ACEH,ACEH TIMUR,PEUREULAK TIMUR,1391,2678,4069
ACEH,ACEH TIMUR,SUNGAI RAYA,1477,1872,3349
ACEH,ACEH TIMUR,IDI RAYEUK,5577,5106,10683
ACEH,ACEH TIMUR,DARUL FALAH,442,1084,1526
ACEH,ACEH TIMUR,SERBAJADI,1893,1267,3160
ACEH,ACEH TIMUR,PEUREULAK,4870,6850,11720
ACEH,ACEH TIMUR,PEUREULAK BARAT,2282,2048,4330
ACEH,ACEH TENGAH,LINGE,2239,3127,5366
ACEH,ACEH TIMUR,SIMPANG JERNIH,1300,544,1844
ACEH,ACEH TIMUR,RANTAU SELAMAT,1835,1942,3777
ACEH,ACEH TIMUR,SIMPANG ULIM,2492,2775,5267
ACEH,ACEH TIMUR,IDI TIMUR,824,1153,1977
ACEH,ACEH TIMUR,JULOK,3589,4736,8325
ACEH,ACEH TIMUR,PANTE BIDARI,2626,4052,6678
ACEH,ACEH TIMUR,RANTAU PEUREULAK,5339,3238,8577
ACEH,ACEH TIMUR,PEUNARON,2315,1801,4116
ACEH,ACEH TENGAH,CELALA,1747,3106,4853
ACEH,ACEH TIMUR,NURUSSALAM,2570,3702,6272
ACEH,ACEH TIMUR,BIREM BAYEUN,8471,3382,11853
ACEH,ACEH TENGAH,PEGASING,3528,6690,10218
ACEH,ACEH TENGAH,KEBAYAKAN,3047,4750,7797
ACEH,ACEH TENGAH,RUSIP ANTARA,1525,2194,3719
ACEH,ACEH TENGAH,BIES,1865,2243,4108
ACEH,ACEH TENGAH,LAUT TAWAR,3987,5035,9022
ACEH,ACEH TENGAH,KETOL,3311,3819,7130
ACEH,ACEH TENGAH,ATU LINTANG,1972,1413,3385
ACEH,ACEH BARAT,WOYLA BARAT,2425,1714,4139
ACEH,ACEH BARAT,PANTE CEUREUMEN,3245,2270,5515
ACEH,ACEH TENGAH,KUTE PANANG,1463,2745,4208
ACEH,ACEH TENGAH,JAGONG JEGET,3274,1968,5242
ACEH,ACEH TENGAH,SILIH NARA,4403,7420,11823
ACEH,ACEH TENGAH,BEBESEN,6936,9334,16270
ACEH,ACEH BARAT,SUNGAI MAS,1218,845,2063
ACEH,ACEH TENGAH,BINTANG,1225,4038,5263
ACEH,ACEH BESAR,KUTA MALAKA,2158,1042,3200
ACEH,ACEH BARAT,JOHAN PAHWALAN,13649,10052,23701
ACEH,ACEH BARAT,ARONGAN LAMBALEK,2261,3316,5577
ACEH,ACEH BARAT,BUBON,1732,1800,3532
ACEH,ACEH BARAT,WOYLA TIMUR,1345,1281,2626
ACEH,ACEH BARAT,MEUREUBO,5705,5686,11391
ACEH,ACEH BESAR,DARUL KAMAL,1819,1599,3418
ACEH,ACEH BARAT,WOYLA,4000,3208,7208
ACEH,ACEH BESAR,KOTA JANTHO,1967,2018,3985
ACEH,ACEH BARAT,KAWAY XVI,5921,4506,10427
ACEH,ACEH BESAR,MONTASIK,6373,3074,9447
ACEH,ACEH BARAT,SAMATIGA,3904,4284,8188
ACEH,ACEH BESAR,KUTA BARO,6132,5241,11373
ACEH,ACEH BESAR,LEUPUNG,631,763,1394
ACEH,ACEH BESAR,LHOONG,2779,2419,5198
ACEH,ACEH BESAR,INDRAPURI,6377,3906,10283
ACEH,ACEH BARAT,PANTON REU,1930,1100,3030
ACEH,ACEH BESAR,SIMPANG TIGA,1857,1176,3033
ACEH,ACEH BESAR,KOTA COT GLIE,3272,3379,6651
ACEH,ACEH BESAR,LHOKNGA,4580,3111,7691
ACEH,ACEH BESAR,SUKAMAKMUR,4189,3170,7359
ACEH,ACEH BESAR,PULO ACEH,1127,1301,2428
ACEH,PIDIE,TANGSE,5198,6186,11384
ACEH,ACEH BESAR,BLANG BINTANG,3053,2148,5201
ACEH,ACEH BESAR,SEULIMEUM,4693,5158,9851
ACEH,ACEH BESAR,BAITUSSALAM,3779,3160,6939
ACEH,ACEH BESAR,PEUKAN BADA,3778,3662,7440
ACEH,PIDIE,GLUMPANG BARO,1565,2941,4506
ACEH,PIDIE,MANE,976,1397,2373
ACEH,PIDIE,PEUKAN BARO,0,0,0
ACEH,PIDIE,KEUMALA,1032,2969,4001
ACEH,ACEH BESAR,DARUSSALAM,5537,3722,9259
ACEH,PIDIE,BATEE,0,0,0
ACEH,PIDIE,PADANG TIJI,4002,5167,9169
ACEH,ACEH BESAR,INGIN JAYA,8026,6351,14377
ACEH,ACEH BESAR,MESJID RAYA,3001,3257,6258
ACEH,PIDIE,DELIMA,0,0,0
ACEH,PIDIE,GEULUMPANG TIGA,0,0,0
ACEH,PIDIE,TITEUE,1110,1353,2463
ACEH,ACEH BESAR,DARUL IMARAH,11484,7981,19465
ACEH,PIDIE,SIMPANG TIGA,4660,5611,10271
ACEH,PIDIE,SAKTI,0,0,0
ACEH,PIDIE,MUARA TIGA,4865,1867,6732
ACEH,PIDIE,KOTA SIGLI,3518,3742,7260
ACEH,PIDIE,PIDIE,0,0,0
ACEH,ACEH UTARA,COT GIREK,6352,2450,8802
ACEH,PIDIE,MILA,1760,1958,3718
ACEH,PIDIE,MUTIARA TIMUR,4938,8418,13356
ACEH,PIDIE,MUTIARA,3270,4973,8243
ACEH,ACEH UTARA,BAKTIYA,7176,6433,13609
ACEH,PIDIE,KEMBANG TANJONG,3411,5241,8652
ACEH,ACEH UTARA,PAYA BAKONG,2984,2449,5433
ACEH,ACEH UTARA,BANDA BARO,1705,695,2400
ACEH,PIDIE,GEUMPANG,785,1158,1943
ACEH,ACEH UTARA,GEUREDONG PASE,1563,533,2096
ACEH,PIDIE,INDRA JAYA,3618,5734,9352
ACEH,ACEH UTARA,KUTA MAKMUR,6314,3703,10017
ACEH,ACEH UTARA,TANAH PASIR,1867,1427,3294
ACEH,ACEH UTARA,NIBONG,2514,1675,4189
ACEH,ACEH UTARA,MEURAH MULIA,3965,3782,7747
ACEH,ACEH UTARA,SAMUDERA,6294,3771,10065
ACEH,ACEH UTARA,PIRAK TIMUR,1775,1507,3282
ACEH,ACEH UTARA,NISAM,4535,1928,6463
ACEH,ACEH UTARA,LAPANG,1181,1280,2461
ACEH,ACEH UTARA,LANGKAHAN,4194,3819,8013
ACEH,ACEH UTARA,BAKTIYA BARAT,2948,3224,6172
ACEH,ACEH UTARA,LHOKSUKON,9549,7667,17216
ACEH,ACEH UTARA,MATANGKULI,3872,3445,7317
ACEH,ACEH UTARA,SIMPANG KRAMAT,2801,1284,4085
ACEH,ACEH UTARA,MUARA BATU,5837,2986,8823
ACEH,ACEH UTARA,SYAMTALIRA ARON,4374,3121,7495
ACEH,SIMEULUE,TEUPAH TENGAH,0,0,0
ACEH,SIMEULUE,SIMEULUE TIMUR,0,0,0
ACEH,SIMEULUE,ALAPAN,0,0,0
ACEH,ACEH UTARA,SAWANG,7866,3931,11797
ACEH,ACEH UTARA,DEWANTARA,8254,4449,12703
ACEH,SIMEULUE,SIMEULUE TENGAH,0,0,0
ACEH,SIMEULUE,SIMEULUE CUT,0,0,0
ACEH,ACEH UTARA,NISAM ANTARA,1611,937,2548
ACEH,ACEH UTARA,SEUNUDDON,6338,2800,9138
ACEH,SIMEULUE,TEUPAH SELATAN,0,0,0
ACEH,ACEH UTARA,SYAMTALIRA BAYU,4800,2801,7601
ACEH,ACEH SINGKIL,SINGKIL,4907,2480,7387
ACEH,ACEH UTARA,TANAH LUAS,6213,4120,10333
ACEH,ACEH SINGKIL,DANAU PARIS,1054,1273,2327
ACEH,ACEH SINGKIL,PULAU BANYAK,838,574,1412
ACEH,SIMEULUE,SIMEULUE BARAT,0,0,0
ACEH,SIMEULUE,SALANG,0,0,0
ACEH,SIMEULUE,TELUK DALAM,0,0,0
ACEH,ACEH SINGKIL,SINGKIL UTARA,2008,1810,3818
ACEH,ACEH SINGKIL,KOTA BAHARU,1627,1031,2658
ACEH,ACEH SINGKIL,SIMPANG KANAN,3821,2613,6434
ACEH,ACEH SINGKIL,PULAU BANYAK BARAT,370,654,1024
ACEH,BIREUEN,KOTA JUANG,10759,5952,16711
ACEH,ACEH SINGKIL,SINGKOHOR,1795,1135,2930
ACEH,SIMEULUE,TEUPAH BARAT,0,0,0
ACEH,ACEH SINGKIL,KUALA BARU,569,413,982
ACEH,BIREUEN,PEUSANGAN SIBLAH KRUENG,2839,1838,4677
ACEH,BIREUEN,KUALA,4215,2235,6450
ACEH,BIREUEN,PEULIMBANG,2180,2342,4522
ACEH,BIREUEN,SIMPANG MAMPLAM,4639,4356,8995
ACEH,BIREUEN,PEUSANGAN,11179,7392,18571
ACEH,ACEH SINGKIL,GUNUNG MERIAH,9059,5549,14608
ACEH,BIREUEN,SAMALANGA,6185,3652,9837
ACEH,ACEH SINGKIL,SURO MAKMUR,1233,1698,2931
ACEH,BIREUEN,JEUMPA,7113,4486,11599
ACEH,BIREUEN,JANGKA,5432,4381,9813
ACEH,BIREUEN,PANDRAH,2018,1335,3353
ACEH,BIREUEN,PEUSANGAN SELATAN,3085,2060,5145
ACEH,BIREUEN,PEUDADA,5264,5031,10295
ACEH,BIREUEN,JULI,7180,4581,11761
ACEH,BIREUEN,MAKMUR,3523,2013,5536
ACEH,ACEH BARAT DAYA,LEMBAH SABIL,0,0,0
ACEH,ACEH BARAT DAYA,JEUMPA,2860,1536,4396
ACEH,ACEH BARAT DAYA,BABAH ROT,2284,3615,5899
ACEH,BIREUEN,GANDAPURA,6515,2592,9107
ACEH,ACEH BARAT DAYA,KUALA BATEE,3972,3536,7508
ACEH,ACEH BARAT DAYA,MANGGENG,3479,2648,6127
ACEH,BIREUEN,JEUNIEB,7878,3096,10974
ACEH,GAYO LUES,PANTAN CUACA,714,1561,2275
ACEH,BIREUEN,KUTA BLANG,5773,2745,8518
ACEH,ACEH BARAT DAYA,SETIA,1239,1627,2866
ACEH,ACEH BARAT DAYA,BLANG PIDIE,4780,3709,8489
ACEH,GAYO LUES,DABUN GELANG,1233,1499,2732
ACEH,GAYO LUES,RIKIT GAIB,0,0,0
ACEH,ACEH BARAT DAYA,SUSOH,4895,5305,10200
ACEH,ACEH JAYA,INDRA JAYA,2307,1233,3540
ACEH,GAYO LUES,TERANGUN,2187,2268,4455
ACEH,ACEH JAYA,PANGA,1458,1992,3450
ACEH,GAYO LUES,TERIPE JAYA,0,0,0
ACEH,ACEH JAYA,JAYA,5321,2147,7468
ACEH,ACEH JAYA,SAMPOINIET,1453,1618,3071
ACEH,GAYO LUES,BLANGJERANGO,1201,2483,3684
ACEH,ACEH JAYA,SETIA BAKTI,1729,1593,3322
ACEH,NAGAN RAYA,DARUL MAKMUR,10555,9416,19971
ACEH,GAYO LUES,PINING,680,1444,2124
ACEH,GAYO LUES,KUTAPANJANG,1536,2498,4034
ACEH,GAYO LUES,BLANGPEGAYON,1155,1465,2620
ACEH,NAGAN RAYA,TRIPA MAKMUR,1932,1612,3544
ACEH,NAGAN RAYA,SEUNAGAN,3480,4764,8244
ACEH,GAYO LUES,PUTERI BETUNG,1259,2673,3932
ACEH,ACEH TAMIANG,MANYAK PAYED,7261,4187,11448
ACEH,ACEH TAMIANG,BANDA MULIA,3180,1373,4553
ACEH,NAGAN RAYA,BEUTONG ATEUH BANGGALANG,308,553,861
ACEH,GAYO LUES,BLANGKEJEREN,0,0,0
ACEH,NAGAN RAYA,TADU RAYA,3129,3235,6364
ACEH,ACEH JAYA,TEUNOM,3345,3199,6544
ACEH,ACEH JAYA,PASIE RAYA,0,0,0
ACEH,ACEH JAYA,KRUENG SABEE,0,0,0
ACEH,ACEH TAMIANG,TENGGULUN,3867,2994,6861
ACEH,NAGAN RAYA,SUKA MAKMUE,2077,2852,4929
ACEH,NAGAN RAYA,KUALA,4447,4269,8716
ACEH,ACEH TAMIANG,KARANG BARU,12432,5320,17752
ACEH,ACEH JAYA,DARUL HIKMAH,1779,1271,3050
ACEH,NAGAN RAYA,BEUTONG,2308,4007,6315
ACEH,ACEH TAMIANG,KEJURUAN MUDA,9005,5757,14762
ACEH,BENER MERIAH,PERMATA,0,0,0
ACEH,NAGAN RAYA,SEUNAGAN TIMUR,3125,4321,7446
ACEH,NAGAN RAYA,KUALA PESISIR,4204,3819,8023
ACEH,ACEH TAMIANG,KOTA KUALASIMPANG,4391,2982,7373
ACEH,ACEH TAMIANG,BENDAHARA,5617,2931,8548
ACEH,BENER MERIAH,GAJAH PUTIH,0,0,0
ACEH,ACEH TAMIANG,BANDAR PUSAKA,3303,2136,5439
ACEH,ACEH TAMIANG,TAMIANG HULU,5532,2790,8322
ACEH,ACEH TAMIANG,RANTAU,10874,4766,15640
ACEH,BENER MERIAH,BENER KELIPAH,759,1531,2290
ACEH,BENER MERIAH,BANDAR,0,0,0
ACEH,PIDIE JAYA,MEURAH DUA,2344,2740,5084
ACEH,PIDIE JAYA,BANDAR BARU,6010,6710,12720
ACEH,ACEH TAMIANG,SEKERAK,1990,1106,3096
ACEH,ACEH TAMIANG,SERUWAY,6817,4801,11618
ACEH,BENER MERIAH,BUKIT,0,0,0
ACEH,BENER MERIAH,TIMANG GAJAH,0,0,0
ACEH,PIDIE JAYA,JANGKA BUYA,1195,2071,3266
ACEH,BENER MERIAH,SYIAH UTAMA,300,653,953
ACEH,BENER MERIAH,MESIDAH,635,1445,2080
ACEH,PIDIE JAYA,ULIM,1917,3794,5711
ACEH,BENER MERIAH,PINTU RIME GAYO,1965,3742,5707
ACEH,KOTA BANDA ACEH,KUTA ALAM,8282,6568,14850
ACEH,KOTA BANDA ACEH,JAYA BARU,4594,3471,8065
ACEH,KOTA BANDA ACEH,BAITURRAHMAN,6679,5261,11940
ACEH,BENER MERIAH,WIH PESAM,5304,5670,10974
ACEH,PIDIE JAYA,MEUREUDU,3636,4771,8407
ACEH,KOTA BANDA ACEH,BANDA RAYA,5642,3709,9351
ACEH,KOTA SABANG,SUKAJAYA,3746,2619,6365
ACEH,PIDIE JAYA,PANTERAJA,1521,1300,2821
ACEH,KOTA LHOKSEUMAWE,MUARA SATU,5999,3257,9256
ACEH,PIDIE JAYA,BANDAR DUA,3590,4847,8437
ACEH,KOTA BANDA ACEH,KUTA RAJA,1716,1702,3418
ACEH,KOTA LHOKSEUMAWE,BLANG MANGAT,4426,3013,7439
ACEH,KOTA BANDA ACEH,LUENG BATA,4387,3644,8031
ACEH,PIDIE JAYA,TRIENGGADENG,3869,4105,7974
ACEH,KOTA LANGSA,LANGSA BARO,14232,5092,19324
ACEH,KOTA SUBULUSSALAM,SIMPANG KIRI,7966,4310,12276
ACEH,KOTA BANDA ACEH,MEURAXA,3215,3080,6295
SUMATERA UTARA,TAPANULI TENGAH,ANDAM DEWI,1407,4863,6270
ACEH,KOTA BANDA ACEH,ULEE KARENG,5028,3950,8978
ACEH,KOTA SABANG,SUKAKARYA,3555,2918,6473
ACEH,KOTA SUBULUSSALAM,LONGKIB,1494,1039,2533
ACEH,KOTA BANDA ACEH,SYIAH KUALA,6280,4618,10898
ACEH,KOTA LHOKSEUMAWE,MUARA DUA,9299,4709,14008
ACEH,KOTA LANGSA,LANGSA BARAT,6976,3235,10211
SUMATERA UTARA,TAPANULI TENGAH,PASARIBU TOBING,0,0,0
ACEH,KOTA LHOKSEUMAWE,BANDA SAKTI,14892,8317,23209
ACEH,KOTA SUBULUSSALAM,PENANGGALAN,3299,2038,5337
SUMATERA UTARA,TAPANULI TENGAH,BARUS UTARA,240,2040,2280
SUMATERA UTARA,TAPANULI TENGAH,SIRANDORUNG,1010,4761,5771
ACEH,KOTA SUBULUSSALAM,SULTAN DAULAT,3649,2204,5853
ACEH,KOTA LANGSA,LANGSA KOTA,8533,4667,13200
ACEH,KOTA LANGSA,LANGSA TIMUR,3639,1838,5477
ACEH,KOTA SUBULUSSALAM,RUNDENG,3764,1685,5449
ACEH,KOTA LANGSA,LANGSA LAMA,9313,3508,12821
SUMATERA UTARA,TAPANULI TENGAH,SORKAM,0,0,0
SUMATERA UTARA,TAPANULI TENGAH,PINANGSORI,2315,6550,8865
SUMATERA UTARA,TAPANULI TENGAH,BARUS,3972,2833,6805
SUMATERA UTARA,TAPANULI TENGAH,MANDUAMAS,1828,5877,7705
SUMATERA UTARA,TAPANULI TENGAH,SORKAM BARAT,2183,4574,6757
SUMATERA UTARA,TAPANULI TENGAH,SITAHUIS,0,0,0
SUMATERA UTARA,TAPANULI TENGAH,TUKKA,1587,3496,5083
SUMATERA UTARA,TAPANULI TENGAH,LUMUT,992,3857,4849
SUMATERA UTARA,TAPANULI TENGAH,PANDAN,0,0,0
SUMATERA UTARA,TAPANULI UTARA,PARMONANGAN,303,6447,6750
SUMATERA UTARA,TAPANULI UTARA,SIPAHUTAR,706,10962,11668
SUMATERA UTARA,TAPANULI UTARA,SIMANGUMBAN,677,2716,3393
SUMATERA UTARA,TAPANULI TENGAH,BADIRI,2631,6471,9102
SUMATERA UTARA,TAPANULI TENGAH,SUKA BANGUN,340,1114,1454
SUMATERA UTARA,TAPANULI UTARA,PURBA TUA,482,2920,3402
SUMATERA UTARA,TAPANULI TENGAH,SARUDIK,0,0,0
SUMATERA UTARA,TAPANULI TENGAH,KOLANG,1291,6367,7658
SUMATERA UTARA,TAPANULI UTARA,PANGARIBUAN,929,11370,12299
SUMATERA UTARA,TAPANULI UTARA,PAHAE JAE,821,4304,5125
SUMATERA UTARA,TAPANULI TENGAH,TAPIAN NAULI,2000,6211,8211
SUMATERA UTARA,TAPANULI UTARA,MUARA,229,6506,6735
SUMATERA UTARA,TAPANULI TENGAH,SOSOR GADONG,0,0,0
SUMATERA UTARA,TAPANULI SELATAN,SAYUR MATINGGI,7994,3401,11395
SUMATERA UTARA,TAPANULI UTARA,ADIAN KOTING,518,5878,6396
SUMATERA UTARA,TAPANULI UTARA,SIATAS BARITA,664,5661,6325
SUMATERA UTARA,TAPANULI TENGAH,SIBABANGUN,2050,5479,7529
SUMATERA UTARA,TAPANULI SELATAN,BATANG ANGKOLA,11997,3672,15669
SUMATERA UTARA,TAPANULI UTARA,TARUTUNG,2140,16837,18977
SUMATERA UTARA,TAPANULI UTARA,GAROGA,914,6395,7309
SUMATERA UTARA,TAPANULI SELATAN,MARANCAR,3491,1451,4942
SUMATERA UTARA,TAPANULI SELATAN,ANGKOLA TIMUR,8052,1963,10015
SUMATERA UTARA,TAPANULI SELATAN,TANO TOMBANGAN ANGKOLA,1431,6247,7678
SUMATERA UTARA,TAPANULI UTARA,PAGARAN,308,7648,7956
SUMATERA UTARA,TAPANULI UTARA,PAHAE JULU,586,5306,5892
SUMATERA UTARA,TAPANULI SELATAN,ARSE,2975,1570,4545
SUMATERA UTARA,TAPANULI SELATAN,ANGKOLA SANGKUNUR,3871,5876,9747
SUMATERA UTARA,TAPANULI SELATAN,ANGKOLA BARAT,8823,2362,11185
SUMATERA UTARA,NIAS,HILISERANGKAI,427,5891,6318
SUMATERA UTARA,TAPANULI UTARA,SIPOHOLON,936,9178,10114
SUMATERA UTARA,TAPANULI SELATAN,BATANG TORU,7160,7530,14690
SUMATERA UTARA,TAPANULI SELATAN,SAIPAR DOLOK HOLE,4687,2178,6865
SUMATERA UTARA,TAPANULI SELATAN,ANGKOLA SELATAN,5712,6129,11841
SUMATERA UTARA,TAPANULI SELATAN,AEK BILAH,2908,975,3883
SUMATERA UTARA,TAPANULI SELATAN,MUARA BATANG TORU,2141,2946,5087
SUMATERA UTARA,NIAS,ULUGAWO,486,4785,5271
SUMATERA UTARA,LANGKAT,BAHOROK,0,0,0
SUMATERA UTARA,LANGKAT,BESITANG,0,0,0
SUMATERA UTARA,TAPANULI SELATAN,SIPIROK,11369,4333,15702
SUMATERA UTARA,LANGKAT,SEI LEPAN,9688,12619,22307
SUMATERA UTARA,LANGKAT,PANGKALAN SUSU,0,0,0
SUMATERA UTARA,LANGKAT,SAWIT SEBERANG,5258,7260,12518
SUMATERA UTARA,LANGKAT,PADANG TUALANG,11242,12489,23731
SUMATERA UTARA,LANGKAT,BABALAN,12053,12274,24327
SUMATERA UTARA,NIAS,BOTOMUZOI,387,3819,4206
SUMATERA UTARA,NIAS,HILIDUHO,222,4117,4339
SUMATERA UTARA,NIAS,IDANO GAWO,2099,9244,11343
SUMATERA UTARA,LANGKAT,SALAPIAN,5536,8311,13847
SUMATERA UTARA,NIAS,GIDO,517,8501,9018
SUMATERA UTARA,LANGKAT,KUALA,11025,9508,20533
SUMATERA UTARA,LANGKAT,TANJUNG PURA,0,0,0
SUMATERA UTARA,LANGKAT,SEI BINGEI,8473,14775,23248
SUMATERA UTARA,NIAS,BAWOLATO,1524,7707,9231
SUMATERA UTARA,LANGKAT,BRANDAN BARAT,0,0,0
SUMATERA UTARA,LANGKAT,KUTAMBARU,2173,4877,7050
SUMATERA UTARA,LANGKAT,SELESAI,0,0,0
SUMATERA UTARA,LANGKAT,BATANG SERANGAN,0,0,0
SUMATERA UTARA,LANGKAT,SIRAPIT,4312,4443,8755
SUMATERA UTARA,LANGKAT,HINAI,0,0,0
SUMATERA UTARA,LANGKAT,GEBANG,10299,9860,20159
SUMATERA UTARA,LANGKAT,SECANGGANG,17900,14641,32541
SUMATERA UTARA,KARO,DOLAT RAYAT,483,3606,4089
SUMATERA UTARA,KARO,KUTABULUH,1330,5130,6460
SUMATERA UTARA,KARO,KABANJAHE,5367,21660,27027
SUMATERA UTARA,KARO,MERDEKA,1105,5109,6214
SUMATERA UTARA,KARO,TIGABINANGA,1594,8804,10398
SUMATERA UTARA,LANGKAT,BINJAI,13548,8475,22023
SUMATERA UTARA,LANGKAT,STABAT,0,0,0
SUMATERA UTARA,LANGKAT,WAMPU,11793,9067,20860
SUMATERA UTARA,KARO,TIGAPANAH,1593,13036,14629
SUMATERA UTARA,KARO,BERASTAGI,4211,14167,18378
SUMATERA UTARA,LANGKAT,PEMATANG JAYA,0,0,0
SUMATERA UTARA,DELI SERDANG,GUNUNG MERIAH,0,0,0
SUMATERA UTARA,KARO,MEREK,854,8271,9125
SUMATERA UTARA,KARO,SIMPANG EMPAT,1356,8141,9497
SUMATERA UTARA,KARO,NAMAN TERAN,986,4123,5109
SUMATERA UTARA,KARO,PAYUNG,667,4816,5483
SUMATERA UTARA,KARO,LAUBALENG,929,7498,8427
SUMATERA UTARA,KARO,MARDINGDING,735,7003,7738
SUMATERA UTARA,DELI SERDANG,PATUMBAK,0,0,0
SUMATERA UTARA,KARO,JUHAR,651,6993,7644
SUMATERA UTARA,KARO,BARUSJAHE,1115,10680,11795
SUMATERA UTARA,DELI SERDANG,SUNGGAL,0,0,0
SUMATERA UTARA,DELI SERDANG,TANJUNG MORAWA,0,0,0
SUMATERA UTARA,DELI SERDANG,HAMPARAN PERAK,44699,23338,68037
SUMATERA UTARA,DELI SERDANG,BATANG KUIS,16245,8625,24870
SUMATERA UTARA,DELI SERDANG,KUTALIMBARU,0,0,0
SUMATERA UTARA,DELI SERDANG,LUBUK PAKAM,0,0,0
SUMATERA UTARA,KARO,MUNTE,1389,8829,10218
SUMATERA UTARA,DELI SERDANG,PANCUR BATU,14120,24919,39039
SUMATERA UTARA,DELI SERDANG,GALANG,0,0,0
SUMATERA UTARA,DELI SERDANG,STM HULU,1225,5003,6228
SUMATERA UTARA,KARO,TIGANDERKET,1097,5880,6977
SUMATERA UTARA,SIMALUNGUN,DOLOK PARDAMEAN,515,7822,8337
SUMATERA UTARA,DELI SERDANG,SIBOLANGIT,0,0,0
SUMATERA UTARA,DELI SERDANG,DELI TUA,0,0,0
SUMATERA UTARA,DELI SERDANG,BERINGIN,12254,13808,26062
SUMATERA UTARA,DELI SERDANG,LABUHAN DELI,0,0,0
SUMATERA UTARA,DELI SERDANG,PERCUT SEI TUAN,91428,62678,154106
SUMATERA UTARA,DELI SERDANG,PAGAR MERBAU,10146,7753,17899
SUMATERA UTARA,SIMALUNGUN,SILIMAKUTA,626,5254,5880
SUMATERA UTARA,DELI SERDANG,PANTAI LABU,10445,8143,18588
SUMATERA UTARA,SIMALUNGUN,TAPIAN DOLOK,9783,10642,20425
SUMATERA UTARA,SIMALUNGUN,SILOU KAHEAN,2095,6009,8104
SUMATERA UTARA,SIMALUNGUN,SIANTAR,12917,19726,32643
SUMATERA UTARA,SIMALUNGUN,HARANGGAOL HORISON,222,2690,2912
SUMATERA UTARA,SIMALUNGUN,UJUNG PADANG,8424,11708,20132
SUMATERA UTARA,SIMALUNGUN,HUTA BAYU RAJA,3696,10975,14671
SUMATERA UTARA,DELI SERDANG,BANGUN PURBA,4991,6222,11213
SUMATERA UTARA,DELI SERDANG,STM HILIR,4465,10386,14851
SUMATERA UTARA,SIMALUNGUN,DOLOK BATU NANGGAR,11047,10255,21302
SUMATERA UTARA,SIMALUNGUN,DOLOK SILAU,850,6301,7151
SUMATERA UTARA,SIMALUNGUN,GUNUNG MALELA,8780,9304,18084
SUMATERA UTARA,SIMALUNGUN,BANDAR MASILAM,6559,5814,12373
SUMATERA UTARA,SIMALUNGUN,PEMATANG BANDAR,6474,9134,15608
SUMATERA UTARA,SIMALUNGUN,SIDAMANIK,3902,10164,14066
SUMATERA UTARA,DELI SERDANG,NAMORAMBE,0,0,0
SUMATERA UTARA,SIMALUNGUN,PEMATANG SIDAMANIK,1896,6648,8544
SUMATERA UTARA,SIMALUNGUN,JAWA MARAJA BAH JAMBI,4883,5400,10283
SUMATERA UTARA,SIMALUNGUN,HATONDUHAN,2079,8167,10246
SUMATERA UTARA,SIMALUNGUN,RAYA,2199,13824,16023
SUMATERA UTARA,SIMALUNGUN,BANDAR HULUAN,6467,6922,13389
SUMATERA UTARA,SIMALUNGUN,BANDAR,13056,16782,29838
SUMATERA UTARA,SIMALUNGUN,JORLANG HATARAN,1949,6265,8214
SUMATERA UTARA,SIMALUNGUN,PANEI,2220,9457,11677
SUMATERA UTARA,SIMALUNGUN,PANOMBEIAN PANE,3068,7582,10650
SUMATERA UTARA,SIMALUNGUN,GIRSANG SIPANGAN BOLON,860,7009,7869
SUMATERA UTARA,ASAHAN,RAHUNING,4415,4765,9180
SUMATERA UTARA,ASAHAN,SEI KEPAYANG TIMUR,2391,1179,3570
SUMATERA UTARA,SIMALUNGUN,PURBA,1039,9521,10560
SUMATERA UTARA,ASAHAN,SETIA JANJI,2826,3921,6747
SUMATERA UTARA,SIMALUNGUN,RAYA KAHEAN,2269,6713,8982
SUMATERA UTARA,ASAHAN,MERANTI,3218,6662,9880
SUMATERA UTARA,SIMALUNGUN,PAMATANG SILIMA HUTA,323,5053,5376
SUMATERA UTARA,SIMALUNGUN,BOSAR MALIGAS,8701,11264,19965
SUMATERA UTARA,SIMALUNGUN,TANAH JAWA,8933,16027,24960
SUMATERA UTARA,SIMALUNGUN,GUNUNG MALIGAS,7665,5511,13176
SUMATERA UTARA,ASAHAN,KOTA KISARAN TIMUR,20541,14396,34937
SUMATERA UTARA,ASAHAN,TANJUNG BALAI,7629,5422,13051
SUMATERA UTARA,SIMALUNGUN,DOLOK PANRIBUAN,865,8446,9311
SUMATERA UTARA,ASAHAN,SEI KEPAYANG BARAT,2862,2225,5087
SUMATERA UTARA,ASAHAN,KOTA KISARAN BARAT,16480,12068,28548
SUMATERA UTARA,ASAHAN,SEI DADAP,7438,7839,15277
SUMATERA UTARA,ASAHAN,RAWANG PANCA ARGA,4490,4739,9229
SUMATERA UTARA,ASAHAN,SILAU LAUT,4445,5187,9632
SUMATERA UTARA,ASAHAN,AEK SONGSONGAN,3259,5662,8921
SUMATERA UTARA,ASAHAN,BUNTU PANE,4976,7425,12401
SUMATERA UTARA,ASAHAN,PULAU RAKYAT,6746,9180,15926
SUMATERA UTARA,ASAHAN,BANDAR PULAU,4477,6895,11372
SUMATERA UTARA,ASAHAN,TINGGI RAJA,4582,5487,10069
SUMATERA UTARA,ASAHAN,PULO BANDRING,7239,8182,15421
SUMATERA UTARA,LABUHANBATU,BILAH BARAT,10276,6125,16401
SUMATERA UTARA,LABUHANBATU,RANTAU SELATAN,19295,9890,29185
SUMATERA UTARA,ASAHAN,AEK LEDONG,3824,6019,9843
SUMATERA UTARA,ASAHAN,SIMPANG EMPAT,7103,10817,17920
SUMATERA UTARA,ASAHAN,AIR BATU,9790,9766,19556
SUMATERA UTARA,ASAHAN,TELUK DALAM,4211,4397,8608
SUMATERA UTARA,ASAHAN,AEK KUASAN,4761,7872,12633
SUMATERA UTARA,ASAHAN,AIR JOMAN,9421,11402,20823
SUMATERA UTARA,ASAHAN,SEI KEPAYANG,2956,4231,7187
SUMATERA UTARA,LABUHANBATU,BILAH HILIR,10740,13104,23844
SUMATERA UTARA,ASAHAN,BANDAR PASIR MANDOGE,4857,11593,16450
SUMATERA UTARA,LABUHANBATU,PANAI HULU,7452,7769,15221
SUMATERA UTARA,LABUHANBATU,RANTAU UTARA,24400,16271,40671
SUMATERA UTARA,DAIRI,BRAMPU,1314,2208,3522
SUMATERA UTARA,DAIRI,SIEMPAT NEMPU,1109,7533,8642
SUMATERA UTARA,DAIRI,SILIMA PUNGGA PUNGA,1240,5235,6475
SUMATERA UTARA,LABUHANBATU,PANGKATAN,7165,9523,16688
SUMATERA UTARA,DAIRI,SUMBUL,1797,16966,18763
SUMATERA UTARA,LABUHANBATU,BILAH HULU,15414,13143,28557
SUMATERA UTARA,DAIRI,SIEMPAT NEMPU HULU,2251,6313,8564
SUMATERA UTARA,DAIRI,GUNUNG SITEMBER,804,3933,4737
SUMATERA UTARA,DAIRI,TANAH PINEM,1809,9164,10973
SUMATERA UTARA,LABUHANBATU,PANAI HILIR,6461,7671,14132
SUMATERA UTARA,DAIRI,PEGAGAN HILIR,905,6282,7187
SUMATERA UTARA,DAIRI,SIDIKALANG,5185,17072,22257
SUMATERA UTARA,LABUHANBATU,PANAI TENGAH,5368,8405,13773
SUMATERA UTARA,DAIRI,SIEMPAT NEMPU HILIR,730,4521,5251
SUMATERA UTARA,DAIRI,TIGALINGGA,1728,9860,11588
SUMATERA UTARA,DAIRI,LAE PARIRA,1210,5601,6811
SUMATERA UTARA,TOBA SAMOSIR,BALIGE,1692,16619,18311
SUMATERA UTARA,TOBA SAMOSIR,BONATUA LUNASI,279,2402,2681
SUMATERA UTARA,DAIRI,PARBULUAN,805,8640,9445
SUMATERA UTARA,DAIRI,SILAHISABUNGAN,200,2090,2290
SUMATERA UTARA,TOBA SAMOSIR,BORBOR,208,3139,3347
SUMATERA UTARA,TOBA SAMOSIR,PINTU POHAN MERANTI,574,2485,3059
SUMATERA UTARA,TOBA SAMOSIR,TAMPAHAN,134,1971,2105
SUMATERA UTARA,TOBA SAMOSIR,HABINSARAN,636,6951,7587
SUMATERA UTARA,DAIRI,SITINJO,1038,4314,5352
SUMATERA UTARA,TOBA SAMOSIR,ULUAN,297,3850,4147
SUMATERA UTARA,TOBA SAMOSIR,PORSEA,758,5734,6492
SUMATERA UTARA,TOBA SAMOSIR,SIANTAR NARUMONDA,300,2563,2863
SUMATERA UTARA,MANDAILING NATAL,LINGGA BAYU,6986,4178,11164
SUMATERA UTARA,MANDAILING NATAL,PANYABUNGAN KOTA,29000,5814,34814
SUMATERA UTARA,TOBA SAMOSIR,LAGUBOTI,781,9000,9781
SUMATERA UTARA,TOBA SAMOSIR,PARMAKSIAN,762,4203,4965
SUMATERA UTARA,MANDAILING NATAL,BATAHAN,7227,2751,9978
SUMATERA UTARA,TOBA SAMOSIR,LUMBAN JULU,242,3990,4232
SUMATERA UTARA,MANDAILING NATAL,NATAL,8616,5370,13986
SUMATERA UTARA,TOBA SAMOSIR,AJIBATA,191,3686,3877
SUMATERA UTARA,MANDAILING NATAL,HUTA BARGOT,3140,626,3766
SUMATERA UTARA,TOBA SAMOSIR,SILAEN,414,6305,6719
SUMATERA UTARA,TOBA SAMOSIR,NASSAU,617,3259,3876
SUMATERA UTARA,TOBA SAMOSIR,SIGUMPAR,269,3368,3637
SUMATERA UTARA,MANDAILING NATAL,PUNCAK SORIK MARAPI,3985,299,4284
SUMATERA UTARA,MANDAILING NATAL,PANYABUNGAN SELATAN,4475,656,5131
SUMATERA UTARA,MANDAILING NATAL,PANYABUNGAN TIMUR,5181,805,5986
SUMATERA UTARA,MANDAILING NATAL,RANTO BAEK,4376,1664,6040
SUMATERA UTARA,MANDAILING NATAL,NAGA JUANG,845,1062,1907
SUMATERA UTARA,MANDAILING NATAL,BUKIT MALINTANG,3906,1343,5249
SUMATERA UTARA,NIAS SELATAN,FANAYAMA,0,0,0
SUMATERA UTARA,MANDAILING NATAL,MUARA SIPONGI,3410,1666,5076
SUMATERA UTARA,MANDAILING NATAL,TAMBANGAN,5476,837,6313
SUMATERA UTARA,MANDAILING NATAL,PAKANTAN,725,370,1095
SUMATERA UTARA,MANDAILING NATAL,BATANG NATAL,9102,2683,11785
SUMATERA UTARA,MANDAILING NATAL,PANYABUNGAN BARAT,4153,683,4836
SUMATERA UTARA,MANDAILING NATAL,LEMBAH SORIK MARAPI,4566,637,5203
SUMATERA UTARA,MANDAILING NATAL,MUARA BATANG GADIS,4479,2393,6872
SUMATERA UTARA,MANDAILING NATAL,SINUNUKAN,4297,4290,8587
SUMATERA UTARA,NIAS SELATAN,ONOHAZUMBA,0,0,0
SUMATERA UTARA,MANDAILING NATAL,ULU PUNGKUT,2232,182,2414
SUMATERA UTARA,NIAS SELATAN,ULUSUSUA,1720,5107,6827
SUMATERA UTARA,MANDAILING NATAL,PANYABUNGAN UTARA,6169,2550,8719
SUMATERA UTARA,MANDAILING NATAL,KOTANOPAN,10802,1950,12752
SUMATERA UTARA,NIAS SELATAN,ULUNOYO,0,0,0
SUMATERA UTARA,NIAS SELATAN,MAZO,851,6331,7182
SUMATERA UTARA,NIAS SELATAN,LOLOMATUA,0,0,0
SUMATERA UTARA,NIAS SELATAN,SIMUK,0,0,0
SUMATERA UTARA,MANDAILING NATAL,SIABU,16900,4237,21137
SUMATERA UTARA,NIAS SELATAN,TELUK DALAM,1587,16952,18539
SUMATERA UTARA,NIAS SELATAN,HURUNA,0,0,0
SUMATERA UTARA,NIAS SELATAN,GOMO,0,0,0
SUMATERA UTARA,NIAS SELATAN,BORONADU,0,0,0
SUMATERA UTARA,NIAS SELATAN,SOMAMBAWA,529,4392,4921
SUMATERA UTARA,PAKPAK BHARAT,SALAK,855,2621,3476
SUMATERA UTARA,PAKPAK BHARAT,SITELU TALI URANG JULU,599,1122,1721
SUMATERA UTARA,PAKPAK BHARAT,SITELU TALI URANG JEHE,2143,1729,3872
SUMATERA UTARA,NIAS SELATAN,MAZINO,1391,5820,7211
SUMATERA UTARA,NIAS SELATAN,ARAMO,0,0,0
SUMATERA UTARA,NIAS SELATAN,HIBALA,0,0,0
SUMATERA UTARA,NIAS SELATAN,LAHUSA,952,10935,11887
SUMATERA UTARA,NIAS SELATAN,MANIAMOLO,0,0,0
SUMATERA UTARA,NIAS SELATAN,AMANDRAYA,1376,3881,5257
SUMATERA UTARA,NIAS SELATAN,TANAH MASA,0,0,0
SUMATERA UTARA,PAKPAK BHARAT,PAGINDAR,207,346,553
SUMATERA UTARA,NIAS SELATAN,HILIMEGAI,0,0,0
SUMATERA UTARA,NIAS SELATAN,UMBUNASI,0,0,0
SUMATERA UTARA,NIAS SELATAN,SUSUA,0,0,0
SUMATERA UTARA,NIAS SELATAN,TOMA,0,0,0
SUMATERA UTARA,PAKPAK BHARAT,TINADA,421,1386,1807
SUMATERA UTARA,PAKPAK BHARAT,PERGETTENG GETTENG SENGKUT,780,971,1751
SUMATERA UTARA,HUMBANG HASUNDUTAN,PAKKAT,0,0,0
SUMATERA UTARA,SAMOSIR,SIANJUR MULA MULA,215,4468,4683
SUMATERA UTARA,PAKPAK BHARAT,KERAJAAN,1262,2414,3676
SUMATERA UTARA,HUMBANG HASUNDUTAN,PARANGINAN,0,0,0
SUMATERA UTARA,HUMBANG HASUNDUTAN,TARABINTANG,0,0,0
SUMATERA UTARA,PAKPAK BHARAT,SIEMPAT RUBE,414,1486,1900
SUMATERA UTARA,SAMOSIR,HARIAN,363,3524,3887
SUMATERA UTARA,HUMBANG HASUNDUTAN,SIJAMAPOLANG,306,2260,2566
SUMATERA UTARA,SAMOSIR,ONAN RUNGGU,261,4752,5013
SUMATERA UTARA,HUMBANG HASUNDUTAN,DOLOK SANGGUL,0,0,0
SUMATERA UTARA,HUMBANG HASUNDUTAN,BAKTIRAJA,208,3339,3547
SUMATERA UTARA,SERDANG BEDAGAI,SEI BAMBAN,7063,13952,21015
SUMATERA UTARA,SAMOSIR,NAINGGOLAN,297,5292,5589
SUMATERA UTARA,HUMBANG HASUNDUTAN,LINTONG NIHUTA,1419,13138,14557
SUMATERA UTARA,SERDANG BEDAGAI,SERBA JADI,4518,5707,10225
SUMATERA UTARA,HUMBANG HASUNDUTAN,ONAN GANJANG,496,4531,5027
SUMATERA UTARA,HUMBANG HASUNDUTAN,PARLILITAN,0,0,0
SUMATERA UTARA,SAMOSIR,RONGGUR NIHUTA,267,3605,3872
SUMATERA UTARA,HUMBANG HASUNDUTAN,POLLUNG,0,0,0
SUMATERA UTARA,SERDANG BEDAGAI,SIPISPIS,7929,8827,16756
SUMATERA UTARA,SERDANG BEDAGAI,DOLOK MASIHUL,13599,12301,25900
SUMATERA UTARA,SAMOSIR,PANGURURAN,966,13704,14670
SUMATERA UTARA,SERDANG BEDAGAI,TEBING TINGGI,12524,9286,21810
SUMATERA UTARA,SAMOSIR,SIMANINDO,479,10367,10846
SUMATERA UTARA,SERDANG BEDAGAI,KOTARIH,1591,2761,4352
SUMATERA UTARA,SERDANG BEDAGAI,SILINDA,1158,3375,4533
SUMATERA UTARA,SAMOSIR,PALIPI,358,7874,8232
SUMATERA UTARA,SERDANG BEDAGAI,TEBING SYAHBANDAR,10468,5890,16358
SUMATERA UTARA,SERDANG BEDAGAI,PANTAI CERMIN,11276,9103,20379
SUMATERA UTARA,BATU BARA,TANJUNG TIRAM,10275,13665,23940
SUMATERA UTARA,SERDANG BEDAGAI,DOLOK MERAWAN,5940,3684,9624
SUMATERA UTARA,BATU BARA,SEI SUKA,13961,12921,26882
SUMATERA UTARA,BATU BARA,TALAWI,10748,13683,24431
SUMATERA UTARA,SERDANG BEDAGAI,PEGAJAHAN,5846,8612,14458
SUMATERA UTARA,PADANG LAWAS UTARA,PADANG BOLAK JULU,3887,1054,4941
SUMATERA UTARA,SERDANG BEDAGAI,BANDAR KHALIFAH,4193,7930,12123
SUMATERA UTARA,BATU BARA,SEI BALAI,6451,7252,13703
SUMATERA UTARA,PADANG LAWAS UTARA,PADANG BOLAK,24707,6380,31087
SUMATERA UTARA,SERDANG BEDAGAI,BINTANG BAYU,3783,2781,6564
SUMATERA UTARA,BATU BARA,AIR PUTIH,11257,12959,24216
SUMATERA UTARA,SERDANG BEDAGAI,PERBAUNGAN,28203,21630,49833
SUMATERA UTARA,SERDANG BEDAGAI,TELUK MENGKUDU,9692,9765,19457
SUMATERA UTARA,PADANG LAWAS,BARUMUN SELATAN,2990,710,3700
SUMATERA UTARA,PADANG LAWAS UTARA,HALONGONAN,10677,5694,16371
SUMATERA UTARA,PADANG LAWAS UTARA,BATANG ONANG,4184,1640,5824
SUMATERA UTARA,BATU BARA,MEDANG DERAS,10611,10600,21211
SUMATERA UTARA,PADANG LAWAS,SOSOPAN,3501,1262,4763
SUMATERA UTARA,PADANG LAWAS,BATANG LUBU SUTAM,4142,1598,5740
SUMATERA UTARA,SERDANG BEDAGAI,TANJUNG BERINGIN,7955,7942,15897
SUMATERA UTARA,PADANG LAWAS,LUBUK BARUMUN,6099,1660,7759
SUMATERA UTARA,BATU BARA,LIMA PULUH,18101,22403,40504
SUMATERA UTARA,PADANG LAWAS UTARA,DOLOK SIGOMPULON,5245,2407,7652
SUMATERA UTARA,PADANG LAWAS UTARA,HULU SIHAPAS,1693,382,2075
SUMATERA UTARA,PADANG LAWAS,HURISTAK,5480,2539,8019
SUMATERA UTARA,PADANG LAWAS UTARA,DOLOK,9196,2746,11942
SUMATERA UTARA,PADANG LAWAS UTARA,PORTIBI,10348,1955,12303
SUMATERA UTARA,LABUHANBATU SELATAN,KOTAPINANG,14894,13122,28016
SUMATERA UTARA,PADANG LAWAS,ULU BARUMUN,4212,1738,5950
SUMATERA UTARA,PADANG LAWAS UTARA,SIMANGAMBAT,12475,13490,25965
SUMATERA UTARA,PADANG LAWAS,AEK NABARA BARUMUN,4731,939,5670
SUMATERA UTARA,PADANG LAWAS,BARUMUN TENGAH,7043,1296,8339
SUMATERA UTARA,PADANG LAWAS,SOSA,10863,3981,14844
SUMATERA UTARA,LABUHANBATU UTARA,MARBAU,11432,9894,21326
SUMATERA UTARA,LABUHANBATU UTARA,KUALUH HULU,11924,21298,33222
SUMATERA UTARA,PADANG LAWAS,BARUMUN,15495,4218,19713
SUMATERA UTARA,LABUHANBATU SELATAN,TORGAMBA,17524,29511,47035
SUMATERA UTARA,LABUHANBATU SELATAN,KAMPUNG RAKYAT,12712,14141,26853
SUMATERA UTARA,LABUHANBATU UTARA,KUALUH HILIR,4649,9288,13937
SUMATERA UTARA,LABUHANBATU SELATAN,SUNGAI KANAN,14780,7798,22578
SUMATERA UTARA,PADANG LAWAS,HUTA RAJA TINGGI,10019,8416,18435
SUMATERA UTARA,LABUHANBATU UTARA,AEK NATAS,7817,7835,15652
SUMATERA UTARA,PADANG LAWAS,SIHAPAS BARUMUN,2188,432,2620
SUMATERA UTARA,NIAS UTARA,LOTU,508,4498,5006
SUMATERA UTARA,LABUHANBATU SELATAN,SILANGKITANG,6988,9008,15996
SUMATERA UTARA,NIAS UTARA,LAHEWA,1884,6709,8593
SUMATERA UTARA,NIAS UTARA,TUGALA OYO,202,2890,3092
SUMATERA UTARA,NIAS UTARA,AFULU,1024,3083,4107
SUMATERA UTARA,NIAS UTARA,ALASA TALUMUZOI,303,2070,2373
SUMATERA UTARA,LABUHANBATU UTARA,KUALUH LEIDONG,5008,8122,13130
SUMATERA UTARA,LABUHANBATU UTARA,AEK KUO,5583,9640,15223
SUMATERA UTARA,NIAS UTARA,SAWO,639,3293,3932
SUMATERA UTARA,NIAS BARAT,MANDREHE,700,8860,9560
SUMATERA UTARA,NIAS BARAT,MANDREHE UTARA,406,3086,3492
SUMATERA UTARA,NIAS UTARA,NAMOHALU ESIWA,346,4987,5333
SUMATERA UTARA,NIAS UTARA,ALASA,964,5926,6890
SUMATERA UTARA,LABUHANBATU UTARA,KUALUH SELATAN,11146,18706,29852
SUMATERA UTARA,KOTA MEDAN,MEDAN KOTA,16439,25773,42212
SUMATERA UTARA,NIAS UTARA,SITOLU ORI,523,4696,5219
SUMATERA UTARA,NIAS BARAT,SIROMBU,1121,3396,4517
SUMATERA UTARA,KOTA MEDAN,MEDAN PETISAH,11954,22355,34309
SUMATERA UTARA,NIAS BARAT,LAHOMI,616,4002,4618
SUMATERA UTARA,NIAS UTARA,TUHEMBERUA,469,4122,4591
SUMATERA UTARA,NIAS UTARA,LAHEWA TIMUR,421,3031,3452
SUMATERA UTARA,KOTA MEDAN,MEDAN MARELAN,39648,20964,60612
SUMATERA UTARA,KOTA MEDAN,MEDAN MAIMUN,12801,9913,22714
SUMATERA UTARA,KOTA MEDAN,MEDAN BARU,6607,12637,19244
SUMATERA UTARA,KOTA MEDAN,MEDAN LABUHAN,28948,22552,51500
SUMATERA UTARA,KOTA MEDAN,MEDAN JOHOR,33926,27539,61465
SUMATERA UTARA,NIAS BARAT,MANDREHE BARAT,243,2714,2957
SUMATERA UTARA,KOTA MEDAN,MEDAN BARAT,19269,20754,40023
SUMATERA UTARA,KOTA MEDAN,MEDAN PERJUANGAN,25497,24598,50095
SUMATERA UTARA,NIAS BARAT,LOLOFITU MOI,1197,4315,5512
SUMATERA UTARA,KOTA MEDAN,MEDAN TEMBUNG,36652,26457,63109
SUMATERA UTARA,KOTA MEDAN,MEDAN TIMUR,28108,28932,57040
SUMATERA UTARA,KOTA MEDAN,MEDAN POLONIA,11286,12557,23843
SUMATERA UTARA,KOTA MEDAN,MEDAN SUNGGAL,27470,24877,52347
SUMATERA UTARA,KOTA MEDAN,MEDAN TUNTUNGAN,12319,27223,39542
SUMATERA UTARA,KOTA PEMATANGSIANTAR,SIANTAR UTARA,7902,15791,23693
SUMATERA UTARA,KOTA PEMATANGSIANTAR,SIANTAR BARAT,10327,9058,19385
SUMATERA UTARA,KOTA PEMATANGSIANTAR,SIANTAR MARIMBUN,1284,7142,8426
SUMATERA UTARA,KOTA PEMATANGSIANTAR,SIANTAR MARIHAT,1689,8070,9759
SUMATERA UTARA,KOTA MEDAN,MEDAN DENAI,38688,28462,67150
SUMATERA UTARA,KOTA SIBOLGA,SIBOLGA UTARA,1651,7978,9629
SUMATERA UTARA,KOTA MEDAN,MEDAN BELAWAN,21862,17425,39287
SUMATERA UTARA,KOTA MEDAN,MEDAN SELAYANG,19764,25578,45342
SUMATERA UTARA,KOTA MEDAN,MEDAN AREA,32862,22676,55538
SUMATERA UTARA,KOTA PEMATANGSIANTAR,SIANTAR SITALASARI,5997,7923,13920
SUMATERA UTARA,KOTA MEDAN,MEDAN HELVETIA,33517,35254,68771
SUMATERA UTARA,KOTA SIBOLGA,SIBOLGA SELATAN,5701,6600,12301
SUMATERA UTARA,KOTA MEDAN,MEDAN DELI,39353,29295,68648
SUMATERA UTARA,KOTA MEDAN,MEDAN AMPLAS,33273,20574,53847
SUMATERA UTARA,KOTA TANJUNG BALAI,TANJUNG BALAI SELATAN,3993,5131,9124
SUMATERA UTARA,KOTA BINJAI,BINJAI BARAT,12530,7522,20052
SUMATERA UTARA,KOTA TANJUNG BALAI,TANJUNG BALAI UTARA,3523,3551,7074
SUMATERA UTARA,KOTA PEMATANGSIANTAR,SIANTAR SELATAN,1181,8265,9446
SUMATERA UTARA,KOTA PEMATANGSIANTAR,SIANTAR TIMUR,4159,14493,18652
SUMATERA UTARA,KOTA TANJUNG BALAI,DATUK BANDAR TIMUR,7560,4126,11686
SUMATERA UTARA,KOTA BINJAI,BINJAI TIMUR,17748,10030,27778
SUMATERA UTARA,KOTA PEMATANGSIANTAR,SIANTAR MARTOBA,7585,12545,20130
SUMATERA UTARA,KOTA TANJUNG BALAI,SEI TUALANG RASO,5044,3642,8686
SUMATERA UTARA,KOTA TEBING TINGGI,PADANG HILIR,9204,6888,16092
SUMATERA UTARA,KOTA BINJAI,BINJAI SELATAN,16054,9154,25208
SUMATERA UTARA,KOTA TANJUNG BALAI,DATUK BANDAR,6436,6972,13408
SUMATERA UTARA,KOTA SIBOLGA,SIBOLGA KOTA,3161,3866,7027
SUMATERA UTARA,KOTA PADANG SIDIMPUAN,PADANGSIDIMPUAN UTARA,24148,5833,29981
SUMATERA UTARA,KOTA SIBOLGA,SIBOLGA SAMBAS,4169,4129,8298
SUMATERA UTARA,KOTA TEBING TINGGI,PADANG HULU,8165,6273,14438
SUMATERA UTARA,KOTA PADANG SIDIMPUAN,PADANGSIDIMPUAN HUTAIMBARU,6595,1554,8149
SUMATERA UTARA,KOTA TANJUNG BALAI,TELUK NIBUNG,7963,5189,13152
SUMATERA UTARA,KOTA PADANG SIDIMPUAN,PADANGSIDIMPUAN SELATAN,20957,8884,29841
SUMATERA UTARA,KOTA BINJAI,BINJAI UTARA,23149,11275,34424
SUMATERA UTARA,KOTA TEBING TINGGI,BAJENIS,8963,7862,16825
SUMATERA UTARA,KOTA GUNUNGSITOLI,GUNUNGSITOLI IDANOI,1153,9868,11021
SUMATERA UTARA,KOTA PADANG SIDIMPUAN,PADANGSIDIMPUAN TENGGARA,9769,3925,13694
SUMATERA UTARA,KOTA TEBING TINGGI,RAMBUTAN,9399,7137,16536
SUMATERA UTARA,KOTA BINJAI,BINJAI KOTA,8407,7482,15889
SUMATERA UTARA,KOTA GUNUNGSITOLI,GUNUNGSITOLI UTARA,1333,6073,7406
SUMATERA BARAT,PESISIR SELATAN,IV NAGARI BAYANG UTARA,3711,549,4260
SUMATERA UTARA,KOTA TEBING TINGGI,TEBING TINGGI KOTA,5861,7338,13199
SUMATERA UTARA,KOTA GUNUNGSITOLI,GUNUNGSITOLI SELATAN,535,6019,6554
SUMATERA BARAT,PESISIR SELATAN,BATANG KAPAS,9918,3763,13681
SUMATERA UTARA,KOTA GUNUNGSITOLI,GUNUNGSITOLI,6030,20577,26607
SUMATERA UTARA,KOTA PADANG SIDIMPUAN,PADANGSIDIMPUAN BATUNADUA,7548,2276,9824
SUMATERA UTARA,KOTA PADANG SIDIMPUAN,PADANGSIDIMPUAN ANGKOLA JULU,2830,951,3781
SUMATERA BARAT,PESISIR SELATAN,LENGAYANG,16625,7014,23639
SUMATERA BARAT,PESISIR SELATAN,RANAH AMPEK HULU TAPAN,4143,1864,6007
SUMATERA UTARA,KOTA GUNUNGSITOLI,GUNUNGSITOLI BARAT,313,3331,3644
SUMATERA BARAT,PESISIR SELATAN,PANCUNG SOAL,6917,3211,10128
SUMATERA BARAT,PESISIR SELATAN,AIRPURA,3805,2483,6288
SUMATERA BARAT,PESISIR SELATAN,LINGGO SARI BAGANTI,13824,5574,19398
SUMATERA BARAT,SOLOK,HILIRAN GUMANTI,6056,1149,7205
SUMATERA BARAT,SOLOK,X KOTO SINGKARAK,13797,2730,16527
SUMATERA BARAT,PESISIR SELATAN,SUTERA,16484,4997,21481
SUMATERA BARAT,SOLOK,TIGO LURAH,3878,910,4788
SUMATERA BARAT,PESISIR SELATAN,BAYANG,16018,3220,19238
SUMATERA BARAT,PESISIR SELATAN,BASA AMPEK BALAI TAPAN,3384,2180,5564
SUMATERA BARAT,PESISIR SELATAN,LUNANG,4741,5076,9817
SUMATERA BARAT,SOLOK,PANTAI CERMIN,7142,1409,8551
SUMATERA BARAT,PESISIR SELATAN,KOTO XI TARUSAN,16477,5388,21865
SUMATERA BARAT,SOLOK,PAYUNG SEKAKI,3587,572,4159
SUMATERA BARAT,SOLOK,JUNJUNG SIRI,5220,738,5958
SUMATERA BARAT,SOLOK,KUBUNG,23290,3836,27126
SUMATERA BARAT,PESISIR SELATAN,IV JURAI,17408,5299,22707
SUMATERA BARAT,PESISIR SELATAN,SILAUT,3708,3568,7276
SUMATERA BARAT,SIJUNJUNG,IV NAGARI,6079,924,7003
SUMATERA BARAT,PESISIR SELATAN,RANAH PESISIR,9987,4188,14175
SUMATERA BARAT,SIJUNJUNG,TANJUNG GADANG,8787,1879,10666
SUMATERA BARAT,SOLOK,DANAU KEMBAR,7174,746,7920
SUMATERA BARAT,SOLOK,BUKIT SUNDI,9553,1730,11283
SUMATERA BARAT,SOLOK,X KOTO DIATAS,7811,1579,9390
SUMATERA BARAT,SOLOK,IX KOTO SEI LASI,4366,911,5277
SUMATERA BARAT,SOLOK,GUNUNG TALANG,19944,3412,23356
SUMATERA BARAT,SIJUNJUNG,SIJUNJUNG,16417,4014,20431
SUMATERA BARAT,SOLOK,LEMBAH GUMANTI,19286,2441,21727
SUMATERA BARAT,SIJUNJUNG,SUMPUR KUDUS,7899,3756,11655
SUMATERA BARAT,SIJUNJUNG,KAMANG BARU,14311,6826,21137
SUMATERA BARAT,SOLOK,LEMBANG JAYA,10038,1668,11706
SUMATERA BARAT,TANAH DATAR,LINTAU BUO UTARA,8652,9698,18350
SUMATERA BARAT,TANAH DATAR,X KOTO,14816,3437,18253
SUMATERA BARAT,TANAH DATAR,RAMBATAN,13817,2801,16618
SUMATERA BARAT,SIJUNJUNG,LUBUAK TAROK,4601,2626,7227
SUMATERA BARAT,SIJUNJUNG,KUPITAN,4641,1234,5875
SUMATERA BARAT,TANAH DATAR,SUNGAI TARAB,11803,2642,14445
SUMATERA BARAT,SIJUNJUNG,KOTO VII,11768,3037,14805
SUMATERA BARAT,TANAH DATAR,TANJUANG BARU,5799,948,6747
SUMATERA BARAT,TANAH DATAR,PADANG GANTING,4988,2093,7081
SUMATERA BARAT,PADANG PARIAMAN,PADANG SAGO,3017,1001,4018
SUMATERA BARAT,PADANG PARIAMAN,LUBUK ALUNG,14807,3443,18250
SUMATERA BARAT,PADANG PARIAMAN,2 X 11 ENAM LINGKUNG,5922,2390,8312
SUMATERA BARAT,TANAH DATAR,LINTAU BUO,5338,3689,9027
SUMATERA BARAT,TANAH DATAR,SALIMPAUANG,8057,1692,9749
SUMATERA BARAT,TANAH DATAR,PARIANGAN,7683,1711,9394
SUMATERA BARAT,TANAH DATAR,BATIPUH,10613,2865,13478
SUMATERA BARAT,PADANG PARIAMAN,SINTUAK TOBOH GADANG,6880,1660,8540
SUMATERA BARAT,TANAH DATAR,SUNGAYANG,6180,2312,8492
SUMATERA BARAT,TANAH DATAR,TANJUNG EMAS,9512,2338,11850
SUMATERA BARAT,TANAH DATAR,LIMA KAUM,15118,3139,18257
SUMATERA BARAT,PADANG PARIAMAN,V KOTO KAMPUNG DALAM,8863,1924,10787
SUMATERA BARAT,PADANG PARIAMAN,2 X 11 KAYU TANAM,8807,2678,11485
SUMATERA BARAT,TANAH DATAR,BATIPUAH SELATAN,5057,822,5879
SUMATERA BARAT,PADANG PARIAMAN,NAN SABARIS,10825,2050,12875
SUMATERA BARAT,PADANG PARIAMAN,SUNGAI GARINGGING,8524,3051,11575
SUMATERA BARAT,PADANG PARIAMAN,SUNGAI LIMAU,10420,2269,12689
SUMATERA BARAT,PADANG PARIAMAN,BATANG GASAN,4503,811,5314
SUMATERA BARAT,PADANG PARIAMAN,V KOTO TIMUR,5615,1130,6745
SUMATERA BARAT,AGAM,PELEMBAYAN,11355,2205,13560
SUMATERA BARAT,PADANG PARIAMAN,PATAMUAN,5676,1688,7364
SUMATERA BARAT,AGAM,TANJUNG MUTIARA,0,0,0
SUMATERA BARAT,PADANG PARIAMAN,IV KOTO AUR MALINTANG,6398,1674,8072
SUMATERA BARAT,PADANG PARIAMAN,ULAKAN TAPAKIH,6696,1771,8467
SUMATERA BARAT,AGAM,KAMANG MAGEK,9425,1691,11116
SUMATERA BARAT,PADANG PARIAMAN,VII KOTO SUNGAI SARIK,11635,4194,15829
SUMATERA BARAT,AGAM,AMPEK NAGARI,8612,2306,10918
SUMATERA BARAT,AGAM,IV KOTO,9894,1639,11533
SUMATERA BARAT,PADANG PARIAMAN,BATANG ANAI,14936,3786,18722
SUMATERA BARAT,PADANG PARIAMAN,ENAM LINGKUNG,7414,1835,9249
SUMATERA BARAT,AGAM,IV ANGKAT CANDUNG,15606,3746,19352
SUMATERA BARAT,AGAM,PALUPUH,5158,1242,6400
SUMATERA BARAT,LIMA PULUH KOTA,BUKIK BARISAN,9332,1789,11121
SUMATERA BARAT,LIMA PULUH KOTA,SULIKI,5588,1711,7299
SUMATERA BARAT,AGAM,MALALAK,3628,613,4241
SUMATERA BARAT,LIMA PULUH KOTA,LAREH SAGO HALABAN,14331,4617,18948
SUMATERA BARAT,AGAM,CANDUNG,8670,1787,10457
SUMATERA BARAT,AGAM,LUBUK BASUNG,23529,6334,29863
SUMATERA BARAT,AGAM,TILATANG KAMANG,14173,2953,17126
SUMATERA BARAT,AGAM,SUNGAI PUA,9093,1753,10846
SUMATERA BARAT,LIMA PULUH KOTA,MUNGKA,9650,2084,11734
SUMATERA BARAT,LIMA PULUH KOTA,PAYAKUMBUH,12815,2761,15576
SUMATERA BARAT,LIMA PULUH KOTA,AKABILURU,10465,1721,12186
SUMATERA BARAT,AGAM,MATUR,7477,1340,8817
SUMATERA BARAT,AGAM,BASO,12864,2871,15735
SUMATERA BARAT,LIMA PULUH KOTA,LUAK,11062,2388,13450
SUMATERA BARAT,AGAM,BANUHAMPU,14317,2522,16839
SUMATERA BARAT,PASAMAN,MAPAT TUNGGUL SELATAN,3120,1120,4240
SUMATERA BARAT,PASAMAN,RAO,7961,3385,11346
SUMATERA BARAT,LIMA PULUH KOTA,PANGKALAN KOTO BARU,10502,2272,12774
SUMATERA BARAT,LIMA PULUH KOTA,SITUJUAH LIMO NAGARI,8640,2074,10714
SUMATERA BARAT,AGAM,TANJUNG RAYA,13017,2843,15860
SUMATERA BARAT,PASAMAN,LUBUK SIKAPING,19038,3231,22269
SUMATERA BARAT,PASAMAN,DUO KOTO,7767,3060,10827
SUMATERA BARAT,PASAMAN,RAO UTARA,4623,1040,5663
SUMATERA BARAT,LIMA PULUH KOTA,KAPUR IX,8460,2862,11322
SUMATERA BARAT,LIMA PULUH KOTA,HARAU,17964,4949,22913
SUMATERA BARAT,LIMA PULUH KOTA,GUNUANG OMEH,4834,1426,6260
SUMATERA BARAT,KEPULAUAN MENTAWAI,PAGAI UTARA,0,0,0
SUMATERA BARAT,PASAMAN,MAPAT TUNGGUL,2915,1845,4760
SUMATERA BARAT,PASAMAN,PADANG GELUGUR,10148,2766,12914
SUMATERA BARAT,PASAMAN,SIMPANG ALAHAN MATI,3971,661,4632
SUMATERA BARAT,LIMA PULUH KOTA,GUGUAK,13440,4045,17485
SUMATERA BARAT,KEPULAUAN MENTAWAI,SIPORA UTARA,0,0,0
SUMATERA BARAT,KEPULAUAN MENTAWAI,PAGAI SELATAN,0,0,0
SUMATERA BARAT,PASAMAN,TIGO NAGARI,7644,1702,9346
SUMATERA BARAT,PASAMAN,RAO SELATAN,8978,2319,11297
SUMATERA BARAT,PASAMAN,BONJOL,8207,1880,10087
SUMATERA BARAT,KEPULAUAN MENTAWAI,SIBERUT BARAT DAYA,0,0,0
SUMATERA BARAT,KEPULAUAN MENTAWAI,SIBERUT TENGAH,0,0,0
SUMATERA BARAT,PASAMAN,PANTI,9871,3635,13506
SUMATERA BARAT,DHARMASRAYA,KOTO BARU,11072,4531,15603
SUMATERA BARAT,DHARMASRAYA,SEMBILAN KOTO,2602,1145,3747
SUMATERA BARAT,DHARMASRAYA,ASAM JUJUHAN,4257,1595,5852
SUMATERA BARAT,KEPULAUAN MENTAWAI,SIBERUT BARAT,0,0,0
SUMATERA BARAT,KEPULAUAN MENTAWAI,SIKAKAP,0,0,0
SUMATERA BARAT,KEPULAUAN MENTAWAI,SIPORA SELATAN,0,0,0
SUMATERA BARAT,DHARMASRAYA,KOTO SALAK,5324,4371,9695
SUMATERA BARAT,DHARMASRAYA,PADANG LAWEH,1983,1169,3152
SUMATERA BARAT,DHARMASRAYA,KOTO BESAR,7452,4523,11975
SUMATERA BARAT,SOLOK SELATAN,SUNGAI PAGU,11577,2697,14274
SUMATERA BARAT,DHARMASRAYA,TIMPEH,4678,3173,7851
SUMATERA BARAT,KEPULAUAN MENTAWAI,SIBERUT UTARA,0,0,0
SUMATERA BARAT,KEPULAUAN MENTAWAI,SIBERUT SELATAN,0,0,0
SUMATERA BARAT,DHARMASRAYA,TIUMANG,3588,3345,6933
SUMATERA BARAT,DHARMASRAYA,SITIUNG,9578,3881,13459
SUMATERA BARAT,DHARMASRAYA,PULAU PUNJUNG,14604,4167,18771
SUMATERA BARAT,PASAMAN BARAT,GUNUNG TULEH,0,0,0
SUMATERA BARAT,DHARMASRAYA,SUNGAI RUMBAI,5003,4837,9840
SUMATERA BARAT,PASAMAN BARAT,LUHAK NAN DUO,13729,5522,19251
SUMATERA BARAT,SOLOK SELATAN,SANGIR,13722,4466,18188
SUMATERA BARAT,PASAMAN BARAT,TALAMAU,11156,1890,13046
SUMATERA BARAT,SOLOK SELATAN,PAUH DUO,6413,1616,8029
SUMATERA BARAT,PASAMAN BARAT,LEMBAH MELINTANG,14078,3312,17390
SUMATERA BARAT,PASAMAN BARAT,RANAH BATAHAN,9098,3287,12385
SUMATERA BARAT,PASAMAN BARAT,SUNGAI BEREMAS,7121,1775,8896
SUMATERA BARAT,SOLOK SELATAN,SANGIR JUJUAN,5340,1078,6418
SUMATERA BARAT,PASAMAN BARAT,KOTO BALINGKA,8334,3546,11880
SUMATERA BARAT,SOLOK SELATAN,SANGIR BATANG HARI,4920,2411,7331
SUMATERA BARAT,PASAMAN BARAT,SUNGAI AUA,10071,4072,14143
SUMATERA BARAT,KOTA PADANG,NANGGALO,21193,5640,26833
SUMATERA BARAT,SOLOK SELATAN,SANGIR BALAI JANGGO,6212,2771,8983
SUMATERA BARAT,SOLOK SELATAN,KOTO PARIK GADANG DIATEH,7881,2064,9945
SUMATERA BARAT,PASAMAN BARAT,SASAK RANAH PESISIA,4940,1703,6643
SUMATERA BARAT,KOTA PADANG,PADANG TIMUR,29436,7665,37101
SUMATERA BARAT,KOTA PADANG,KURANJI,49937,9780,59717
SUMATERA BARAT,KOTA PADANG,PADANG SELATAN,18798,9241,28039
SUMATERA BARAT,KOTA PADANG,PADANG BARAT,14282,8106,22388
SUMATERA BARAT,KOTA SOLOK,LUBUK SIKARAH,14393,2644,17037
SUMATERA BARAT,KOTA PADANG,LUBUK BEGALUNG,40781,10537,51318
SUMATERA BARAT,KOTA PADANG,LUBUK KILANGAN,18849,4298,23147
SUMATERA BARAT,KOTA SAWAHLUNTO,LEMBAH SEGAR,5128,1387,6515
SUMATERA BARAT,PASAMAN BARAT,KINALI,20039,8905,28944
SUMATERA BARAT,PASAMAN BARAT,PASAMAN,23134,5883,29017
SUMATERA BARAT,KOTA SAWAHLUNTO,BARANGIN,7000,2017,9017
SUMATERA BARAT,KOTA PAYAKUMBUH,PAYAKUMBUH SELATAN,4221,884,5105
SUMATERA BARAT,KOTA PADANG,BUNGUS TELUK KABUNG,8788,1516,10304
SUMATERA BARAT,KOTA PADANG PANJANG,PADANG PANJANG TIMUR,7967,1786,9753
SUMATERA BARAT,KOTA PAYAKUMBUH,LAMPOSI TIGO NAGORI,3908,796,4704
SUMATERA BARAT,KOTA SOLOK,TANJUNG HARAPAN,11256,2426,13682
SUMATERA BARAT,KOTA PADANG,PAUH,22107,4039,26146
SUMATERA BARAT,KOTA PAYAKUMBUH,PAYAKUMBUH BARAT,17746,4672,22418
SUMATERA BARAT,KOTA PARIAMAN,PARIAMAN TIMUR,6606,1123,7729
SUMATERA BARAT,KOTA SAWAHLUNTO,TALAWI,7466,2165,9631
SUMATERA BARAT,KOTA PAYAKUMBUH,PAYAKUMBUH UTARA,11739,2515,14254
SUMATERA BARAT,KOTA PAYAKUMBUH,PAYAKUMBUH TIMUR,9517,2883,12400
SUMATERA BARAT,KOTA PADANG,PADANG UTARA,20697,5443,26140
SUMATERA BARAT,KOTA PADANG,KOTO TANGAH,59982,17433,77415
SUMATERA BARAT,KOTA BUKITTINGGI,GUGUAK PANJANG,14470,3681,18151
SUMATERA BARAT,KOTA PADANG PANJANG,PADANG PANJANG BARAT,10980,2616,13596
RIAU,KAMPAR,RUMBIO JAYA,6378,1933,8311
SUMATERA BARAT,KOTA SAWAHLUNTO,SILUNGKANG,3880,1097,4977
RIAU,KAMPAR,GUNUNG SAHILAN,3496,5186,8682
RIAU,KAMPAR,BANGKINANG SEBERANG,11190,4604,15794
RIAU,KAMPAR,BANGKINANG,13629,3037,16666
SUMATERA BARAT,KOTA BUKITTINGGI,AUR BIRUGO TIGO BALEH,9145,1894,11039
RIAU,KAMPAR,KAMPAR UTARA,8313,1015,9328
RIAU,KAMPAR,TAPUNG HULU,13569,23052,36621
SUMATERA BARAT,KOTA PARIAMAN,PARIAMAN SELATAN,6952,1198,8150
RIAU,KAMPAR,TAMBANG,24850,7197,32047
RIAU,KAMPAR,KUOK,8927,2144,11071
RIAU,KAMPAR,SALO,7392,2835,10227
SUMATERA BARAT,KOTA PARIAMAN,PARIAMAN UTARA,7904,1652,9556
RIAU,KAMPAR,KAMPAR TIMUR,9819,2174,11993
SUMATERA BARAT,KOTA PARIAMAN,PARIAMAN TENGAH,12517,2697,15214
RIAU,KAMPAR,TAPUNG,20749,21824,42573
RIAU,KAMPAR,KAMPAR KIRI,6538,6706,13244
RIAU,KAMPAR,KOTO KAMPAR HULU,6013,3739,9752
RIAU,KAMPAR,KAMPAR,21187,3084,24271
RIAU,KAMPAR,KAMPAR KIRI HILIR,2927,2378,5305
RIAU,KAMPAR,KAMPAR KIRI TENGAH,6778,7583,14361
RIAU,KAMPAR,PERHENTIAN RAJA,4377,3512,7889
RIAU,INDRAGIRI HULU,RAKIT KULIM,2964,5331,8295
RIAU,INDRAGIRI HULU,BATANG GANGSAL,2930,8765,11695
RIAU,INDRAGIRI HULU,KUALA CENAKU,3081,2684,5765
RIAU,KAMPAR,SIAK HULU,26069,15156,41225
RIAU,KAMPAR,TAPUNG HILIR,11596,14887,26483
RIAU,KAMPAR,XIII KOTO KAMPAR,7865,3407,11272
RIAU,INDRAGIRI HULU,LIRIK,4756,6406,11162
RIAU,INDRAGIRI HULU,RENGAT,13895,7258,21153
RIAU,INDRAGIRI HULU,LUBUK BATU JAYA,4383,6048,10431
RIAU,INDRAGIRI HULU,BATANG PERANAP,1451,3724,5175
RIAU,INDRAGIRI HULU,SIBERIDA,9303,12380,21683
RIAU,INDRAGIRI HULU,PERANAP,5137,7276,12413
RIAU,KAMPAR,KAMPAR KIRI HULU,3018,2676,5694
RIAU,BENGKALIS,SIAK KECIL,4122,6616,10738
RIAU,INDRAGIRI HILIR,GAUNG,3890,10251,14141
RIAU,BENGKALIS,MANDAU,62864,48405,111269
RIAU,BENGKALIS,RUPAT,4639,10921,15560
RIAU,INDRAGIRI HULU,SUNGAI LALA,2980,3760,6740
RIAU,INDRAGIRI HULU,PASIR PENYU,7817,6499,14316
RIAU,INDRAGIRI HULU,KELAYANG,5024,6316,11340
RIAU,INDRAGIRI HULU,BATANG CENAKU,6179,10963,17142
RIAU,INDRAGIRI HILIR,CONCONG,1902,2585,4487
RIAU,BENGKALIS,BUKIT BATU,7195,8878,16073
RIAU,BENGKALIS,PINGGIR,12781,29362,42143
RIAU,BENGKALIS,BANTAN,6261,12783,19044
RIAU,BENGKALIS,BENGKALIS,16789,19492,36281
RIAU,INDRAGIRI HILIR,TELUK BELENGKONG,1831,4209,6040
RIAU,INDRAGIRI HILIR,KEMPAS,7234,9230,16464
RIAU,BENGKALIS,RUPAT UTARA,2010,4412,6422
RIAU,INDRAGIRI HILIR,RETEH,6818,11872,18690
RIAU,INDRAGIRI HULU,RENGAT BARAT,10154,10050,20204
RIAU,INDRAGIRI HILIR,KUALA INDRAGIRI,2120,3762,5882
RIAU,INDRAGIRI HILIR,KEMUNING,5547,9778,15325
RIAU,INDRAGIRI HILIR,KERITANG,8712,19039,27751
RIAU,INDRAGIRI HILIR,TEMBILAHAN HULU,8262,9519,17781
RIAU,PELALAWAN,UKUI,6226,11287,17513
RIAU,INDRAGIRI HILIR,PULAU BURUNG,3662,6237,9899
RIAU,INDRAGIRI HILIR,MANDAH,6031,9066,15097
RIAU,INDRAGIRI HILIR,PELANGIRAN,7530,10750,18280
RIAU,INDRAGIRI HILIR,TANAH MERAH,4265,6252,10517
RIAU,INDRAGIRI HILIR,BATANG TUAKA,5321,4658,9979
RIAU,INDRAGIRI HILIR,TEMBILAHAN,16782,15154,31936
RIAU,PELALAWAN,KERUMUTAN,6079,5294,11373
RIAU,PELALAWAN,KUALA KAMPAR,2199,5971,8170
RIAU,PELALAWAN,PANGKALAN KURAS,9447,13425,22872
RIAU,PELALAWAN,TELUK MERANTI,2956,4559,7515
RIAU,PELALAWAN,BANDAR SEI KIJANG,3431,4035,7466
RIAU,ROKAN HULU,UJUNG BATU,10220,8410,18630
RIAU,PELALAWAN,LANGGAM,4440,6402,10842
RIAU,INDRAGIRI HILIR,GAUNG ANAK SERKA,3727,5167,8894
RIAU,INDRAGIRI HILIR,TEMPULING,6121,7074,13195
RIAU,PELALAWAN,PANGKALAN LESUNG,5190,7422,12612
RIAU,INDRAGIRI HILIR,ENOK,5876,9762,15638
RIAU,ROKAN HULU,KEPENUHAN HULU,4936,3645,8581
RIAU,INDRAGIRI HILIR,KATEMAN,6148,11228,17376
RIAU,INDRAGIRI HILIR,SUNGAI BATANG,1866,3041,4907
RIAU,PELALAWAN,PANGKALAN KERINCI,18025,15584,33609
RIAU,ROKAN HULU,RAMBAH HILIR,10506,9196,19702
RIAU,ROKAN HULU,TANDUN,6095,7593,13688
RIAU,PELALAWAN,BUNUT,2619,3288,5907
RIAU,ROKAN HULU,TAMBUSAI UTARA,10511,27182,37693
RIAU,PELALAWAN,PELALAWAN,2747,3972,6719
RIAU,ROKAN HULU,KUNTO DARUSSALAM,9138,9687,18825
RIAU,ROKAN HILIR,KUBU,3811,6624,10435
RIAU,ROKAN HILIR,PEKAITAN,1990,6877,8867
RIAU,ROKAN HULU,BANGUN PURBA,4772,4503,9275
RIAU,ROKAN HULU,RAMBAH SAMO,8552,7015,15567
RIAU,ROKAN HULU,PENDALIAN IV KOTO,3029,3031,6060
RIAU,ROKAN HULU,KABUN,5662,6036,11698
RIAU,PELALAWAN,BANDAR PETALANGAN,3584,4257,7841
RIAU,ROKAN HULU,BONAI DARUSSALAM,4331,7374,11705
RIAU,ROKAN HULU,PAGARAN TAPAH DARUSSALAM,2472,2610,5082
RIAU,ROKAN HULU,ROKAN IV KOTO,6808,4731,11539
RIAU,ROKAN HILIR,RIMBA MELINTANG,6396,10380,16776
RIAU,ROKAN HILIR,BATU HAMPAR,1519,2243,3762
RIAU,ROKAN HILIR,RANTAU KOPAR,1853,1322,3175
RIAU,ROKAN HILIR,KUBU BABUSSALAM,3401,6403,9804
RIAU,ROKAN HILIR,BANGKO,19000,18967,37967
RIAU,ROKAN HULU,TAMBUSAI,9690,15701,25391
RIAU,ROKAN HULU,RAMBAH,16335,5770,22105
RIAU,ROKAN HILIR,SIMPANG KANAN,5009,7837,12846
RIAU,SIAK,MEMPURA,4380,2374,6754
RIAU,SIAK,KOTO GASIB,4646,3688,8334
RIAU,ROKAN HULU,KEPENUHAN,6899,3528,10427
RIAU,ROKAN HILIR,BAGAN SINEMBAH,28025,36760,64785
RIAU,SIAK,KERINCI KANAN,4978,6490,11468
RIAU,SIAK,TUALANG,27533,17667,45200
RIAU,SIAK,SABAK AUH,2828,2668,5496
RIAU,SIAK,BUNGA RAYA,5464,6569,12033
RIAU,ROKAN HILIR,PASIR LIMAU KAPAS,4920,10135,15055
RIAU,ROKAN HILIR,TANAH PUTIH,11955,14995,26950
RIAU,ROKAN HILIR,BANGKO PUSAKO,8998,17643,26641
RIAU,ROKAN HILIR,TANAH PUTIH TANJUNG MELAWAN,3084,3173,6257
RIAU,ROKAN HILIR,PUJUD,11948,22239,34187
RIAU,ROKAN HILIR,SINABOI,2307,4039,6346
RIAU,SIAK,LUBUK DALAM,3304,5382,8686
RIAU,SIAK,SUNGAI APIT,5613,7568,13181
RIAU,KUANTAN SINGINGI,KUANTAN HILIR SEBERANG,2058,4193,6251
RIAU,SIAK,KANDIS,9204,18538,27742
RIAU,SIAK,SIAK,6738,4063,10801
RIAU,KUANTAN SINGINGI,KUANTAN MUDIK,6920,4427,11347
RIAU,KUANTAN SINGINGI,KUANTAN HILIR,3500,3617,7117
RIAU,KUANTAN SINGINGI,HULU KUANTAN,1913,1913,3826
RIAU,KUANTAN SINGINGI,INUMAN,2407,4376,6783
RIAU,KUANTAN SINGINGI,SINGINGI HILIR,7107,10333,17440
RIAU,KUANTAN SINGINGI,PUCUK RANTAU,1783,2715,4498
RIAU,KUANTAN SINGINGI,SENTAJO RAYA,7298,7780,15078
RIAU,SIAK,SUNGAI MANDAU,2029,1366,3395
RIAU,SIAK,DAYUN,5753,7306,13059
RIAU,KUANTAN SINGINGI,GUNUNGTOAR,4098,2314,6412
RIAU,SIAK,PUSAKO,1768,1188,2956
RIAU,KUANTAN SINGINGI,BENAI,4613,3492,8105
RIAU,KUANTAN SINGINGI,SINGINGI,6743,7972,14715
RIAU,SIAK,MINAS,5636,5502,11138
RIAU,KEPULAUAN MERANTI,TEBING TINGGI BARAT,2888,4905,7793
RIAU,KUANTAN SINGINGI,KUANTAN TENGAH,13599,9329,22928
RIAU,KOTA PEKANBARU,TENAYAN RAYA,35014,20133,55147
RIAU,KUANTAN SINGINGI,CERENTI,3551,3203,6754
RIAU,KEPULAUAN MERANTI,RANGSANG PESISIR,2067,5108,7175
RIAU,KEPULAUAN MERANTI,RANGSANG BARAT,3045,5253,8298
RIAU,KUANTAN SINGINGI,LOGAS TANAH DARAT,4216,6376,10592
RIAU,KEPULAUAN MERANTI,MERBAU,2319,4747,7066
RIAU,KOTA PEKANBARU,TAMPAN,0,0,0
RIAU,KUANTAN SINGINGI,PANGEAN,4788,4219,9007
RIAU,KEPULAUAN MERANTI,TASIK PUTRI PUYU,2003,5523,7526
RIAU,KEPULAUAN MERANTI,TEBING TINGGI TIMUR,1589,4186,5775
RIAU,KOTA PEKANBARU,PAYUNG SEKAKI,21464,18553,40017
RIAU,KEPULAUAN MERANTI,TEBING TINGGI,11280,14905,26185
RIAU,KOTA PEKANBARU,SUKAJADI,0,0,0
RIAU,KEPULAUAN MERANTI,RANGSANG,2581,6100,8681
RIAU,KEPULAUAN MERANTI,PULAUMERBAU,1839,4562,6401
RIAU,KOTA DUMAI,DUMAI BARAT,8634,8526,17160
RIAU,KOTA DUMAI,SUNGAI SEMBILAN,3944,10744,14688
RIAU,KOTA PEKANBARU,MARPOYAN DAMAI,0,0,0
RIAU,KOTA PEKANBARU,BUKIT RAYA,30135,10460,40595
RIAU,KOTA PEKANBARU,PEKANBARU KOTA,8588,2758,11346
RIAU,KOTA DUMAI,BUKIT KAPUR,7090,10694,17784
RIAU,KOTA DUMAI,MEDANG KAMPAI,2160,2569,4729
RIAU,KOTA PEKANBARU,RUMBAI PESISIR,0,0,0
RIAU,KOTA PEKANBARU,LIMA PULUH,10507,9741,20248
JAMBI,KERINCI,SIULAK MUKAI,1703,4138,5841
JAMBI,KERINCI,AIR HANGAT BARAT,5517,1260,6777
JAMBI,KERINCI,DEPATI TUJUH,9411,1087,10498
RIAU,KOTA PEKANBARU,SAIL,0,0,0
JAMBI,KERINCI,GUNUNG RAYA,3254,1511,4765
RIAU,KOTA PEKANBARU,RUMBAI,0,0,0
JAMBI,KERINCI,BUKITKERMAN,5591,1449,7040
RIAU,KOTA DUMAI,DUMAI SELATAN,12695,9708,22403
RIAU,KOTA PEKANBARU,SENAPELAN,10511,6906,17417
JAMBI,KERINCI,DANAU KERINCI,6905,1588,8493
RIAU,KOTA DUMAI,DUMAI TIMUR,12643,13952,26595
JAMBI,KERINCI,GUNUNG TUJUH,4804,2826,7630
RIAU,KOTA DUMAI,DUMAI KOTA,10345,9291,19636
JAMBI,KERINCI,KELILING DANAU,11353,2450,13803
JAMBI,KERINCI,SIULAK,9457,3211,12668
JAMBI,KERINCI,AIR HANGAT TIMUR,9624,1622,11246
JAMBI,KERINCI,KAYU ARO,6688,5817,12505
JAMBI,MERANGIN,RENAH PEMBARAP,4952,2115,7067
JAMBI,KERINCI,GUNUNG KERINCI,5439,1921,7360
JAMBI,KERINCI,BATANG MERANGIN,2744,1946,4690
JAMBI,KERINCI,KAYU ARO BARAT,7380,5302,12682
JAMBI,MERANGIN,PAMENANG BARAT,3843,5362,9205
JAMBI,MERANGIN,MUARA SIAU,2103,2841,4944
JAMBI,MERANGIN,TABIR ILIR,1901,3670,5571
JAMBI,KERINCI,AIR HANGAT,7685,1189,8874
JAMBI,KERINCI,SITINJAU LAUT,7094,1363,8457
JAMBI,MERANGIN,JANGKAT,3823,2325,6148
JAMBI,MERANGIN,SUNGAI TENANG,3572,1763,5335
JAMBI,MERANGIN,LEMBAH MASURAI,4810,6224,11034
JAMBI,MERANGIN,BANGKO,15527,9014,24541
JAMBI,MERANGIN,PANGKALAN JAMBU,2766,1141,3907
JAMBI,MERANGIN,RENAH PAMENANG,3617,4819,8436
JAMBI,MERANGIN,PAMENANG SELATAN,2785,2787,5572
JAMBI,MERANGIN,TABIR TIMUR,1467,3009,4476
JAMBI,MERANGIN,TABIR LINTAS,1732,2476,4208
JAMBI,SAROLANGUN,SINGKUT,8310,12660,20970
JAMBI,MERANGIN,BANGKO  BARAT,2571,3643,6214
JAMBI,SAROLANGUN,BATHIN VIII,7002,4897,11899
JAMBI,MERANGIN,PAMENANG,7719,10204,17923
JAMBI,MERANGIN,MARGO TABIR,3521,3851,7372
JAMBI,MERANGIN,SUNGAI MANAU,4176,1322,5498
JAMBI,SAROLANGUN,PELAWAN,7793,8655,16448
JAMBI,SAROLANGUN,BATANG ASAI,4821,3849,8670
JAMBI,MERANGIN,BATANG MASUMAI,3954,1444,5398
JAMBI,MERANGIN,TABIR BARAT,3337,2746,6083
JAMBI,SAROLANGUN,AIR HITAM,4078,8358,12436
JAMBI,MERANGIN,TABIR,7757,7323,15080
JAMBI,MERANGIN,TABIR SELATAN,6435,9787,16222
JAMBI,MERANGIN,TABIR ULU,1889,2501,4390
JAMBI,SAROLANGUN,SAROLANGUN,17727,9566,27293
JAMBI,SAROLANGUN,MANDIANGIN,5970,12813,18783
JAMBI,MERANGIN,NALO TATAN,3176,3784,6960
JAMBI,BATANGHARI,MARO SEBO ILIR,3539,3928,7467
JAMBI,SAROLANGUN,LIMUN,5585,4783,10368
JAMBI,BATANGHARI,MERSAM,6751,7857,14608
JAMBI,MERANGIN,TIANG PUMPUNG,1540,1256,2796
JAMBI,SAROLANGUN,PAUH,3769,8414,12183
JAMBI,MUARO JAMBI,KUMPEH ULU,11373,14702,26075
JAMBI,MUARO JAMBI,JAMBI LUAR KOTA,17456,15204,32660
JAMBI,MUARO JAMBI,TAMAN RAJO,3570,3016,6586
JAMBI,BATANGHARI,PEMAYUNG,8011,8427,16438
JAMBI,BATANGHARI,MARO SEBO ULU,5077,9527,14604
JAMBI,MUARO JAMBI,BAHAR UTARA,2705,4563,7268
JAMBI,BATANGHARI,MUARA TEMBESI,7589,7721,15310
JAMBI,BATANGHARI,BATIN XXIV,4564,9778,14342
JAMBI,SAROLANGUN,CERMIN NAN GEDANG,3543,2448,5991
JAMBI,MUARO JAMBI,SUNGAI GELAM,10668,23702,34370
JAMBI,MUARO JAMBI,BAHAR SELATAN,3414,5524,8938
JAMBI,BATANGHARI,BAJUBANG,6693,12232,18925
JAMBI,BATANGHARI,MUARA BULIAN,17517,13529,31046
JAMBI,TANJUNG JABUNG BARAT,KUALA BETARA,3531,3124,6655
JAMBI,MUARO JAMBI,KUMPEH,5559,6227,11786
JAMBI,TANJUNG JABUNG BARAT,TEBING TINGGI,8607,6973,15580
JAMBI,MUARO JAMBI,SEKERNAN,8551,13151,21702
JAMBI,MUARO JAMBI,SUNGAI BAHAR,5289,8710,13999
JAMBI,MUARO JAMBI,MESTONG,7528,13695,21223
JAMBI,TANJUNG JABUNG BARAT,SENYERANG,5288,6593,11881
JAMBI,MUARO JAMBI,MARO SEBO,5282,5638,10920
JAMBI,TANJUNG JABUNG BARAT,TUNGKAL ULU,2737,4201,6938
JAMBI,TANJUNG JABUNG BARAT,TUNGKAL ULU,2737,4201,6938
JAMBI,TANJUNG JABUNG TIMUR,KUALA JAMBI,3044,4451,7495
JAMBI,TANJUNG JABUNG BARAT,TUNGKAL ILIR,16516,15705,32221
JAMBI,TANJUNG JABUNG BARAT,MERLUNG,3325,4559,7884
JAMBI,TANJUNG JABUNG TIMUR,MENDAHARA,5514,8133,13647
JAMBI,TANJUNG JABUNG BARAT,BRAM ITAM,3788,4532,8320
JAMBI,TANJUNG JABUNG BARAT,MUARA PAPALIK,2234,3363,5597
JAMBI,TANJUNG JABUNG BARAT,BATANG ASAM,4154,9031,13185
JAMBI,TANJUNG JABUNG BARAT,SEBERANG KOTA,1896,2316,4212
JAMBI,TANJUNG JABUNG BARAT,PENGABUAN,5332,7031,12363
JAMBI,TANJUNG JABUNG BARAT,RENAH MENDALUH,2281,3957,6238
JAMBI,TANJUNG JABUNG TIMUR,GERAGAI,4448,8985,13433
JAMBI,TANJUNG JABUNG TIMUR,MENDAHARA ULU,2975,5247,8222
JAMBI,BUNGO,TANAH SEPENGGAL LINTAS,5988,7546,13534
JAMBI,TANJUNG JABUNG BARAT,BETARA,4117,7705,11822
JAMBI,BUNGO,TANAH TUMBUH,3162,5439,8601
JAMBI,BUNGO,BATHIN II PELAYANG,888,3187,4075
JAMBI,TANJUNG JABUNG TIMUR,DENDANG,3014,6001,9015
JAMBI,BUNGO,BUNGO DANI,8162,4587,12749
JAMBI,TANJUNG JABUNG TIMUR,MUARA SABAK TIMUR,5789,11453,17242
JAMBI,TANJUNG JABUNG TIMUR,MUARA SABAK BARAT,3610,5136,8746
JAMBI,TANJUNG JABUNG TIMUR,BERBAK,2056,2864,4920
JAMBI,TANJUNG JABUNG TIMUR,NIPAH PANJANG,5961,7281,13242
JAMBI,TANJUNG JABUNG TIMUR,S A D U,3519,4079,7598
JAMBI,TANJUNG JABUNG TIMUR,RANTAU RASAU,4989,7801,12790
JAMBI,BUNGO,PELEPAT ILIR,11089,15057,26146
JAMBI,BUNGO,LIMBUR LUBUK MENGKUANG,8303,1842,10145
JAMBI,BUNGO,BATHIN III ULU,1919,2437,4356
JAMBI,BUNGO,JUJUHAN,4596,4038,8634
JAMBI,TEBO,TEBO TENGAH,9219,9931,19150
JAMBI,BUNGO,TANAH SEPENGGAL,5289,7291,12580
JAMBI,BUNGO,RANTAU PANDAN,2998,2670,5668
JAMBI,TEBO,VII KOTO ILIR,2210,5414,7624
JAMBI,TEBO,TEBO ULU,6341,9787,16128
JAMBI,TEBO,RIMBO ULU,7310,14933,22243
JAMBI,BUNGO,RIMBO TENGAH,7962,4803,12765
JAMBI,BUNGO,BATIN II BABEKO,2382,3401,5783
JAMBI,BUNGO,BATHIN III,6653,4369,11022
JAMBI,TEBO,RIMBO BUJANG,14800,20051,34851
JAMBI,BUNGO,JUJUHAN ILIR,2762,3306,6068
JAMBI,BUNGO,PASAR MUARO BUNGO,7609,3796,11405
JAMBI,TEBO,MUARA TABIR,2795,5570,8365
JAMBI,KOTA JAMBI,PELAYANGAN,4581,2503,7084
JAMBI,BUNGO,PELEPAT,6234,10849,17083
JAMBI,KOTA JAMBI,DANAU TELUK,4582,2183,6765
JAMBI,TEBO,SUMAY,2946,7022,9968
JAMBI,TEBO,TENGAH ILIR,3432,9269,12701
JAMBI,KOTA JAMBI,JAMBI SELATAN,33531,35684,69215
JAMBI,TEBO,SERAI SERUMPUN,1502,3127,4629
JAMBI,KOTA JAMBI,TELANAIPURA,29777,20088,49865
JAMBI,TEBO,VII KOTO,3587,6576,10163
JAMBI,TEBO,TEBO ILIR,6215,8066,14281
JAMBI,TEBO,RIMBO ILIR,5815,8805,14620
JAMBI,KOTA JAMBI,KOTA BARU,43981,37230,81211
JAMBI,KOTA JAMBI,JELUTUNG,16369,16868,33237
JAMBI,KOTA JAMBI,JAMBI TIMUR,19590,24911,44501
SUMATERA SELATAN,OGAN KOMERING ULU,SOSOH BUAY RAYAP,3951,2281,6232
SUMATERA SELATAN,OGAN KOMERING ULU,SINAR PENINJAUAN,6014,6294,12308
JAMBI,KOTA SUNGAI PENUH,SUNGAIBUNGKAL,3837,1278,5115
JAMBI,KOTA SUNGAI PENUH,SUNGAIPENUH,3731,1303,5034
JAMBI,KOTA JAMBI,PASAR JAMBI,3149,3502,6651
JAMBI,KOTA SUNGAI PENUH,TANAH KAMPUNG,3185,1254,4439
JAMBI,KOTA SUNGAI PENUH,HAMPARAN RAWANG,7057,1294,8351
JAMBI,KOTA SUNGAI PENUH,PONDOK TINGGI,6970,1819,8789
JAMBI,KOTA SUNGAI PENUH,PESISIR BUKIT,5100,1055,6155
JAMBI,KOTA SUNGAI PENUH,KOTO BARU,3139,694,3833
SUMATERA SELATAN,OGAN KOMERING ILIR,TELUK GELAM,0,0,0
SUMATERA SELATAN,OGAN KOMERING ULU,PENINJAUAN,13074,9287,22361
JAMBI,KOTA SUNGAI PENUH,KUMUN DEBAI,3362,1858,5220
SUMATERA SELATAN,OGAN KOMERING ULU,LENGKITI,7282,4320,11602
SUMATERA SELATAN,OGAN KOMERING ULU,BATURAJA BARAT,11318,7105,18423
SUMATERA SELATAN,OGAN KOMERING ULU,SEMIDANG AJI,7504,3824,11328
SUMATERA SELATAN,OGAN KOMERING ULU,ULU OGAN,3309,770,4079
SUMATERA SELATAN,OGAN KOMERING ILIR,MESUJI MAKMUR,0,0,0
SUMATERA SELATAN,OGAN KOMERING ILIR,CENGAL,0,0,0
SUMATERA SELATAN,OGAN KOMERING ULU,BATURAJA TIMUR,30403,16271,46674
SUMATERA SELATAN,OGAN KOMERING ULU,PENGANDONAN,3286,1327,4613
SUMATERA SELATAN,OGAN KOMERING ILIR,SUNGAI MENANG,0,0,0
SUMATERA SELATAN,OGAN KOMERING ULU,LUBUK BATANG,9919,5519,15438
SUMATERA SELATAN,OGAN KOMERING ILIR,PANGKALAN LAMPAM,0,0,0
SUMATERA SELATAN,OGAN KOMERING ILIR,LEMPUING JAYA,0,0,0
SUMATERA SELATAN,OGAN KOMERING ULU,MUARA JAYA,2288,664,2952
SUMATERA SELATAN,OGAN KOMERING ILIR,MESUJI RAYA,0,0,0
SUMATERA SELATAN,OGAN KOMERING ILIR,PEDAMARAN,0,0,0
SUMATERA SELATAN,OGAN KOMERING ILIR,LEMPUING,0,0,0
SUMATERA SELATAN,OGAN KOMERING ILIR,PAMPANGAN,0,0,0
SUMATERA SELATAN,OGAN KOMERING ULU,LUBUK RAJA,10299,6810,17109
SUMATERA SELATAN,OGAN KOMERING ILIR,MESUJI,0,0,0
SUMATERA SELATAN,OGAN KOMERING ILIR,JEJAWI,0,0,0
SUMATERA SELATAN,OGAN KOMERING ILIR,TANJUNG LUBUK,0,0,0
SUMATERA SELATAN,OGAN KOMERING ILIR,SIRAH PULAU PADANG,0,0,0
SUMATERA SELATAN,MUARA ENIM,RAMBANG,0,0,0
SUMATERA SELATAN,MUARA ENIM,TANJUNG AGUNG,0,0,0
SUMATERA SELATAN,MUARA ENIM,BENAKAT,0,0,0
SUMATERA SELATAN,MUARA ENIM,KELEKAR,0,0,0
SUMATERA SELATAN,MUARA ENIM,PENUKAL UTARA,0,0,0
SUMATERA SELATAN,OGAN KOMERING ILIR,PEDAMARAN TIMUR,0,0,0
SUMATERA SELATAN,OGAN KOMERING ILIR,AIR SUGIHAN,0,0,0
SUMATERA SELATAN,OGAN KOMERING ILIR,TULUNG SELAPAN,0,0,0
SUMATERA SELATAN,MUARA ENIM,MUARA BELIDA,0,0,0
SUMATERA SELATAN,OGAN KOMERING ILIR,KAYU AGUNG,0,0,0
SUMATERA SELATAN,MUARA ENIM,LAWANG KIDUL,0,0,0
SUMATERA SELATAN,MUARA ENIM,BELIMBING,0,0,0
SUMATERA SELATAN,MUARA ENIM,SUNGAI ROTAN,0,0,0
SUMATERA SELATAN,MUARA ENIM,ABAB,0,0,0
SUMATERA SELATAN,MUARA ENIM,RAMBANG DANGKU,0,0,0
SUMATERA SELATAN,MUARA ENIM,LEMBAK,0,0,0
SUMATERA SELATAN,MUARA ENIM,SEMENDE DARAT TENGAH,0,0,0
SUMATERA SELATAN,MUARA ENIM,GELUMBANG,0,0,0
SUMATERA SELATAN,MUARA ENIM,SEMENDE DARAT LAUT,0,0,0
SUMATERA SELATAN,MUARA ENIM,MUARA ENIM,0,0,0
SUMATERA SELATAN,MUARA ENIM,GUNUNG MEGANG,0,0,0
SUMATERA SELATAN,MUARA ENIM,TALANG UBI,0,0,0
SUMATERA SELATAN,MUARA ENIM,TANAH ABANG,0,0,0
SUMATERA SELATAN,MUARA ENIM,BELINDA DARAT,0,0,0
SUMATERA SELATAN,MUARA ENIM,LUBAI,0,0,0
SUMATERA SELATAN,MUARA ENIM,PENUKAL,0,0,0
SUMATERA SELATAN,LAHAT,TANJUNG SAKTI PUMI,0,0,0
SUMATERA SELATAN,LAHAT,TANJUNGSAKTI PUMU,0,0,0
SUMATERA SELATAN,MUARA ENIM,SEMENDE DARAT ULU,0,0,0
SUMATERA SELATAN,LAHAT,GUMAY ULU,0,0,0
SUMATERA SELATAN,LAHAT,TANJUNGTEBAT,0,0,0
SUMATERA SELATAN,LAHAT,PSEKSU,0,0,0
SUMATERA SELATAN,LAHAT,LAHAT,0,0,0
SUMATERA SELATAN,LAHAT,MUARAPAYANG,0,0,0
SUMATERA SELATAN,MUARA ENIM,UJAN MAS,0,0,0
SUMATERA SELATAN,LAHAT,KIKIM BARAT,0,0,0
SUMATERA SELATAN,LAHAT,KIKIM TENGAH,0,0,0
SUMATERA SELATAN,LAHAT,KIKIM SELATAN,0,0,0
SUMATERA SELATAN,MUARA ENIM,LUBAI ULU,0,0,0
SUMATERA SELATAN,LAHAT,GUMAY TALANG,0,0,0
SUMATERA SELATAN,LAHAT,PULAUPINANG,0,0,0
SUMATERA SELATAN,LAHAT,MERAPI SELATAN,0,0,0
SUMATERA SELATAN,LAHAT,PAGAR GUNUNG,0,0,0
SUMATERA SELATAN,LAHAT,KIKIM TIMUR,0,0,0
SUMATERA SELATAN,MUSI RAWAS,NIBUNG,0,0,0
SUMATERA SELATAN,LAHAT,MERAPI TIMUR,0,0,0
SUMATERA SELATAN,LAHAT,JARAI,0,0,0
SUMATERA SELATAN,LAHAT,MULAK ULU,0,0,0
SUMATERA SELATAN,MUSI RAWAS,TUAH NEGERI,0,0,0
SUMATERA SELATAN,LAHAT,KOTA AGUNG,0,0,0
SUMATERA SELATAN,MUSI RAWAS,SUMBER HARTA,0,0,0
SUMATERA SELATAN,MUSI RAWAS,TIANG PUMPUNG KEPUNGUT,0,0,0
SUMATERA SELATAN,MUSI RAWAS,MUARA LAKITAN,0,0,0
SUMATERA SELATAN,MUSI RAWAS,KARANG DAPO,0,0,0
SUMATERA SELATAN,LAHAT,PAJAR BULAN,0,0,0
SUMATERA SELATAN,MUSI RAWAS,PURWODADI,0,0,0
SUMATERA SELATAN,LAHAT,MERAPI BARAT,0,0,0
SUMATERA SELATAN,MUSI RAWAS,SELANGIT,0,0,0
SUMATERA SELATAN,MUSI RAWAS,MEGANG SAKTI,0,0,0
SUMATERA SELATAN,MUSI RAWAS,JAYALOKA,0,0,0
SUMATERA SELATAN,MUSI RAWAS,RAWAS ULU,0,0,0
SUMATERA SELATAN,MUSI RAWAS,KARANG JAYA,0,0,0
SUMATERA SELATAN,MUSI BANYUASIN,SEKAYU,20267,17999,38266
SUMATERA SELATAN,MUSI RAWAS,RAWAS ILIR,0,0,0
SUMATERA SELATAN,MUSI RAWAS,TUGUMULYO,0,0,0
SUMATERA SELATAN,MUSI BANYUASIN,TUNGKAL JAYA,0,0,0
SUMATERA SELATAN,LAHAT,SUKAMERINDU,0,0,0
SUMATERA SELATAN,MUSI RAWAS,MUARA KELINGI,0,0,0
SUMATERA SELATAN,MUSI RAWAS,STL ULU TERAWAS,0,0,0
SUMATERA SELATAN,MUSI RAWAS,MUARA BELITI,0,0,0
SUMATERA SELATAN,MUSI RAWAS,ULU RAWAS,0,0,0
SUMATERA SELATAN,MUSI BANYUASIN,LALAN,0,0,0
SUMATERA SELATAN,BANYUASIN,SEMBAWA,10371,6633,17004
SUMATERA SELATAN,MUSI BANYUASIN,LAWANG WETAN,4725,6979,11704
SUMATERA SELATAN,MUSI BANYUASIN,BAYUNG LENCIR,0,0,0
SUMATERA SELATAN,MUSI RAWAS,RUPIT,0,0,0
SUMATERA SELATAN,MUSI BANYUASIN,BABAT TOMAN,6874,9482,16356
SUMATERA SELATAN,MUSI BANYUASIN,BATANG HARI LEKO,0,0,0
SUMATERA SELATAN,MUSI BANYUASIN,PLAKAT TINGGI,0,0,0
SUMATERA SELATAN,MUSI RAWAS,SUKA KARYA,0,0,0
SUMATERA SELATAN,BANYUASIN,BANYUASIN I,14114,13552,27666
SUMATERA SELATAN,BANYUASIN,SUAK TAPEH,6057,3414,9471
SUMATERA SELATAN,MUSI BANYUASIN,SUNGAI LILIN,0,0,0
SUMATERA SELATAN,MUSI BANYUASIN,SANGA DESA,0,0,0
SUMATERA SELATAN,MUSI BANYUASIN,BABAT SUPAT,0,0,0
SUMATERA SELATAN,MUSI BANYUASIN,KELUANG,7653,9078,16731
SUMATERA SELATAN,MUSI BANYUASIN,SUNGAI KERUH,0,0,0
SUMATERA SELATAN,BANYUASIN,TANJUNG LAGO,7175,12596,19771
SUMATERA SELATAN,BANYUASIN,MUARA SUGIHAN,8365,14268,22633
SUMATERA SELATAN,MUSI BANYUASIN,LAIS,0,0,0
SUMATERA SELATAN,BANYUASIN,RAMBUTAN,11080,10913,21993
SUMATERA SELATAN,BANYUASIN,MUARA PADANG,5059,10856,15915
SUMATERA SELATAN,BANYUASIN,SUMBER MARGA TELANG,5701,6002,11703
SUMATERA SELATAN,BANYUASIN,BETUNG,13961,12304,26265
SUMATERA SELATAN,BANYUASIN,AIR SALEK,5476,13113,18589
SUMATERA SELATAN,BANYUASIN,PULAU RIMAU,7831,14483,22314
SUMATERA SELATAN,BANYUASIN,RANTAU BAYUR,11553,10119,21672
SUMATERA SELATAN,OGAN KOMERING ULU TIMUR,MARTAPURA,18924,8413,27337
SUMATERA SELATAN,BANYUASIN,BANYUASIN III,19371,14466,33837
SUMATERA SELATAN,BANYUASIN,TUNGKAL ILIR,6315,8380,14695
SUMATERA SELATAN,BANYUASIN,MUARA TELANG,8231,12020,20251
SUMATERA SELATAN,BANYUASIN,MAKARTI JAYA,5696,8327,14023
SUMATERA SELATAN,OGAN KOMERING ULU TIMUR,BELITANG JAYA,5685,6716,12401
SUMATERA SELATAN,BANYUASIN,TALANG KELAPA,32924,30737,63661
SUMATERA SELATAN,OGAN KOMERING ULU TIMUR,BELITANG MADANG RAYA,15858,8806,24664
SUMATERA SELATAN,OGAN KOMERING ULU TIMUR,SEMENDAWAI TIMUR,8709,11847,20556
SUMATERA SELATAN,OGAN KOMERING ULU TIMUR,MADANG SUKU II,11062,6549,17611
SUMATERA SELATAN,OGAN KOMERING ULU TIMUR,SEMENDAWAI BARAT,6071,4489,10560
SUMATERA SELATAN,OGAN KOMERING ULU TIMUR,BUAY MADANG TIMUR,25069,10296,35365
SUMATERA SELATAN,BANYUASIN,BANYUASIN II,6299,13648,19947
SUMATERA SELATAN,OGAN KOMERING ULU TIMUR,JAYAPURA,3653,4309,7962
SUMATERA SELATAN,OGAN KOMERING ULU SELATAN,MUARA DUA,0,0,0
SUMATERA SELATAN,OGAN KOMERING ULU TIMUR,BUAY PEMUKA PELIUNG,12516,7643,20159
SUMATERA SELATAN,OGAN KOMERING ULU TIMUR,BELITANG MULYA,7336,5088,12424
SUMATERA SELATAN,OGAN KOMERING ULU TIMUR,BELITANG,20440,10959,31399
SUMATERA SELATAN,BANYUASIN,AIR KUMBANG,4359,8278,12637
SUMATERA SELATAN,OGAN KOMERING ULU TIMUR,SEMENDAWAI SUKU III,11753,10914,22667
SUMATERA SELATAN,OGAN KOMERING ULU SELATAN,RUNJUNG AGUNG,4181,2091,6272
SUMATERA SELATAN,OGAN KOMERING ULU SELATAN,BUAY PEMATANG RIBU RANAU TENGAH,6485,5499,11984
SUMATERA SELATAN,OGAN KOMERING ULU TIMUR,MADANG SUKU III,7916,6924,14840
SUMATERA SELATAN,OGAN KOMERING ULU TIMUR,BUNGA MAYANG,5155,3579,8734
SUMATERA SELATAN,OGAN KOMERING ULU TIMUR,BELITANG II,11681,13684,25365
SUMATERA SELATAN,OGAN KOMERING ULU SELATAN,TIGA DIHAJI,3396,1930,5326
SUMATERA SELATAN,OGAN KOMERING ULU SELATAN,WARKUK RANAU SELATAN,6058,5819,11877
SUMATERA SELATAN,OGAN KOMERING ULU TIMUR,BELITANG III,11159,10420,21579
SUMATERA SELATAN,OGAN KOMERING ULU TIMUR,CEMPAKA,8171,5818,13989
SUMATERA SELATAN,OGAN KOMERING ULU TIMUR,MADANG SUKU I,12164,8339,20503
SUMATERA SELATAN,OGAN KOMERING ULU TIMUR,BUAY MADANG,16800,5633,22433
SUMATERA SELATAN,OGAN KOMERING ULU SELATAN,BUANA PEMACA,3712,2744,6456
SUMATERA SELATAN,OGAN KOMERING ULU SELATAN,BUAY RUNJUNG,3940,2317,6257
SUMATERA SELATAN,OGAN KOMERING ULU SELATAN,SUNGAI ARE,3608,2317,5925
SUMATERA SELATAN,OGAN KOMERING ULU SELATAN,SIMPANG,3537,3024,6561
SUMATERA SELATAN,OGAN KOMERING ULU SELATAN,MUARA DUA KISAM,6595,2837,9432
SUMATERA SELATAN,OGAN KOMERING ULU TIMUR,BUAY PEMUKA BANGSA RAJA,5242,1877,7119
SUMATERA SELATAN,OGAN KOMERING ULU SELATAN,BUAY RAWAN,4132,3158,7290
SUMATERA SELATAN,OGAN KOMERING ULU SELATAN,MEKAKAU ILIR,6229,4923,11152
SUMATERA SELATAN,OGAN ILIR,LUBUK KELIAT,0,0,0
SUMATERA SELATAN,OGAN KOMERING ULU SELATAN,BANDING AGUNG,6327,5185,11512
SUMATERA SELATAN,OGAN KOMERING ULU SELATAN,SINDANG DANAU,4075,1615,5690
SUMATERA SELATAN,OGAN KOMERING ULU SELATAN,KISAM ILIR,2621,1505,4126
SUMATERA SELATAN,OGAN ILIR,SUNGAI PINANG,0,0,0
SUMATERA SELATAN,OGAN KOMERING ULU SELATAN,BUAY PEMACA,10388,11000,21388
SUMATERA SELATAN,OGAN KOMERING ULU SELATAN,BUAY SANDANG AJI,5879,3163,9042
SUMATERA SELATAN,OGAN KOMERING ULU SELATAN,PULAU BERINGIN,8505,5917,14422
SUMATERA SELATAN,OGAN KOMERING ULU SELATAN,KISAM TINGGI,7281,3865,11146
SUMATERA SELATAN,OGAN ILIR,PEMULUTAN SELATAN,0,0,0
SUMATERA SELATAN,OGAN ILIR,PEMULUTAN BARAT,0,0,0
SUMATERA SELATAN,OGAN ILIR,INDRALAYA SELATAN,5797,5465,11262
SUMATERA SELATAN,OGAN ILIR,TANJUNG BATU,13131,10764,23895
SUMATERA SELATAN,OGAN ILIR,PAYARAMAN,0,0,0
SUMATERA SELATAN,OGAN ILIR,MUARA KUANG,0,0,0
SUMATERA SELATAN,EMPAT LAWANG,PASEMAH AIR KERUH,0,0,0
SUMATERA SELATAN,EMPAT LAWANG,SALING,0,0,0
SUMATERA SELATAN,EMPAT LAWANG,TALANG PADANG,0,0,0
SUMATERA SELATAN,EMPAT LAWANG,LINTANG KANAN,0,0,0
SUMATERA SELATAN,OGAN ILIR,KANDIS,0,0,0
SUMATERA SELATAN,OGAN ILIR,RANTAU PANJANG,0,0,0
SUMATERA SELATAN,OGAN ILIR,TANJUNG RAJA,0,0,0
SUMATERA SELATAN,OGAN ILIR,RAMBANG KUANG,0,0,0
SUMATERA SELATAN,OGAN ILIR,PEMULUTAN,0,0,0
SUMATERA SELATAN,OGAN ILIR,INDRALAYA,10312,8945,19257
SUMATERA SELATAN,EMPAT LAWANG,SIKAP DALAM,0,0,0
SUMATERA SELATAN,EMPAT LAWANG,TEBING TINGGI,0,0,0
SUMATERA SELATAN,OGAN ILIR,RANTAU ALAI,0,0,0
SUMATERA SELATAN,EMPAT LAWANG,PENDOPO BARAT,0,0,0
SUMATERA SELATAN,OGAN ILIR,INDRALAYA UTARA,0,0,0
SUMATERA SELATAN,KOTA PALEMBANG,KERTAPATI,23192,20737,43929
SUMATERA SELATAN,KOTA PALEMBANG,ILIR BARAT I,37846,30192,68038
SUMATERA SELATAN,EMPAT LAWANG,MUARA PINANG,0,0,0
SUMATERA SELATAN,KOTA PALEMBANG,PLAJU,24482,21746,46228
SUMATERA SELATAN,KOTA PALEMBANG,ILIR TIMUR I,14921,23998,38919
SUMATERA SELATAN,EMPAT LAWANG,ULU MUSI,0,0,0
SUMATERA SELATAN,KOTA PALEMBANG,KALIDONI,0,0,0
SUMATERA SELATAN,KOTA PALEMBANG,SUKARAMI,37593,36794,74387
SUMATERA SELATAN,KOTA PALEMBANG,BUKIT KECIL,11929,9431,21360
SUMATERA SELATAN,KOTA PALEMBANG,SAKO,0,0,0
SUMATERA SELATAN,KOTA PALEMBANG,SEBERANG ULU II,25990,22029,48019
SUMATERA SELATAN,KOTA PALEMBANG,ILIR BARAT II,0,0,0
SUMATERA SELATAN,KOTA PALEMBANG,GANDUS,17009,13804,30813
SUMATERA SELATAN,EMPAT LAWANG,PENDOPO,0,0,0
SUMATERA SELATAN,KOTA PALEMBANG,KEMUNING,22231,20596,42827
SUMATERA SELATAN,KOTA LUBUKLINGGAU,LUBUK LINGGAU BARAT I,9041,6624,15665
SUMATERA SELATAN,KOTA PAGAR ALAM,PAGAR ALAM SELATAN,12743,11880,24623
SUMATERA SELATAN,KOTA PALEMBANG,ILIR TIMUR II,44260,41162,85422
SUMATERA SELATAN,KOTA PALEMBANG,SEMATANG BORANG,10095,9480,19575
SUMATERA SELATAN,KOTA PALEMBANG,SEBERANG ULU I,43087,40138,83225
SUMATERA SELATAN,KOTA LUBUKLINGGAU,LUBUK LINGGAU TIMUR I,9128,5781,14909
SUMATERA SELATAN,KOTA PAGAR ALAM,DEMPO SELATAN,0,0,0
SUMATERA SELATAN,KOTA PAGAR ALAM,DEMPO UTARA,0,0,0
SUMATERA SELATAN,KOTA PAGAR ALAM,DEMPO TENGAH,3982,3741,7723
SUMATERA SELATAN,KOTA PRABUMULIH,PRABUMULIH SELATAN,0,0,0
SUMATERA SELATAN,KOTA PAGAR ALAM,PAGAR ALAM UTARA,10883,9697,20580
SUMATERA SELATAN,KOTA PRABUMULIH,PRABUMULIH TIMUR,0,0,0
SUMATERA SELATAN,KOTA PRABUMULIH,CAMBAI,0,0,0
BENGKULU,BENGKULU SELATAN,KEDURANG,2269,3389,5658
SUMATERA SELATAN,KOTA LUBUKLINGGAU,LUBUK LINGGAU SELATAN I,4140,3578,7718
SUMATERA SELATAN,KOTA PRABUMULIH,PRABUMULIH BARAT,0,0,0
SUMATERA SELATAN,KOTA LUBUKLINGGAU,LUBUK LINGGAU UTARA I,3219,5172,8391
SUMATERA SELATAN,KOTA LUBUKLINGGAU,LUBUK LINGGAU UTARA II,8457,8323,16780
BENGKULU,BENGKULU SELATAN,KEDURANG ILIR,1163,2962,4125
SUMATERA SELATAN,KOTA LUBUKLINGGAU,LUBUK LINGGAU TIMUR II,7461,8773,16234
BENGKULU,BENGKULU SELATAN,SEGINIM,2195,5529,7724
BENGKULU,BENGKULU SELATAN,KOTA MANNA,7696,6787,14483
BENGKULU,BENGKULU SELATAN,PASAR MANNA,5237,3726,8963
SUMATERA SELATAN,KOTA LUBUKLINGGAU,LUBUK LINGGAU BARAT II,6145,5141,11286
SUMATERA SELATAN,KOTA LUBUKLINGGAU,LUBUK LINGGAU SELATAN II,8213,6481,14694
BENGKULU,BENGKULU SELATAN,MANNA,3045,3989,7034
BENGKULU,BENGKULU SELATAN,PINO RAYA,2893,6548,9441
BENGKULU,BENGKULU SELATAN,AIR NIPIS,1575,3472,5047
SUMATERA SELATAN,KOTA PRABUMULIH,RAMBANG KPK TENGAH,0,0,0
BENGKULU,REJANG LEBONG,KOTA PADANG,2936,2311,5247
BENGKULU,REJANG LEBONG,CURUP SELATAN,6994,3052,10046
SUMATERA SELATAN,KOTA PRABUMULIH,PRABUMULIH UTARA,0,0,0
BENGKULU,BENGKULU SELATAN,BUNGA MAS,1175,2145,3320
BENGKULU,REJANG LEBONG,SINDANG KELINGI,3968,4448,8416
BENGKULU,REJANG LEBONG,CURUP UTARA,4986,3406,8392
BENGKULU,BENGKULU SELATAN,PINO,2357,3805,6162
BENGKULU,BENGKULU SELATAN,ULU MANNA,1549,2612,4161
BENGKULU,BENGKULU UTARA,HULU PALIK,2153,3535,5688
BENGKULU,REJANG LEBONG,SINDANG DATARAN,2372,3168,5540
BENGKULU,BENGKULU UTARA,ENGGANO,353,1119,1472
BENGKULU,REJANG LEBONG,SELUPU REJANG,8279,7672,15951
BENGKULU,REJANG LEBONG,PADANG ULAK TANDING,4389,5104,9493
BENGKULU,REJANG LEBONG,BERMANI ULU,3445,3253,6698
BENGKULU,REJANG LEBONG,CURUP TENGAH,10518,6393,16911
BENGKULU,REJANG LEBONG,SINDANG BELITI ILIR,2523,1889,4412
BENGKULU,BENGKULU UTARA,ARMA JAYA,2495,3498,5993
BENGKULU,REJANG LEBONG,CURUP TIMUR,6122,4478,10600
BENGKULU,REJANG LEBONG,BINDURIANG,2024,2934,4958
BENGKULU,BENGKULU UTARA,ULOK KUPAI,2321,3735,6056
BENGKULU,REJANG LEBONG,CURUP,9087,5179,14266
BENGKULU,REJANG LEBONG,SINDANG BELITI ULU,3196,2775,5971
BENGKULU,BENGKULU UTARA,AIR BESI,1836,3124,4960
BENGKULU,BENGKULU UTARA,AIR NAPAL,2130,3141,5271
BENGKULU,BENGKULU UTARA,AIR PADANG,1053,2189,3242
BENGKULU,BENGKULU UTARA,BATIK NAU,1904,5531,7435
BENGKULU,REJANG LEBONG,BERMANI ULU RAYA,2640,3001,5641
BENGKULU,BENGKULU UTARA,KERKAP,2733,3738,6471
BENGKULU,BENGKULU UTARA,NAPAL PUTIH,1468,2589,4057
BENGKULU,KAUR,LUAS,1594,1476,3070
BENGKULU,BENGKULU UTARA,PADANG JAYA,6005,10204,16209
BENGKULU,KAUR,TETAP,1648,2213,3861
BENGKULU,BENGKULU UTARA,ARGA MAKMUR,10570,9445,20015
BENGKULU,BENGKULU UTARA,KETAHUN,7423,16588,24011
BENGKULU,KAUR,KINAL,1295,1452,2747
BENGKULU,BENGKULU UTARA,TANJUNGAGUNG PALIK,1617,2626,4243
BENGKULU,KAUR,NASAL,2242,5688,7930
BENGKULU,BENGKULU UTARA,LAIS,2630,4121,6751
BENGKULU,KAUR,KAUR TENGAH,1791,1031,2822
BENGKULU,KAUR,KELAM TENGAH,1477,1930,3407
BENGKULU,KAUR,TANJUNG KEMUNING,2047,3866,5913
BENGKULU,SELUMA,ULU TALO,1116,2004,3120
BENGKULU,BENGKULU UTARA,PUTRI HIJAU,6189,14071,20260
BENGKULU,KAUR,SEMIDANG GUMAY,1509,1902,3411
BENGKULU,KAUR,LUNGKANG KULE,848,884,1732
BENGKULU,SELUMA,TALO KECIL,1975,2843,4818
BENGKULU,KAUR,PADANG GUCI HILIR,774,1176,1950
BENGKULU,SELUMA,SELUMA BARAT,1653,3074,4727
BENGKULU,BENGKULU UTARA,GIRI MULYA,2545,6080,8625
BENGKULU,KAUR,MUARA SAHUNG,1405,2251,3656
BENGKULU,KAUR,MAJE,2040,5192,7232
BENGKULU,SELUMA,AIR PERIUKAN,3396,8103,11499
BENGKULU,SELUMA,SEMIDANG ALAS MARAS,4585,6452,11037
BENGKULU,MUKOMUKO,LUBUK PINANG,2938,3605,6543
BENGKULU,MUKOMUKO,AIR DIKIT,1341,1969,3310
BENGKULU,SELUMA,TALO,3001,2607,5608
BENGKULU,KAUR,KAUR UTARA,1593,1757,3350
BENGKULU,SELUMA,SELUMA SELATAN,2511,3843,6354
BENGKULU,SELUMA,LUBUK SANDI,2958,3066,6024
BENGKULU,KAUR,KAUR SELATAN,4352,4152,8504
BENGKULU,SELUMA,SELUMA TIMUR,2398,2652,5050
BENGKULU,KAUR,PADANG GUCI HULU,1630,1486,3116
BENGKULU,SELUMA,SUKARAJA,5255,11794,17049
BENGKULU,SELUMA,SELUMA UTARA,3101,2237,5338
BENGKULU,SELUMA,SELUMA,2107,2253,4360
BENGKULU,SELUMA,SEMIDANG ALAS,2385,4503,6888
BENGKULU,MUKOMUKO,IPUH,4599,3303,7902
BENGKULU,MUKOMUKO,KOTA MUKOMUKO,4087,3800,7887
BENGKULU,MUKOMUKO,SELAGAN RAYA,1587,2072,3659
BENGKULU,SELUMA,ILIR TALO,3446,4100,7546
BENGKULU,LEBONG,AMEN,1926,2189,4115
BENGKULU,LEBONG,RIMBO PENGADANG,1015,1395,2410
BENGKULU,MUKOMUKO,AIR RAMI,2532,3746,6278
BENGKULU,MUKOMUKO,TERAMANG JAYA,2115,3210,5325
BENGKULU,MUKOMUKO,PONDOK SUGUH,2448,2910,5358
BENGKULU,MUKOMUKO,AIR MAJUNTO,1735,4048,5783
BENGKULU,MUKOMUKO,V KOTO,1560,1682,3242
BENGKULU,LEBONG,BINGIN KUNING,2134,3030,5164
BENGKULU,LEBONG,PELABAI,1106,1841,2947
BENGKULU,MUKOMUKO,MALIN DEMAN,1470,1569,3039
BENGKULU,LEBONG,URAM JAYA,1497,1342,2839
BENGKULU,MUKOMUKO,XIV KOTO,2269,3886,6155
BENGKULU,LEBONG,LEBONG UTARA,3685,4223,7908
BENGKULU,MUKOMUKO,PENARIK,3657,8469,12126
BENGKULU,LEBONG,LEBONG SAKTI,2144,2533,4677
BENGKULU,LEBONG,LEBONG TENGAH,2062,2699,4761
BENGKULU,LEBONG,LEBONG ATAS,1292,3201,4493
BENGKULU,LEBONG,LEBONG SELATAN,2948,4071,7019
BENGKULU,MUKOMUKO,SUNGAI RUMBAI,1409,2936,4345
BENGKULU,MUKOMUKO,TERAS TERUNJAM,1292,2426,3718
BENGKULU,BENGKULU TENGAH,MERIGI KELINDANG,1939,1992,3931
BENGKULU,LEBONG,TOPOS,2179,1273,3452
BENGKULU,KEPAHIANG,SEBERANG MUSI,1848,2038,3886
BENGKULU,BENGKULU TENGAH,TABA PENANJUNG,3001,3085,6086
BENGKULU,KEPAHIANG,KEBAWETAN,2751,4037,6788
BENGKULU,BENGKULU TENGAH,KARANG TINGGI,3222,4033,7255
BENGKULU,KEPAHIANG,TEBAT KARAI,3908,2894,6802
BENGKULU,KEPAHIANG,UJAN MAS,5854,4247,10101
BENGKULU,BENGKULU TENGAH,PONDOK KUBANG,1887,3093,4980
BENGKULU,KEPAHIANG,MERIGI,3112,2074,5186
BENGKULU,LEBONG,PINANG BELAPIS,947,1572,2519
BENGKULU,BENGKULU TENGAH,MERIGI SAKTI,1680,1577,3257
BENGKULU,KOTA BENGKULU,MUARA BANGKA HULU,8978,9713,18691
BENGKULU,KEPAHIANG,KEPAHIANG,11782,8776,20558
BENGKULU,BENGKULU TENGAH,TALANG EMPAT,2864,5044,7908
BENGKULU,KEPAHIANG,BERMANI ILIR,4707,3749,8456
BENGKULU,KOTA BENGKULU,TELUK SEGARA,6580,6028,12608
BENGKULU,KOTA BENGKULU,SINGARAN PATI,9676,10109,19785
BENGKULU,BENGKULU TENGAH,PAGAR JATI,2139,1495,3634
BENGKULU,KOTA BENGKULU,KAMPUNG MELAYU,5941,10124,16065
BENGKULU,BENGKULU TENGAH,PONDOK KELAPA,6299,9254,15553
LAMPUNG,LAMPUNG SELATAN,WAY SULAN,5586,5523,11109
BENGKULU,KEPAHIANG,MUARA KEMUMU,7875,4840,12715
BENGKULU,BENGKULU TENGAH,PEMATANG TIGA,1688,2119,3807
LAMPUNG,LAMPUNG SELATAN,NATAR,47475,48609,96084
LAMPUNG,LAMPUNG SELATAN,TANJUNG SARI,5253,11441,16694
BENGKULU,KOTA BENGKULU,RATU SAMBAN,6364,5628,11992
BENGKULU,KOTA BENGKULU,SUNGAI SERUT,5649,5477,11126
BENGKULU,KOTA BENGKULU,SELEBAR,13191,14343,27534
LAMPUNG,LAMPUNG SELATAN,PALAS,11593,18557,30150
BENGKULU,KOTA BENGKULU,GADING CEMPAKA,11391,9534,20925
BENGKULU,KOTA BENGKULU,RATU AGUNG,13362,12179,25541
LAMPUNG,LAMPUNG SELATAN,KETAPANG,9411,16970,26381
LAMPUNG,LAMPUNG SELATAN,BAKAUHENI,4849,6914,11763
BENGKULU,BENGKULU TENGAH,BANG HAJI,1321,1839,3160
LAMPUNG,LAMPUNG SELATAN,PENENGAHAN,12876,8009,20885
LAMPUNG,LAMPUNG SELATAN,CANDIPURO,10428,17781,28209
LAMPUNG,LAMPUNG SELATAN,JATI AGUNG,23310,39079,62389
LAMPUNG,LAMPUNG TENGAH,PUBIAN,0,0,0
LAMPUNG,LAMPUNG SELATAN,RAJA BASA,6766,5739,12505
LAMPUNG,LAMPUNG TENGAH,KALIREJO,0,0,0
LAMPUNG,LAMPUNG SELATAN,KATIBUNG,14360,19665,34025
LAMPUNG,LAMPUNG SELATAN,SRAGI,6015,10701,16716
LAMPUNG,LAMPUNG SELATAN,WAY PANJI,3043,6742,9785
LAMPUNG,LAMPUNG SELATAN,MERBAU MATARAM,11085,15336,26421
LAMPUNG,LAMPUNG TENGAH,KOTA GAJAH,0,0,0
LAMPUNG,LAMPUNG TENGAH,ANAK RATU AJI,4765,4801,9566
LAMPUNG,LAMPUNG TENGAH,SELAGAI LINGGA,6962,10519,17481
LAMPUNG,LAMPUNG SELATAN,TANJUNG BINTANG,18312,21523,39835
LAMPUNG,LAMPUNG TENGAH,PADANG RATU,11954,14615,26569
LAMPUNG,LAMPUNG SELATAN,SIDOMULYO,13677,17155,30832
LAMPUNG,LAMPUNG TENGAH,WAY PANGUBUAN,0,0,0
LAMPUNG,LAMPUNG TENGAH,BANDAR MATARAM,0,0,0
LAMPUNG,LAMPUNG SELATAN,KALIANDA,27326,18077,45403
LAMPUNG,LAMPUNG TENGAH,ANAK TUHA,9261,10591,19852
LAMPUNG,LAMPUNG TENGAH,WAY SEPUTIH,4372,5452,9824
LAMPUNG,LAMPUNG TENGAH,TERBANGGI BESAR,30702,28699,59401
LAMPUNG,LAMPUNG TENGAH,SEPUTIH AGUNG,0,0,0
LAMPUNG,LAMPUNG TENGAH,BANGUN REJO,13338,17207,30545
LAMPUNG,LAMPUNG TENGAH,BEKRI,5992,7848,13840
LAMPUNG,LAMPUNG TENGAH,SEPUTIH SURABAYA,0,0,0
LAMPUNG,LAMPUNG TENGAH,PUTRA RUMBIA,2984,7564,10548
LAMPUNG,LAMPUNG TENGAH,SENDANG AGUNG,7971,11593,19564
LAMPUNG,LAMPUNG TENGAH,SEPUTIH BANYAK,10431,15373,25804
LAMPUNG,LAMPUNG TENGAH,BUMI NABUNG,6403,11524,17927
LAMPUNG,LAMPUNG TENGAH,BUMI RATU NUBAN,0,0,0
LAMPUNG,LAMPUNG TENGAH,BANDAR SURABAYA,0,0,0
LAMPUNG,LAMPUNG TENGAH,TRIMURJO,14700,15086,29786
LAMPUNG,LAMPUNG TENGAH,SEPUTIH RAMAN,11382,15761,27143
LAMPUNG,LAMPUNG UTARA,SUNGKAI BARAT,3889,1979,5868
LAMPUNG,LAMPUNG TENGAH,GUNUNG SUGIH,21134,15244,36378
LAMPUNG,LAMPUNG UTARA,HULU SUNGKAI,4298,3246,7544
LAMPUNG,LAMPUNG TENGAH,PUNGGUR,10383,10495,20878
LAMPUNG,LAMPUNG UTARA,MUARA SUNGKAI,4600,3659,8259
LAMPUNG,LAMPUNG TENGAH,RUMBIA,0,0,0
LAMPUNG,LAMPUNG UTARA,ABUNG TINGGI,6167,2888,9055
LAMPUNG,LAMPUNG TENGAH,SEPUTIH MATARAM,0,0,0
LAMPUNG,LAMPUNG UTARA,ABUNG PEKURUN,3630,2241,5871
LAMPUNG,LAMPUNG UTARA,ABUNG SURAKARTA,7638,7672,15310
LAMPUNG,LAMPUNG UTARA,ABUNG SEMULI,6774,6828,13602
LAMPUNG,LAMPUNG TENGAH,TERUSAN NUNYAI,16298,8448,24746
LAMPUNG,LAMPUNG UTARA,ABUNG TENGAH,4872,4274,9146
LAMPUNG,LAMPUNG UTARA,KOTABUMI UTARA,8436,9019,17455
LAMPUNG,LAMPUNG UTARA,ABUNG KUNANG,3602,1725,5327
LAMPUNG,LAMPUNG UTARA,SUNGKAI JAYA,2863,1477,4340
LAMPUNG,LAMPUNG UTARA,BUKIT KEMUNING,12022,8881,20903
LAMPUNG,LAMPUNG UTARA,BUNGA MAYANG,9289,9801,19090
LAMPUNG,LAMPUNG UTARA,SUNGKAI SELATAN,7158,4587,11745
LAMPUNG,LAMPUNG UTARA,SUNGKAI TENGAH,3722,4817,8539
LAMPUNG,LAMPUNG BARAT,NGAMBUR,2966,6534,9500
LAMPUNG,LAMPUNG UTARA,ABUNG TIMUR,10640,9879,20519
LAMPUNG,LAMPUNG UTARA,SUNGKAI UTARA,9410,8598,18008
LAMPUNG,LAMPUNG UTARA,KOTABUMI,17105,9815,26920
LAMPUNG,LAMPUNG UTARA,ABUNG BARAT,6751,3720,10471
LAMPUNG,LAMPUNG BARAT,PAGAR DEWA,4442,7097,11539
LAMPUNG,LAMPUNG UTARA,ABUNG SELATAN,13790,12211,26001
LAMPUNG,LAMPUNG BARAT,BANGKUNAT BELIMBING,6748,7624,14372
LAMPUNG,LAMPUNG BARAT,WAY KRUI,2098,2040,4138
LAMPUNG,LAMPUNG BARAT,GEDUNG SURIAN,3284,6243,9527
LAMPUNG,LAMPUNG BARAT,PESISIR UTARA,2334,1998,4332
LAMPUNG,LAMPUNG UTARA,TANJUNG RAJA,10734,6405,17139
LAMPUNG,LAMPUNG UTARA,BLAMBANGAN PAGAR,5002,5087,10089
LAMPUNG,LAMPUNG BARAT,BALIK BUKIT,9850,9071,18921
LAMPUNG,LAMPUNG UTARA,KOTABUMI SELATAN,23409,10075,33484
LAMPUNG,LAMPUNG BARAT,AIR HITAM,1855,5112,6967
LAMPUNG,LAMPUNG BARAT,PESISIR SELATAN,4192,7113,11305
LAMPUNG,LAMPUNG BARAT,KRUI SELATAN,1876,2190,4066
LAMPUNG,LAMPUNG BARAT,LUMBOK SEMINUNG,1344,2767,4111
LAMPUNG,LAMPUNG BARAT,BATU KETULIS,3145,4511,7656
LAMPUNG,LAMPUNG BARAT,LEMONG,2804,4201,7005
LAMPUNG,LAMPUNG BARAT,BATU BRAK,4509,3365,7874
LAMPUNG,LAMPUNG BARAT,KEBUN TEBU,3788,6998,10786
LAMPUNG,TULANG BAWANG,GEDUNG AJI BARU,5159,5937,11096
LAMPUNG,LAMPUNG BARAT,KARYA PENGGAWA,2485,3268,5753
LAMPUNG,TULANG BAWANG,DENTE TELADAS,11203,16059,27262
LAMPUNG,LAMPUNG BARAT,PULAUPISANG,420,483,903
LAMPUNG,LAMPUNG BARAT,WAY TENONG,8031,7973,16004
LAMPUNG,LAMPUNG BARAT,PESISIR TENGAH,4901,3958,8859
LAMPUNG,LAMPUNG BARAT,BENGKUNAT,1693,2637,4330
LAMPUNG,LAMPUNG BARAT,BANDAR NEGERI SUOH,3554,12461,16015
LAMPUNG,LAMPUNG BARAT,SUKAU,5589,6182,11771
LAMPUNG,TULANG BAWANG,RAWA PITU,3671,5030,8701
LAMPUNG,TULANG BAWANG,RAWA JITU SELATAN,7308,8111,15419
LAMPUNG,TULANG BAWANG,GEDUNG MENENG,12145,8936,21081
LAMPUNG,TULANG BAWANG,MERAKSA AJI,2683,4573,7256
LAMPUNG,TULANG BAWANG,PENAWAR AJI,2945,6682,9627
LAMPUNG,LAMPUNG BARAT,SUMBER JAYA,5894,6786,12680
LAMPUNG,TULANG BAWANG,PENAWAR TAMA,5193,10065,15258
LAMPUNG,LAMPUNG BARAT,SUOH,2539,8688,11227
LAMPUNG,LAMPUNG BARAT,SEKINCAU,4000,6367,10367
LAMPUNG,LAMPUNG BARAT,BELALAU,3214,4594,7808
LAMPUNG,TANGGAMUS,KOTA AGUNG BARAT,7870,2479,10349
LAMPUNG,TULANG BAWANG,BANJAR BARU,4256,3655,7911
LAMPUNG,TULANG BAWANG,BANJAR MARGO,6913,11789,18702
LAMPUNG,TULANG BAWANG,BANJAR AGUNG,9065,11866,20931
LAMPUNG,TANGGAMUS,AIR NANINGAN,6446,9399,15845
LAMPUNG,TANGGAMUS,GISTING,11552,10386,21938
LAMPUNG,TANGGAMUS,LIMAU,5774,5649,11423
LAMPUNG,TULANG BAWANG,MENGGALA TIMUR,4136,4044,8180
LAMPUNG,TULANG BAWANG,MENGGALA,13801,8094,21895
LAMPUNG,TANGGAMUS,KOTA AGUNG,13219,8682,21901
LAMPUNG,TANGGAMUS,WONOSOBO,9505,8407,17912
LAMPUNG,TANGGAMUS,KLUMBAYAN,3312,3053,6365
LAMPUNG,TANGGAMUS,PUGUNG,17210,12849,30059
LAMPUNG,TANGGAMUS,BULOK,5741,5552,11293
LAMPUNG,TANGGAMUS,TALANG PADANG,15246,8169,23415
LAMPUNG,TULANG BAWANG,GEDUNG AJI,2963,4177,7140
LAMPUNG,TANGGAMUS,GUNUNG ALIP,7502,2452,9954
LAMPUNG,TULANG BAWANG,RAWA JITU TIMUR,3723,3535,7258
LAMPUNG,TANGGAMUS,KOTA AGUNG TIMUR,5999,3851,9850
LAMPUNG,TANGGAMUS,SUMBER REJO,7162,11835,18997
LAMPUNG,TANGGAMUS,PEMATANG SAWA,4187,5017,9204
LAMPUNG,TANGGAMUS,PULAU PANGGUNG,10590,8366,18956
LAMPUNG,TANGGAMUS,BANDAR NEGERI SEMUONG,4143,2959,7102
LAMPUNG,LAMPUNG TIMUR,BANDAR SRIBHAWONO,8520,16946,25466
LAMPUNG,TANGGAMUS,SEMAKA,9700,10814,20514
LAMPUNG,TANGGAMUS,CUKUH BALAK,6671,5921,12592
LAMPUNG,LAMPUNG TIMUR,LABUHAN RATU,9509,14686,24195
LAMPUNG,LAMPUNG TIMUR,BATANGHARI NUBAN,13191,11497,24688
LAMPUNG,LAMPUNG TIMUR,JABUNG,14974,11938,26912
LAMPUNG,TANGGAMUS,KLUMBAYAN BARAT,2504,4011,6515
LAMPUNG,LAMPUNG TIMUR,SEKAMPUNG,13038,22103,35141
LAMPUNG,LAMPUNG TIMUR,GUNUNG PELINDUNG,5656,4853,10509
LAMPUNG,TANGGAMUS,ULU BELU,8822,15824,24646
LAMPUNG,LAMPUNG TIMUR,MATARAM BARU,7243,6867,14110
LAMPUNG,LAMPUNG TIMUR,SEKAMPUNG UDIK,12570,25441,38011
LAMPUNG,LAMPUNG TIMUR,PASIR SAKTI,7267,11532,18799
LAMPUNG,LAMPUNG TIMUR,SUKADANA,16048,20971,37019
LAMPUNG,LAMPUNG TIMUR,BATANGHARI,14832,17860,32692
LAMPUNG,LAMPUNG TIMUR,PEKALONGAN,12982,14914,27896
LAMPUNG,LAMPUNG TIMUR,MARGA TIGA,9349,15063,24412
LAMPUNG,LAMPUNG TIMUR,MELINTING,7092,6258,13350
LAMPUNG,WAY KANAN,BLAMBANGAN UMPU,15627,17377,33004
LAMPUNG,LAMPUNG TIMUR,BUMI AGUNG,4028,6537,10565
LAMPUNG,LAMPUNG TIMUR,PURBOLINGGO,11947,12203,24150
LAMPUNG,LAMPUNG TIMUR,BRAJA SELEBAH,4243,7450,11693
LAMPUNG,LAMPUNG TIMUR,WAWAY KARYA,7262,11813,19075
LAMPUNG,LAMPUNG TIMUR,MARGA SEKAMPUNG,5634,9094,14728
LAMPUNG,WAY KANAN,NEGERI BESAR,3560,7351,10911
LAMPUNG,LAMPUNG TIMUR,WAY BUNGUR,6184,6650,12834
LAMPUNG,LAMPUNG TIMUR,LABUHAN MARINGGAI,15344,17773,33117
LAMPUNG,WAY KANAN,BARADATU,10836,10975,21811
LAMPUNG,WAY KANAN,REBANG TANGKAS,4776,6773,11549
LAMPUNG,WAY KANAN,BUAY BAHUGA,6544,4884,11428
LAMPUNG,LAMPUNG TIMUR,WAY JEPARA,11540,16469,28009
LAMPUNG,LAMPUNG TIMUR,METRO KIBANG,3696,8757,12453
LAMPUNG,WAY KANAN,BAHUGA,2582,3552,6134
LAMPUNG,WAY KANAN,WAY TUBA,6969,5816,12785
LAMPUNG,WAY KANAN,GUNUNG LABUHAN,7220,7314,14534
LAMPUNG,LAMPUNG TIMUR,RAMAN UTARA,8379,13592,21971
LAMPUNG,WAY KANAN,PAKUAN RATU,8196,15577,23773
LAMPUNG,PESAWARAN,GEDONG TATAAN,29078,23615,52693
LAMPUNG,PESAWARAN,NEGERI KATON,16088,19953,36041
LAMPUNG,WAY KANAN,NEGARA BATIN,6849,12418,19267
LAMPUNG,PESAWARAN,MARGA PUNDUH,3949,4188,8137
LAMPUNG,WAY KANAN,KASUI,8025,8924,16949
LAMPUNG,WAY KANAN,NEGERI AGUNG,8245,12719,20964
LAMPUNG,PRINGSEWU,AMBARAWA,8945,10042,18987
LAMPUNG,PESAWARAN,PUNDUH PIDADA,3152,4742,7894
LAMPUNG,WAY KANAN,BANJIT,10766,14072,24838
LAMPUNG,PRINGSEWU,GADING REJO,21132,21505,42637
LAMPUNG,WAY KANAN,BUMI AGUNG,7544,7178,14722
LAMPUNG,PESAWARAN,TEGINENENG,12054,18464,30518
LAMPUNG,PESAWARAN,WAY LIMA,12499,8331,20830
LAMPUNG,PESAWARAN,KEDONDONG,9382,8520,17902
LAMPUNG,PRINGSEWU,PAGELARAN,14214,12974,27188
LAMPUNG,PRINGSEWU,PRINGSEWU,20392,23527,43919
LAMPUNG,MESUJI,MESUJI,3073,6557,9630
LAMPUNG,MESUJI,WAY SERDANG,8697,14530,23227
LAMPUNG,PESAWARAN,PADANG CERMIN,18576,29941,48517
LAMPUNG,PESAWARAN,WAY KHILAU,8782,5561,14343
LAMPUNG,TULANG BAWANG BARAT,TULANG BAWANG UDIK,9087,8880,17967
LAMPUNG,MESUJI,MESUJI TIMUR,6093,11419,17512
LAMPUNG,PRINGSEWU,ADILUWIH,8304,10223,18527
LAMPUNG,PRINGSEWU,PARDASUKA,9227,9407,18634
LAMPUNG,PRINGSEWU,BANYUMAS,5070,5724,10794
LAMPUNG,MESUJI,SIMPANG PEMATANG,8152,5796,13948
LAMPUNG,TULANG BAWANG BARAT,GUNUNG AGUNG,6252,11866,18118
LAMPUNG,PRINGSEWU,PAGELARAN UTARA,3380,4025,7405
LAMPUNG,KOTA BANDAR LAMPUNG,KEMILING,20159,13893,34052
LAMPUNG,MESUJI,TANJUNG RAYA,9256,11694,20950
LAMPUNG,PRINGSEWU,SUKOHARJO,12013,12248,24261
LAMPUNG,KOTA BANDAR LAMPUNG,KEDATON,13389,11950,25339
LAMPUNG,TULANG BAWANG BARAT,LAMBU KIBANG,5716,7496,13212
LAMPUNG,KOTA BANDAR LAMPUNG,TELUKBETUNG TIMUR,8894,11855,20749
LAMPUNG,MESUJI,RAWA JITU UTARA,6025,7080,13105
LAMPUNG,KOTA BANDAR LAMPUNG,LANGKAPURA,10345,6788,17133
LAMPUNG,KOTA BANDAR LAMPUNG,KEDAMAIAN,11341,13007,24348
LAMPUNG,TULANG BAWANG BARAT,TULANG BAWANG TENGAH,23535,22445,45980
LAMPUNG,KOTA BANDAR LAMPUNG,RAJABASA,12873,8524,21397
LAMPUNG,KOTA BANDAR LAMPUNG,ENGGAL,7080,6082,13162
LAMPUNG,MESUJI,PANCA JAYA,3828,5505,9333
LAMPUNG,KOTA BANDAR LAMPUNG,TANJUNGKARANG BARAT,15070,12050,27120
LAMPUNG,KOTA BANDAR LAMPUNG,TELUKBETUNG SELATAN,8678,11231,19909
LAMPUNG,TULANG BAWANG BARAT,PAGAR DEWA,1567,1846,3413
LAMPUNG,TULANG BAWANG BARAT,GUNUNG TERANG,6907,11290,18197
LAMPUNG,KOTA BANDAR LAMPUNG,BUMI WARAS,9732,17938,27670
LAMPUNG,TULANG BAWANG BARAT,WAY KENANGA,3948,7789,11737
LAMPUNG,KOTA BANDAR LAMPUNG,TANJUNG SENANG,12387,11279,23666
LAMPUNG,KOTA BANDAR LAMPUNG,LABUHAN RATU,12448,9195,21643
LAMPUNG,KOTA BANDAR LAMPUNG,SUKARAME,16429,13325,29754
LAMPUNG,TULANG BAWANG BARAT,TUMIJAJAR,12035,12019,24054
KEPULAUAN BANGKA BELITUNG,BANGKA,BELINYU,0,0,0
LAMPUNG,KOTA METRO,METRO UTARA,6733,7972,14705
LAMPUNG,KOTA BANDAR LAMPUNG,SUKABUMI,14930,13529,28459
LAMPUNG,KOTA BANDAR LAMPUNG,PANJANG,13157,21583,34740
LAMPUNG,KOTA BANDAR LAMPUNG,TELUKBETUNG BARAT,7144,8133,15277
LAMPUNG,KOTA BANDAR LAMPUNG,TANJUNGKARANG TIMUR,9096,9084,18180
LAMPUNG,KOTA METRO,METRO PUSAT,13634,12560,26194
LAMPUNG,KOTA BANDAR LAMPUNG,WAY HALIM,14706,16777,31483
KEPULAUAN BANGKA BELITUNG,BANGKA,RIAU SILIP,0,0,0
LAMPUNG,KOTA BANDAR LAMPUNG,TANJUNGKARANG PUSAT,13571,11046,24617
KEPULAUAN BANGKA BELITUNG,BANGKA,MERAWANG,0,0,0
KEPULAUAN BANGKA BELITUNG,BANGKA,PUDING BESAR,0,0,0
KEPULAUAN BANGKA BELITUNG,BANGKA,SUNGAILIAT,0,0,0
LAMPUNG,KOTA METRO,METRO BARAT,7103,7004,14107
LAMPUNG,KOTA METRO,METRO SELATAN,4363,4502,8865
KEPULAUAN BANGKA BELITUNG,BANGKA,MENDO BARAT,0,0,0
LAMPUNG,KOTA BANDAR LAMPUNG,TELUKBETUNG UTARA,12096,13208,25304
KEPULAUAN BANGKA BELITUNG,BANGKA SELATAN,TOBOALI,9492,20385,29877
KEPULAUAN BANGKA BELITUNG,BELITUNG,BADAU,0,0,0
KEPULAUAN BANGKA BELITUNG,BELITUNG,SIJUK,0,0,0
KEPULAUAN BANGKA BELITUNG,BELITUNG,MEMBALONG,0,0,0
KEPULAUAN BANGKA BELITUNG,BANGKA,PEMALI,0,0,0
LAMPUNG,KOTA METRO,METRO TIMUR,10099,9804,19903
KEPULAUAN BANGKA BELITUNG,BANGKA SELATAN,PAYUNG,3945,5554,9499
KEPULAUAN BANGKA BELITUNG,BELITUNG,TANJUNG PANDAN,0,0,0
KEPULAUAN BANGKA BELITUNG,BELITUNG,SELAT NASIK,0,0,0
KEPULAUAN BANGKA BELITUNG,BANGKA SELATAN,SIMPANG RIMBA,2378,7674,10052
KEPULAUAN BANGKA BELITUNG,BANGKA,BAKAM,0,0,0
KEPULAUAN BANGKA BELITUNG,BANGKA SELATAN,AIR GEGAS,4937,10700,15637
KEPULAUAN BANGKA BELITUNG,BANGKA TENGAH,PANGKALAN BARU,4402,13618,18020
KEPULAUAN BANGKA BELITUNG,BANGKA TENGAH,LUBUK BESAR,2621,8581,11202
KEPULAUAN BANGKA BELITUNG,BANGKA TENGAH,SUNGAI SELAN,3811,10194,14005
KEPULAUAN BANGKA BELITUNG,BANGKA SELATAN,TUKAK SADAI,1253,4326,5579
KEPULAUAN BANGKA BELITUNG,BANGKA SELATAN,PULAUBESAR,1102,3247,4349
KEPULAUAN BANGKA BELITUNG,BANGKA TENGAH,SIMPANG KATIS,3609,5884,9493
KEPULAUAN BANGKA BELITUNG,BANGKA BARAT,PARITTIGA,2588,12202,14790
KEPULAUAN BANGKA BELITUNG,BANGKA SELATAN,LEPAR PONGOK,1035,2578,3613
KEPULAUAN BANGKA BELITUNG,BANGKA BARAT,SIMPANG TERITIP,3094,9840,12934
KEPULAUAN BANGKA BELITUNG,BANGKA BARAT,TEMPILANG,3330,9069,12399
KEPULAUAN BANGKA BELITUNG,BANGKA TENGAH,KOBA,5218,10397,15615
KEPULAUAN BANGKA BELITUNG,BANGKA BARAT,JEBUS,2873,6781,9654
KEPULAUAN BANGKA BELITUNG,KOTA PANGKALPINANG,BUKITINTAN,4901,10417,15318
KEPULAUAN BANGKA BELITUNG,BANGKA SELATAN,KEPULAUAN PONGOK,432,1771,2203
KEPULAUAN BANGKA BELITUNG,BANGKA BARAT,MUNTOK,6764,15251,22015
KEPULAUAN BANGKA BELITUNG,BANGKA BARAT,KELAPA,3832,11573,15405
KEPULAUAN BANGKA BELITUNG,BELITUNG TIMUR,KELAPA KAMPIT,3709,6222,9931
KEPULAUAN BANGKA BELITUNG,BELITUNG TIMUR,SIMPANG RENGGIANG,1199,3025,4224
KEPULAUAN BANGKA BELITUNG,BELITUNG TIMUR,MANGGAR,5785,12291,18076
KEPULAUAN BANGKA BELITUNG,BANGKA TENGAH,NAMANG,2417,4033,6450
KEPULAUAN BANGKA BELITUNG,BELITUNG TIMUR,DENDANG,1524,3909,5433
KEPULAUAN RIAU,BINTAN,BINTAN PESISIR,1111,2668,3779
KEPULAUAN BANGKA BELITUNG,KOTA PANGKALPINANG,TAMAN SARI,4880,4680,9560
KEPULAUAN BANGKA BELITUNG,BELITUNG TIMUR,DAMAR,1879,4620,6499
KEPULAUAN BANGKA BELITUNG,KOTA PANGKALPINANG,GABEK,5096,6291,11387
KEPULAUAN BANGKA BELITUNG,KOTA PANGKALPINANG,GIRIMAYA,2556,6631,9187
KEPULAUAN BANGKA BELITUNG,BELITUNG TIMUR,SIMPANG PESAK,986,3364,4350
KEPULAUAN RIAU,BINTAN,BINTAN TIMUR,8196,11772,19968
KEPULAUAN BANGKA BELITUNG,BELITUNG TIMUR,GANTUNG,3460,9386,12846
KEPULAUAN BANGKA BELITUNG,KOTA PANGKALPINANG,RANGKUI,6481,9323,15804
KEPULAUAN BANGKA BELITUNG,KOTA PANGKALPINANG,PANGKAL BALAM,3542,5719,9261
KEPULAUAN BANGKA BELITUNG,KOTA PANGKALPINANG,GERUNGGANG,8347,6642,14989
KEPULAUAN RIAU,BINTAN,GUNUNG KIJANG,2001,4687,6688
KEPULAUAN RIAU,BINTAN,TAMBELAN,945,1370,2315
KEPULAUAN RIAU,BINTAN,BINTAN UTARA,4073,5479,9552
KEPULAUAN RIAU,BINTAN,TELUK BINTAN,2081,3394,5475
KEPULAUAN RIAU,BINTAN,TELOK SEBONG,2606,4966,7572
KEPULAUAN RIAU,KARIMUN,DURAI,1184,1655,2839
KEPULAUAN RIAU,KARIMUN,UNGAR,753,1828,2581
KEPULAUAN RIAU,KARIMUN,MERAL BARAT,2673,3130,5803
KEPULAUAN RIAU,BINTAN,TOAPAYA,1985,4026,6011
KEPULAUAN RIAU,KARIMUN,KUNDUR BARAT,2488,6027,8515
KEPULAUAN RIAU,BINTAN,MANTANG,944,1081,2025
KEPULAUAN RIAU,KARIMUN,MORO,2902,6257,9159
KEPULAUAN RIAU,NATUNA,BUNGURAN SELATAN,403,940,1343
KEPULAUAN RIAU,KARIMUN,KARIMUN,7212,11466,18678
KEPULAUAN RIAU,BINTAN,SERI KUALA LOBAM,3175,4220,7395
KEPULAUAN RIAU,KARIMUN,BURU,1801,2289,4090
KEPULAUAN RIAU,NATUNA,PULAU LAUT,162,843,1005
KEPULAUAN RIAU,NATUNA,BUNGURAN TIMUR LAUT,717,1542,2259
KEPULAUAN RIAU,KARIMUN,KUNDUR,3604,9532,13136
KEPULAUAN RIAU,KARIMUN,TEBING,4654,6377,11031
KEPULAUAN RIAU,NATUNA,BUNGURAN BARAT,1195,3899,5094
KEPULAUAN RIAU,KARIMUN,MERAL,6103,10932,17035
KEPULAUAN RIAU,KARIMUN,KUNDUR UTARA,1636,3855,5491
KEPULAUAN RIAU,NATUNA,MIDAI,684,1734,2418
KEPULAUAN RIAU,KARIMUN,BELAT,833,2161,2994
KEPULAUAN RIAU,KARIMUN,BELAT,833,2161,2994
KEPULAUAN RIAU,LINGGA,SENAYANG,2671,7350,10021
KEPULAUAN RIAU,NATUNA,SUBI,358,964,1322
KEPULAUAN RIAU,NATUNA,BUNGURAN TIMUR,3447,6025,9472
KEPULAUAN RIAU,LINGGA,SINGKEP,4141,7582,11723
KEPULAUAN RIAU,KEPULAUAN ANAMBAS,SIANTAN TIMUR,407,1509,1916
KEPULAUAN RIAU,LINGGA,LINGGA,1868,3880,5748
KEPULAUAN RIAU,LINGGA,SELAYAR,523,1168,1691
KEPULAUAN RIAU,LINGGA,SINGKEP BARAT,1711,6401,8112
KEPULAUAN RIAU,NATUNA,SERASAN TIMUR,582,787,1369
KEPULAUAN RIAU,KEPULAUAN ANAMBAS,SIANTAN,1505,3738,5243
KEPULAUAN RIAU,NATUNA,BUNGURAN TENGAH,519,1160,1679
KEPULAUAN RIAU,KEPULAUAN ANAMBAS,PALMATAK,1582,4248,5830
KEPULAUAN RIAU,NATUNA,PULAU TIGA,620,1661,2281
KEPULAUAN RIAU,KEPULAUAN ANAMBAS,JEMAJA TIMUR,299,879,1178
KEPULAUAN RIAU,LINGGA,SINGKEP PESISIR,636,1643,2279
KEPULAUAN RIAU,KOTA BATAM,BELAKANG PADANG,5232,4839,10071
KEPULAUAN RIAU,NATUNA,BUNGURAN UTARA,445,1390,1835
KEPULAUAN RIAU,LINGGA,LINGGA TIMUR,711,1352,2063
KEPULAUAN RIAU,KEPULAUAN ANAMBAS,SIANTAN SELATAN,493,1384,1877
KEPULAUAN RIAU,KOTA BATAM,LUBUK BAJA,11558,25337,36895
KEPULAUAN RIAU,NATUNA,SERASAN,824,1427,2251
KEPULAUAN RIAU,LINGGA,LINGGA UTARA,1757,3567,5324
KEPULAUAN RIAU,KOTA BATAM,BATU AJI,24713,33715,58428
KEPULAUAN RIAU,KOTA BATAM,SAGULUNG,33442,41770,75212
KEPULAUAN RIAU,KOTA BATAM,GALANG,3555,4248,7803
KEPULAUAN RIAU,KOTA TANJUNGPINANG,TANJUNG PINANG BARAT,9135,14998,24133
KEPULAUAN RIAU,KOTA BATAM,NONGSA,13019,13796,26815
KEPULAUAN RIAU,KOTA TANJUNGPINANG,TANJUNG PINANG KOTA,2848,6745,9593
KEPULAUAN RIAU,KOTA BATAM,BENGKONG,22084,24017,46101
DKI JAKARTA,JAKARTA PUSAT,GAMBIR,20496,30787,51283
KEPULAUAN RIAU,KOTA BATAM,BATU AMPAR,11830,15001,26831
KEPULAUAN RIAU,KOTA BATAM,BULANG,2299,3173,5472
KEPULAUAN RIAU,KOTA TANJUNGPINANG,TANJUNG PINANG TIMUR,15927,17881,33808
DKI JAKARTA,JAKARTA PUSAT,KEMAYORAN,57222,70723,127945
KEPULAUAN RIAU,KEPULAUAN ANAMBAS,SIANTAN TENGAH,369,1314,1683
DKI JAKARTA,JAKARTA PUSAT,SENEN,31210,33278,64488
KEPULAUAN RIAU,KOTA BATAM,BATAM KOTA,31612,45129,76741
KEPULAUAN RIAU,KOTA TANJUNGPINANG,BUKIT BESTARI,10354,15397,25751
KEPULAUAN RIAU,KEPULAUAN ANAMBAS,JEMAJA,813,2073,2886
KEPULAUAN RIAU,KOTA BATAM,SEI BEDUK,16320,21476,37796
KEPULAUAN RIAU,KOTA BATAM,SEKUPANG,26582,24665,51247
DKI JAKARTA,JAKARTA UTARA,PENJARINGAN,43759,114244,158003
DKI JAKARTA,JAKARTA PUSAT,TANAH ABANG,44003,42600,86603
DKI JAKARTA,KEPULAUAN SERIBU,KEPULAUAN SERIBU UTARA,4684,4977,9661
DKI JAKARTA,JAKARTA PUSAT,JOHAR BARU,33646,36654,70300
DKI JAKARTA,KEPULAUAN SERIBU,KEPULAUAN SERIBU SELATAN,2222,3112,5334
DKI JAKARTA,JAKARTA PUSAT,MENTENG,24676,22392,47068
DKI JAKARTA,JAKARTA UTARA,KELAPA GADING,22434,54308,76742
DKI JAKARTA,JAKARTA BARAT,TAMAN SARI,22009,46806,68815
DKI JAKARTA,JAKARTA SELATAN,TEBET,73056,56072,129128
DKI JAKARTA,JAKARTA UTARA,PADEMANGAN,25556,56042,81598
DKI JAKARTA,JAKARTA BARAT,TAMBORA,47244,87464,134708
DKI JAKARTA,JAKARTA SELATAN,CILANDAK,53703,59416,113119
DKI JAKARTA,JAKARTA PUSAT,SAWAH BESAR,20833,46016,66849
DKI JAKARTA,JAKARTA BARAT,KEBON JERUK,81193,94976,176169
DKI JAKARTA,JAKARTA BARAT,GROGOL PETAMBURAN,34891,89315,124206
DKI JAKARTA,JAKARTA BARAT,KEMBANGAN,61233,79413,140646
DKI JAKARTA,JAKARTA UTARA,KOJA,76160,79492,155652
DKI JAKARTA,JAKARTA BARAT,PAL MERAH,56840,56627,113467
DKI JAKARTA,JAKARTA PUSAT,CEMPAKA PUTIH,26630,26216,52846
DKI JAKARTA,JAKARTA BARAT,CENGKARENG,93992,169742,263734
DKI JAKARTA,JAKARTA SELATAN,JAGAKARSA,93772,74947,168719
DKI JAKARTA,JAKARTA BARAT,KALIDERES,82413,117760,200173
DKI JAKARTA,JAKARTA UTARA,CILINCING,93382,93794,187176
DKI JAKARTA,JAKARTA TIMUR,MATRAMAN,51239,45677,96916
DKI JAKARTA,JAKARTA SELATAN,PESANGGRAHAN,60660,62202,122862
DKI JAKARTA,JAKARTA SELATAN,SETIABUDI,32339,32354,64693
DKI JAKARTA,JAKARTA UTARA,TANJUNG PRIOK,81605,119515,201120
DKI JAKARTA,JAKARTA SELATAN,KEBAYORAN BARU,37528,46443,83971
JAWA BARAT,BOGOR,CIJERUK,25985,11818,37803
DKI JAKARTA,JAKARTA TIMUR,KRAMATJATI,84430,65653,150083
DKI JAKARTA,JAKARTA TIMUR,PASAR REBO,61182,45274,106456
DKI JAKARTA,JAKARTA SELATAN,PANCORAN,53147,36630,89777
DKI JAKARTA,JAKARTA TIMUR,JATINEGARA,91053,82591,173644
JAWA BARAT,BOGOR,CIOMAS,53243,27936,81179
DKI JAKARTA,JAKARTA SELATAN,PASAR MINGGU,85216,78402,163618
DKI JAKARTA,JAKARTA TIMUR,CAKUNG,140363,112921,253284
DKI JAKARTA,JAKARTA TIMUR,MAKASAR,56742,51362,108104
DKI JAKARTA,JAKARTA SELATAN,KEBAYORAN LAMA,76241,84957,161198
DKI JAKARTA,JAKARTA TIMUR,DUREN SAWIT,117132,105800,222932
JAWA BARAT,BOGOR,TAMANSARI,31331,20948,52279
DKI JAKARTA,JAKARTA TIMUR,CIRACAS,78752,69201,147953
DKI JAKARTA,JAKARTA SELATAN,MAMPANG PRAPATAN,46816,37005,83821
JAWA BARAT,BOGOR,CISARUA,44885,17662,62547
JAWA BARAT,BOGOR,TENJO,18445,12889,31334
JAWA BARAT,BOGOR,CIAWI,38803,15353,54156
JAWA BARAT,BOGOR,RANCA BUNGUR,17186,11940,29126
DKI JAKARTA,JAKARTA TIMUR,PULOGADUNG,74138,81732,155870
JAWA BARAT,BOGOR,KLAPANUNGGAL,43103,11655,54758
DKI JAKARTA,JAKARTA TIMUR,CIPAYUNG,72928,56525,129453
JAWA BARAT,BOGOR,MEGAMENDUNG,36197,15185,51382
JAWA BARAT,BOGOR,LEUWISADENG,24764,9906,34670
JAWA BARAT,BOGOR,CIBINONG,107445,58743,166188
JAWA BARAT,BOGOR,CIGOMBONG,31090,13430,44520
JAWA BARAT,BOGOR,CIGUDEG,33298,21573,54871
JAWA BARAT,BOGOR,CISEENG,31951,21509,53460
JAWA BARAT,BOGOR,CARINGIN,43721,15682,59403
JAWA BARAT,BOGOR,CITEUREUP,70371,28569,98940
JAWA BARAT,BOGOR,TAJURHALANG,31562,21230,52792
JAWA BARAT,BOGOR,JONGGOL,54417,16908,71325
JAWA BARAT,BOGOR,DRAMAGA,33786,23243,57029
JAWA BARAT,BOGOR,SUKAJAYA,23045,11893,34938
JAWA BARAT,BOGOR,TANJUNGSARI,22245,7669,29914
JAWA BARAT,BOGOR,PARUNG,38083,24181,62264
JAWA BARAT,BOGOR,BABAKAN MADANG,39316,12789,52105
JAWA BARAT,BOGOR,NANGGUNG,27599,16992,44591
JAWA BARAT,BOGOR,CIAMPEA,47438,32069,79507
JAWA BARAT,BOGOR,SUKAMAKMUR,28131,10448,38579
JAWA BARAT,BOGOR,CILEUNGSI,83013,39646,122659
JAWA BARAT,BOGOR,CARIU,23549,6800,30349
JAWA BARAT,BOGOR,SUKARAJA,61972,28474,90446
JAWA BARAT,BOGOR,LEUWILIANG,40257,17777,58034
JAWA BARAT,BOGOR,PARUNG PANJANG,29093,26034,55127
JAWA BARAT,BOGOR,GUNUNG SINDUR,30396,24732,55128
JAWA BARAT,SUKABUMI,SUKABUMI,19933,6929,26862
JAWA BARAT,SUKABUMI,KADUDAMPIT,23036,4405,27441
JAWA BARAT,BOGOR,GUNUNG PUTRI,96077,45519,141596
JAWA BARAT,BOGOR,TENJOLAYA,18412,11081,29493
JAWA BARAT,BOGOR,CIBUNGBULANG,43046,24243,67289
JAWA BARAT,SUKABUMI,CIRACAP,12743,12957,25700
JAWA BARAT,SUKABUMI,CARINGIN,17089,4643,21732
JAWA BARAT,BOGOR,BOJONG GEDE,72754,48959,121713
JAWA BARAT,BOGOR,JASINGA,28354,16557,44911
JAWA BARAT,BOGOR,PAMIJAHAN,44937,22589,67526
JAWA BARAT,SUKABUMI,SUKARAJA,29368,11969,41337
JAWA BARAT,SUKABUMI,CIAMBAR,14021,4480,18501
JAWA BARAT,BOGOR,RUMPIN,37497,26711,64208
JAWA BARAT,SUKABUMI,CICANTAYAN,22413,6537,28950
JAWA BARAT,SUKABUMI,CIDADAP,5974,4702,10676
JAWA BARAT,SUKABUMI,CIREUNGHAS,11934,3966,15900
JAWA BARAT,SUKABUMI,CISAAT,49493,13342,62835
JAWA BARAT,SUKABUMI,KEBON PEDES,12296,3605,15901
JAWA BARAT,BOGOR,KEMANG,29337,21546,50883
JAWA BARAT,SUKABUMI,CURUG KEMBAR,8977,6652,15629
JAWA BARAT,SUKABUMI,WARUNG KIARA,19109,9274,28383
JAWA BARAT,SUKABUMI,TEGALBULEUD,10384,8152,18536
JAWA BARAT,SUKABUMI,GUNUNG GURUH,16696,10206,26902
JAWA BARAT,SUKABUMI,PABUARAN,13497,5910,19407
JAWA BARAT,SUKABUMI,SUKALARANG,10061,7749,17810
JAWA BARAT,SUKABUMI,CIMANGGU,7518,2940,10458
JAWA BARAT,SUKABUMI,CIBITUNG,7843,4725,12568
JAWA BARAT,SUKABUMI,GEGER BITUNG,13345,6643,19988
JAWA BARAT,SUKABUMI,JAMPANG TENGAH,21654,12415,34069
JAWA BARAT,SUKABUMI,SAGARANTEN,16677,9050,25727
JAWA BARAT,SUKABUMI,LENGKONG,8482,4949,13431
JAWA BARAT,SUKABUMI,CIKAKAK,10342,7104,17446
JAWA BARAT,SUKABUMI,PURABAYA,12734,7994,20728
JAWA BARAT,SUKABUMI,CISOLOK,17889,14646,32535
JAWA BARAT,SUKABUMI,CIEMAS,13933,10864,24797
JAWA BARAT,SUKABUMI,NYALINDUNG,17027,8251,25278
JAWA BARAT,SUKABUMI,CIKIDANG,16104,9787,25891
JAWA BARAT,SUKABUMI,CIDOLOG,5690,4355,10045
JAWA BARAT,SUKABUMI,JAMPANG KULON,14634,6655,21289
JAWA BARAT,SUKABUMI,SURADE,22275,13833,36108
JAWA BARAT,SUKABUMI,CIDAHU,23638,6806,30444
JAWA BARAT,SUKABUMI,CIBADAK,38418,16815,55233
JAWA BARAT,SUKABUMI,WALURAN,8082,5091,13173
JAWA BARAT,SUKABUMI,CIKEMBAR,30001,14115,44116
JAWA BARAT,CIANJUR,PAGELARAN,21456,13752,35208
JAWA BARAT,SUKABUMI,KALIBUNDER,9238,3862,13100
JAWA BARAT,SUKABUMI,CICURUG,44985,19284,64269
JAWA BARAT,SUKABUMI,NAGRAK,27516,15483,42999
JAWA BARAT,SUKABUMI,BANTAR GADUNG,10444,5410,15854
JAWA BARAT,CIANJUR,SINDANGBARANG,12606,13112,25718
JAWA BARAT,CIANJUR,CIBINONG,15048,15197,30245
JAWA BARAT,CIANJUR,AGRABINTA,9703,9297,19000
JAWA BARAT,CIANJUR,CAMPAKAMULYA,7441,4714,12155
JAWA BARAT,SUKABUMI,BOJONG GENTENG,14540,3557,18097
JAWA BARAT,SUKABUMI,PARAKAN SALAK,16409,4586,20995
JAWA BARAT,SUKABUMI,SIMPENAN,16730,9556,26286
JAWA BARAT,SUKABUMI,PARUNG KUDA,25828,9301,35129
JAWA BARAT,SUKABUMI,PELABUHAN RATU,31467,18743,50210
JAWA BARAT,CIANJUR,TANGGEUNG,13459,8823,22282
JAWA BARAT,SUKABUMI,KALAPA NUNGGAL,17602,4919,22521
JAWA BARAT,SUKABUMI,KABANDUNGAN,11733,5710,17443
JAWA BARAT,CIANJUR,CIDAUN,13558,17069,30627
JAWA BARAT,CIANJUR,CIPANAS,30883,20033,50916
JAWA BARAT,CIANJUR,TAKOKAK,11551,13525,25076
JAWA BARAT,CIANJUR,CIANJUR,53353,32961,86314
JAWA BARAT,CIANJUR,GEKBRONG,13597,9585,23182
JAWA BARAT,CIANJUR,CILAKU,30811,17588,48399
JAWA BARAT,CIANJUR,CIKADU,7121,9959,17080
JAWA BARAT,CIANJUR,CIJATI,8011,7515,15526
JAWA BARAT,CIANJUR,CIRANJANG,22548,16298,38846
JAWA BARAT,CIANJUR,LELES,11169,6663,17832
JAWA BARAT,CIANJUR,CAMPAKA,19389,11422,30811
JAWA BARAT,CIANJUR,CIKALONGKULON,28477,16459,44936
JAWA BARAT,CIANJUR,CIBEBER,38806,19237,58043
JAWA BARAT,CIANJUR,NARINGGUL,9805,12395,22200
JAWA BARAT,CIANJUR,WARUNGKONDANG,21282,11044,32326
JAWA BARAT,CIANJUR,SUKANAGARA,14793,10014,24807
JAWA BARAT,CIANJUR,KADUPANDAK,11380,11873,23253
JAWA BARAT,CIANJUR,KARANGTENGAH,46088,21769,67857
JAWA BARAT,CIANJUR,SUKARESMI,23812,14344,38156
JAWA BARAT,BANDUNG,CIPARAY,62511,24786,87297
JAWA BARAT,CIANJUR,HAURWANGI,16611,11790,28401
JAWA BARAT,BANDUNG,CILEUNYI,59862,27140,87002
JAWA BARAT,CIANJUR,MANDE,20692,13211,33903
JAWA BARAT,CIANJUR,PACET,27971,18529,46500
JAWA BARAT,CIANJUR,BOJONGPICUNG,22425,13512,35937
JAWA BARAT,BANDUNG,PASEH,35816,31428,67244
JAWA BARAT,BANDUNG,KERTASARI,30452,9076,39528
JAWA BARAT,CIANJUR,SUKALUYU,21137,13150,34287
JAWA BARAT,BANDUNG,RANCAEKEK,69199,22799,91998
JAWA BARAT,BANDUNG,MAJALAYA,53547,34445,87992
JAWA BARAT,BANDUNG,CIKANCUNG,28918,14776,43694
JAWA BARAT,CIANJUR,CUGENANG,27871,20606,48477
JAWA BARAT,BANDUNG,BALEENDAH,82926,41624,124550
JAWA BARAT,BANDUNG,SOLOKANJERUK,28651,18712,47363
JAWA BARAT,BANDUNG,PASIRJAMBU,27468,19645,47113
JAWA BARAT,CIANJUR,PASIRKUDA,10868,7376,18244
JAWA BARAT,BANDUNG,PACET,35103,18341,53444
JAWA BARAT,BANDUNG,NAGREG,17994,9503,27497
JAWA BARAT,BANDUNG,CIWIDEY,25975,18848,44823
JAWA BARAT,BANDUNG,IBUN,22914,22882,45796
JAWA BARAT,BANDUNG,BANJARAN,44649,22642,67291
JAWA BARAT,BANDUNG,PANGALENGAN,56347,25684,82031
JAWA BARAT,BANDUNG,SOREANG,39922,21431,61353
JAWA BARAT,BANDUNG,RANCABALI,16601,11857,28458
JAWA BARAT,BANDUNG,CANGKUANG,23589,16224,39813
JAWA BARAT,BANDUNG,KATAPANG,35809,25306,61115
JAWA BARAT,BANDUNG,CILENGKRANG,17007,9743,26750
JAWA BARAT,BANDUNG,CIMENYAN,33979,26828,60807
JAWA BARAT,BANDUNG,MARGAASIH,42175,32381,74556
JAWA BARAT,BANDUNG,ARJASARI,34134,16384,50518
JAWA BARAT,BANDUNG,KUTAWARINGIN,34797,18895,53692
JAWA BARAT,BANDUNG,CICALENGKA,44238,16492,60730
JAWA BARAT,BANDUNG,DAYEUHKOLOT,37072,21079,58151
JAWA BARAT,GARUT,PEUNDEUY,7306,2360,9666
JAWA BARAT,BANDUNG,CIMAUNG,24421,19288,43709
JAWA BARAT,BANDUNG,MARGAHAYU,35764,28405,64169
JAWA BARAT,GARUT,MEKARMUKTI,4901,3469,8370
JAWA BARAT,BANDUNG,BOJONGSOANG,38930,17308,56238
JAWA BARAT,GARUT,CISOMPET,15431,10583,26014
JAWA BARAT,GARUT,CIHURIP,5364,3368,8732
JAWA BARAT,GARUT,PAMEUNGPEUK,16415,4952,21367
JAWA BARAT,GARUT,PAKENJENG,22614,9327,31941
JAWA BARAT,GARUT,CIBIUK,9768,3975,13743
JAWA BARAT,GARUT,SELAAWI,13690,6021,19711
JAWA BARAT,GARUT,SINGAJAYA,14071,6259,20330
JAWA BARAT,GARUT,PASIRWANGI,25155,8343,33498
JAWA BARAT,BANDUNG,PAMEUNGPEUK,30339,11092,41431
JAWA BARAT,GARUT,CIKAJANG,29211,11156,40367
JAWA BARAT,GARUT,BANJARWANGI,18282,7485,25767
JAWA BARAT,GARUT,CIKELET,14860,5883,20743
JAWA BARAT,GARUT,CARINGIN,9271,6273,15544
JAWA BARAT,GARUT,WANARAJA,16373,6532,22905
JAWA BARAT,GARUT,TALEGONG,9988,6735,16723
JAWA BARAT,GARUT,SUCINARAJA,9707,4407,14114
JAWA BARAT,GARUT,SAMARANG,27174,9363,36537
JAWA BARAT,GARUT,BANYURESMI,32595,9763,42358
JAWA BARAT,GARUT,CIBALONG,12961,9929,22890
JAWA BARAT,GARUT,PAMULIHAN,6468,2753,9221
JAWA BARAT,GARUT,KADUNGORA,31164,14989,46153
JAWA BARAT,GARUT,LELES,26191,13945,40136
JAWA BARAT,GARUT,BAYONGBONG,32872,13104,45976
JAWA BARAT,GARUT,CISEWU,13258,6407,19665
JAWA BARAT,GARUT,PANGATIKAN,13844,3388,17232
JAWA BARAT,GARUT,CISURUPAN,29731,17503,47234
JAWA BARAT,GARUT,BUNGBULANG,19611,9770,29381
JAWA BARAT,GARUT,SUKARESMI,13396,4486,17882
JAWA BARAT,GARUT,CILAWU,38972,15508,54480
JAWA BARAT,GARUT,MALANGBONG,40140,14810,54950
JAWA BARAT,GARUT,KARANGTENGAH,5092,2056,7148
JAWA BARAT,GARUT,TAROGONG KIDUL,43410,15069,58479
JAWA BARAT,GARUT,TAROGONG KALER,34797,13985,48782
JAWA BARAT,GARUT,KARANGPAWITAN,46147,17689,63836
JAWA BARAT,TASIKMALAYA,SINGAPARNA,24243,11663,35906
JAWA BARAT,GARUT,CIBATU,25295,8170,33465
JAWA BARAT,TASIKMALAYA,MANGUNREJA,14149,5986,20135
JAWA BARAT,TASIKMALAYA,GUNUNG TANJUNG,11912,3273,15185
JAWA BARAT,GARUT,LEUWIGOONG,14634,6402,21036
JAWA BARAT,TASIKMALAYA,CIPATUJAH,19862,15457,35319
JAWA BARAT,GARUT,CIGEDUG,12059,5757,17816
JAWA BARAT,TASIKMALAYA,CISAYONG,18425,11092,29517
JAWA BARAT,GARUT,SUKAWENING,18554,5816,24370
JAWA BARAT,TASIKMALAYA,SARIWANGI,12961,3259,16220
JAWA BARAT,TASIKMALAYA,SUKARATU,16205,7228,23433
JAWA BARAT,TASIKMALAYA,JAMANIS,12367,4476,16843
JAWA BARAT,TASIKMALAYA,LEUWISARI,13799,5599,19398
JAWA BARAT,TASIKMALAYA,MANONJAYA,25975,8483,34458
JAWA BARAT,TASIKMALAYA,SUKAHENING,9122,6232,15354
JAWA BARAT,GARUT,GARUT KOTA,46288,24890,71178
JAWA BARAT,GARUT,KERSAMANAH,13528,4000,17528
JAWA BARAT,TASIKMALAYA,SUKARAME,15518,4767,20285
JAWA BARAT,TASIKMALAYA,CIAWI,20339,10823,31162
JAWA BARAT,TASIKMALAYA,CIBALONG,12418,6320,18738
JAWA BARAT,TASIKMALAYA,CIKATOMAS,19550,7739,27289
JAWA BARAT,TASIKMALAYA,BANTARKALONG,14565,4525,19090
JAWA BARAT,TASIKMALAYA,PARUNGPONTENG,15518,3423,18941
JAWA BARAT,TASIKMALAYA,CINEAM,12674,7706,20380
JAWA BARAT,TASIKMALAYA,CIKALONG,23505,10269,33774
JAWA BARAT,TASIKMALAYA,PADAKEMBANG,13269,6229,19498
JAWA BARAT,TASIKMALAYA,KADIPATEN,13792,3098,16890
JAWA BARAT,TASIKMALAYA,PAGERAGEUNG,21939,6145,28084
JAWA BARAT,TASIKMALAYA,CULAMEGA,9884,2500,12384
JAWA BARAT,TASIKMALAYA,SALOPA,15122,7686,22808
JAWA BARAT,TASIKMALAYA,PUSPAHIANG,9132,9192,18324
JAWA BARAT,TASIKMALAYA,RAJAPOLAH,17618,6936,24554
JAWA BARAT,TASIKMALAYA,BOJONGGAMBIR,14580,5705,20285
JAWA BARAT,TASIKMALAYA,TANJUNGJAYA,17264,5271,22535
JAWA BARAT,TASIKMALAYA,KARANGNUNGGAL,28840,15904,44744
JAWA BARAT,TASIKMALAYA,KARANG JAYA,4317,3356,7673
JAWA BARAT,TASIKMALAYA,CIGALONTANG,27924,9978,37902
JAWA BARAT,CIAMIS,KALIPUCANG,9417,11748,21165
JAWA BARAT,TASIKMALAYA,SODONGHILIR,27537,5986,33523
JAWA BARAT,CIAMIS,CIAMIS,37756,19860,57616
JAWA BARAT,TASIKMALAYA,JATIWARAS,18085,6046,24131
JAWA BARAT,CIAMIS,PADAHERANG,15464,20394,35858
JAWA BARAT,CIAMIS,PANGANDARAN,11991,20180,32171
JAWA BARAT,TASIKMALAYA,PANCA TENGAH,18620,5382,24002
JAWA BARAT,CIAMIS,CIMARAGAS,4629,4943,9572
JAWA BARAT,TASIKMALAYA,SUKARAJA,19855,7461,27316
JAWA BARAT,TASIKMALAYA,SALAWU,22298,9920,32218
JAWA BARAT,CIAMIS,CIMERAK,13281,13636,26917
JAWA BARAT,TASIKMALAYA,BOJONGASIH,7889,2490,10379
JAWA BARAT,TASIKMALAYA,TARAJU,12523,7120,19643
JAWA BARAT,TASIKMALAYA,SUKARESIK,14160,3843,18003
JAWA BARAT,CIAMIS,BAREGBEG,14128,10411,24539
JAWA BARAT,CIAMIS,PAMARICAN,17606,20395,38001
JAWA BARAT,CIAMIS,CIJULANG,9149,8403,17552
JAWA BARAT,CIAMIS,CISAGA,11348,11562,22910
JAWA BARAT,CIAMIS,CIGUGUR,7632,4469,12101
JAWA BARAT,CIAMIS,PARIGI,11667,16578,28245
JAWA BARAT,CIAMIS,CIDOLOG,6259,4978,11237
JAWA BARAT,CIAMIS,CIKONENG,18785,11320,30105
JAWA BARAT,CIAMIS,SIDAMULIH,6563,11076,17639
JAWA BARAT,CIAMIS,KAWALI,15345,8295,23640
JAWA BARAT,CIAMIS,PURWADADI,9277,11038,20315
JAWA BARAT,CIAMIS,BANJARSARI,29787,29626,59413
JAWA BARAT,CIAMIS,SUKAMANTRI,5969,4905,10874
JAWA BARAT,CIAMIS,JATINAGARA,8632,5310,13942
JAWA BARAT,CIAMIS,PANAWANGAN,13025,15081,28106
JAWA BARAT,CIAMIS,CIHAURBEUTI,18575,7821,26396
JAWA BARAT,CIAMIS,SINDANGKASIH,17694,9266,26960
JAWA BARAT,CIAMIS,LANGKAPLANCAR,13348,14281,27629
JAWA BARAT,CIAMIS,SADANANYA,12168,8641,20809
JAWA BARAT,CIAMIS,CIJEUNGJING,20137,10517,30654
JAWA BARAT,CIAMIS,CIPAKU,20747,13552,34299
JAWA BARAT,CIAMIS,SUKADANA,7465,6769,14234
JAWA BARAT,CIAMIS,LUMBUNG,11570,4842,16412
JAWA BARAT,KUNINGAN,KADUGEDE,8638,6066,14704
JAWA BARAT,CIAMIS,RANCAH,18807,14138,32945
JAWA BARAT,KUNINGAN,CIMAHI,5934,8582,14516
JAWA BARAT,CIAMIS,RAJADESA,18742,7839,26581
JAWA BARAT,KUNINGAN,PANCALANG,6370,5577,11947
JAWA BARAT,CIAMIS,PANUMBANGAN,17570,13589,31159
JAWA BARAT,CIAMIS,TAMBAKSARI,4711,9111,13822
JAWA BARAT,CIAMIS,PANJALU,15200,7271,22471
JAWA BARAT,CIAMIS,MANGUNJAYA,7900,9041,16941
JAWA BARAT,CIAMIS,LAKBOK,10546,17619,28165
JAWA BARAT,KUNINGAN,PASAWAHAN,5991,6443,12434
JAWA BARAT,KUNINGAN,CIPICUNG,6167,6571,12738
JAWA BARAT,KUNINGAN,CIBEUREUM,4879,5551,10430
JAWA BARAT,KUNINGAN,KARANG KANCANA,4947,4503,9450
JAWA BARAT,KUNINGAN,NUSAHERANG,4992,5644,10636
JAWA BARAT,KUNINGAN,CIGUGUR,15165,11091,26256
JAWA BARAT,KUNINGAN,CIWARU,8230,6220,14450
JAWA BARAT,KUNINGAN,JAPARA,4781,5740,10521
JAWA BARAT,KUNINGAN,CIBINGBIN,9633,8669,18302
JAWA BARAT,KUNINGAN,CILEBAK,3887,2589,6476
JAWA BARAT,KUNINGAN,KRAMATMULYA,11438,10574,22012
JAWA BARAT,KUNINGAN,HANTARA,3871,3643,7514
JAWA BARAT,KUNINGAN,MALEBER,13430,6444,19874
JAWA BARAT,KUNINGAN,KALIMANGGIS,5271,5278,10549
JAWA BARAT,KUNINGAN,JALAKSANA,11950,13142,25092
JAWA BARAT,KUNINGAN,CILIMUS,14394,11998,26392
JAWA BARAT,KUNINGAN,KUNINGAN,35885,21691,57576
JAWA BARAT,KUNINGAN,DARMA,14967,9838,24805
JAWA BARAT,KUNINGAN,SINDANG AGUNG,9800,8197,17997
JAWA BARAT,KUNINGAN,CINIRU,6094,3681,9775
JAWA BARAT,KUNINGAN,SUBANG,7343,1763,9106
JAWA BARAT,KUNINGAN,CIGANDAMEKAR,8070,7560,15630
JAWA BARAT,KUNINGAN,LEBAKWANGI,10753,10202,20955
JAWA BARAT,KUNINGAN,MANDIRANCAN,7015,5121,12136
JAWA BARAT,CIREBON,CIWARINGIN,7755,11197,18952
JAWA BARAT,KUNINGAN,GARAWANGI,11905,8335,20240
JAWA BARAT,CIREBON,KALIWEDI,8168,9979,18147
JAWA BARAT,KUNINGAN,LURAGUNG,13046,9025,22071
JAWA BARAT,CIREBON,ARJAWINANGUN,14579,19608,34187
JAWA BARAT,CIREBON,GEGESIK,15500,18798,34298
JAWA BARAT,CIREBON,SUSUKAN,11369,20285,31654
JAWA BARAT,KUNINGAN,CIAWIGEBANG,22506,17356,39862
JAWA BARAT,CIREBON,GEBANG,8678,22672,31350
JAWA BARAT,CIREBON,KARANGWARENG,3734,10083,13817
JAWA BARAT,CIREBON,KAPETAKAN,10745,16487,27232
JAWA BARAT,CIREBON,KLANGENAN,8728,16123,24851
JAWA BARAT,KUNINGAN,CIDAHU,10327,9357,19684
JAWA BARAT,KUNINGAN,SELAJAMBE,4323,3705,8028
JAWA BARAT,CIREBON,DEPOK,11732,20515,32247
JAWA BARAT,CIREBON,SEDONG,5959,11819,17778
JAWA BARAT,CIREBON,KEDAWUNG,14586,18019,32605
JAWA BARAT,CIREBON,WALED,7538,15533,23071
JAWA BARAT,CIREBON,GEMPOL,8811,14151,22962
JAWA BARAT,CIREBON,PANGURAGAN,9007,10494,19501
JAWA BARAT,CIREBON,SURANENGGALA,9593,14309,23902
JAWA BARAT,CIREBON,PABUARAN,5536,13280,18816
JAWA BARAT,CIREBON,GREGED,8598,11674,20272
JAWA BARAT,CIREBON,KARANGSEMBUNG,6493,11353,17846
JAWA BARAT,CIREBON,PLERED,9317,19213,28530
JAWA BARAT,CIREBON,BABAKAN,9756,23583,33339
JAWA BARAT,CIREBON,SUSUKAN LEBAK,5487,12611,18098
JAWA BARAT,CIREBON,PASALEMAN,4466,7111,11577
JAWA BARAT,CIREBON,LOSARI,9989,17005,26994
JAWA BARAT,CIREBON,PABEDILAN,8678,19385,28063
JAWA BARAT,CIREBON,TENGAH TANI,9005,13933,22938
JAWA BARAT,CIREBON,PLUMBON,15970,26697,42667
JAWA BARAT,CIREBON,GUNUNG JATI,20705,23481,44186
JAWA BARAT,CIREBON,PALIMANAN,12916,18582,31498
JAWA BARAT,CIREBON,LEMAHABANG,10776,14888,25664
JAWA BARAT,CIREBON,BEBER,8210,10023,18233
JAWA BARAT,CIREBON,TALUN,14149,17092,31241
JAWA BARAT,CIREBON,PANGENAN,7001,12415,19416
JAWA BARAT,CIREBON,ASTANAJAPURA,14839,16940,31779
JAWA BARAT,MAJALENGKA,JATITUJUH,0,0,0
JAWA BARAT,CIREBON,CILEDUG,10078,13216,23294
JAWA BARAT,CIREBON,MUNDU,15338,21179,36517
JAWA BARAT,CIREBON,JAMBLANG,5760,13273,19033
JAWA BARAT,CIREBON,DUKUPUNTANG,13604,19718,33322
JAWA BARAT,CIREBON,WERU,14443,21069,35512
JAWA BARAT,CIREBON,SUMBER,17921,25894,43815
JAWA BARAT,MAJALENGKA,SUMBERJAYA,0,0,0
JAWA BARAT,MAJALENGKA,KADIPATEN,0,0,0
JAWA BARAT,MAJALENGKA,PANYINGKIRAN,0,0,0
JAWA BARAT,MAJALENGKA,PALASAH,0,0,0
JAWA BARAT,MAJALENGKA,LEMAHSUGIH,0,0,0
JAWA BARAT,MAJALENGKA,CIKIJING,0,0,0
JAWA BARAT,MAJALENGKA,BANTARUJEG,0,0,0
JAWA BARAT,MAJALENGKA,SINDANGWANGI,0,0,0
JAWA BARAT,MAJALENGKA,LIGUNG,0,0,0
JAWA BARAT,MAJALENGKA,KERTAJATI,0,0,0
JAWA BARAT,MAJALENGKA,MAJA,0,0,0
JAWA BARAT,MAJALENGKA,CIGASONG,0,0,0
JAWA BARAT,MAJALENGKA,KASOKANDEL,0,0,0
JAWA BARAT,MAJALENGKA,SUKAHAJI,0,0,0
JAWA BARAT,MAJALENGKA,LEUWIMUNDING,0,0,0
JAWA BARAT,MAJALENGKA,CINGAMBUL,0,0,0
JAWA BARAT,SUMEDANG,RANCAKALONG,13189,10775,23964
JAWA BARAT,MAJALENGKA,JATIWANGI,0,0,0
JAWA BARAT,MAJALENGKA,BANJARAN,0,0,0
JAWA BARAT,MAJALENGKA,SINDANG,0,0,0
JAWA BARAT,SUMEDANG,TANJUNGKERTA,12391,8037,20428
JAWA BARAT,SUMEDANG,SUMEDANG SELATAN,31073,15435,46508
JAWA BARAT,SUMEDANG,TANJUNGMEDAR,7977,7326,15303
JAWA BARAT,SUMEDANG,SUMEDANG UTARA,33312,19340,52652
JAWA BARAT,MAJALENGKA,DAWUAN,0,0,0
JAWA BARAT,MAJALENGKA,TALAGA,0,0,0
JAWA BARAT,SUMEDANG,WADO,13472,9410,22882
JAWA BARAT,MAJALENGKA,ARGAPURA,0,0,0
JAWA BARAT,MAJALENGKA,RAJAGALUH,0,0,0
JAWA BARAT,SUMEDANG,GANEAS,8583,5009,13592
JAWA BARAT,MAJALENGKA,MAJALENGKA,0,0,0
JAWA BARAT,SUMEDANG,JATINUNGGAL,14850,9438,24288
JAWA BARAT,SUMEDANG,CISITU,8903,7274,16177
JAWA BARAT,SUMEDANG,PAMULIHAN,20302,12927,33229
JAWA BARAT,SUMEDANG,CIMANGGUNG,37363,9987,47350
JAWA BARAT,MAJALENGKA,MALAUSMA,0,0,0
JAWA BARAT,SUMEDANG,CIMALAKA,20547,13680,34227
JAWA BARAT,SUMEDANG,CIBUGEL,6688,4613,11301
JAWA BARAT,SUMEDANG,SITURAJA,14367,8144,22511
JAWA BARAT,SUMEDANG,SURIAN,3244,4012,7256
JAWA BARAT,SUMEDANG,JATINANGOR,37890,14635,52525
JAWA BARAT,SUMEDANG,TANJUNGSARI,33471,13838,47309
JAWA BARAT,SUMEDANG,CISARUA,4985,5547,10532
JAWA BARAT,INDRAMAYU,ARAHAN,6235,10834,17069
JAWA BARAT,SUMEDANG,PASEH,10476,11184,21660
JAWA BARAT,SUMEDANG,BUAHDUA,10136,10231,20367
JAWA BARAT,SUMEDANG,UJUNGJAYA,8559,10523,19082
JAWA BARAT,INDRAMAYU,KANDANGHAUR,16269,27197,43466
JAWA BARAT,SUMEDANG,TOMO,7338,7831,15169
JAWA BARAT,INDRAMAYU,GANTAR,15996,14124,30120
JAWA BARAT,SUMEDANG,DARMARAJA,11863,9235,21098
JAWA BARAT,INDRAMAYU,LOHBENER,10425,19395,29820
JAWA BARAT,INDRAMAYU,HAURGEULIS,19672,23661,43333
JAWA BARAT,SUMEDANG,CONGGEANG,8921,10081,19002
JAWA BARAT,SUMEDANG,JATIGEDE,8211,7324,15535
JAWA BARAT,INDRAMAYU,PASEKAN,4037,8899,12936
JAWA BARAT,SUMEDANG,SUKASARI,13736,6357,20093
JAWA BARAT,INDRAMAYU,SUKAGUMIWANG,9282,8363,17645
JAWA BARAT,INDRAMAYU,GABUSWETAN,11602,19176,30778
JAWA BARAT,INDRAMAYU,LOSARANG,11448,17000,28448
JAWA BARAT,INDRAMAYU,KROYA,12121,20605,32726
JAWA BARAT,INDRAMAYU,TUKDANA,14669,13602,28271
JAWA BARAT,INDRAMAYU,ANJATAN,15780,29609,45389
JAWA BARAT,INDRAMAYU,SINDANG,11934,15742,27676
JAWA BARAT,INDRAMAYU,KERTASEMAYA,11547,17620,29167
JAWA BARAT,INDRAMAYU,LELEA,11034,15901,26935
JAWA BARAT,INDRAMAYU,KRANGKENG,13640,19495,33135
JAWA BARAT,INDRAMAYU,BONGAS,10345,15694,26039
JAWA BARAT,INDRAMAYU,CIKEDUNG,12042,11563,23605
JAWA BARAT,INDRAMAYU,TRISI,14216,16730,30946
JAWA BARAT,INDRAMAYU,BANGODUA,6050,8654,14704
JAWA BARAT,INDRAMAYU,SUKRA,8612,15622,24234
JAWA BARAT,INDRAMAYU,INDRAMAYU,26417,32843,59260
JAWA BARAT,INDRAMAYU,CANTIGI,3563,9434,12997
JAWA BARAT,INDRAMAYU,KEDOKAN BUNDER,10162,13842,24004
JAWA BARAT,INDRAMAYU,JATIBARANG,14193,25565,39758
JAWA BARAT,INDRAMAYU,WIDASARI,7665,12359,20024
JAWA BARAT,INDRAMAYU,JUNTINYUAT,18674,24118,42792
JAWA BARAT,SUBANG,CIPEUNDUEY,13169,12726,25895
JAWA BARAT,SUBANG,CIBOGO,11659,13304,24963
JAWA BARAT,SUBANG,TAMBAKDAHAN,9266,16125,25391
JAWA BARAT,SUBANG,DAWUAN,12038,11779,23817
JAWA BARAT,INDRAMAYU,BALONGAN,10005,11049,21054
JAWA BARAT,INDRAMAYU,KARANGAMPEL,12071,20542,32613
JAWA BARAT,SUBANG,CIPUNAGARA,13023,21641,34664
JAWA BARAT,INDRAMAYU,PATROL,8916,19410,28326
JAWA BARAT,SUBANG,KASOMALANG,15433,7116,22549
JAWA BARAT,SUBANG,SUBANG,39761,31952,71713
JAWA BARAT,SUBANG,COMPRENG,8636,16198,24834
JAWA BARAT,SUBANG,SERANGPANJANG,6993,7502,14495
JAWA BARAT,INDRAMAYU,SLIYEG,12422,22184,34606
JAWA BARAT,SUBANG,PAGADEN BARAT,10978,12013,22991
JAWA BARAT,SUBANG,SAGALAHERANG,10843,7024,17867
JAWA BARAT,SUBANG,CIJAMBE,12697,10681,23378
JAWA BARAT,SUBANG,BINONG,10487,16397,26884
JAWA BARAT,SUBANG,LEGONKULON,5194,7827,13021
JAWA BARAT,SUBANG,SUKASARI,8463,14947,23410
JAWA BARAT,SUBANG,CIKAUM,0,0,0
JAWA BARAT,SUBANG,CIASEM,24950,31011,55961
JAWA BARAT,SUBANG,CIATER,10547,6396,16943
JAWA BARAT,SUBANG,PAGADEN,17480,17404,34884
JAWA BARAT,SUBANG,TANJUNGSIANG,14835,11258,26093
JAWA BARAT,SUBANG,PURWADADI,15399,18221,33620
JAWA BARAT,SUBANG,PAMANUKAN,12292,19202,31494
JAWA BARAT,SUBANG,PATOKBEUSI,23878,19507,43385
JAWA BARAT,PURWAKARTA,BOJONG,18528,6826,25354
JAWA BARAT,SUBANG,KALIJATI,18424,15716,34140
JAWA BARAT,SUBANG,PUSAKAJAYA,9059,16042,25101
JAWA BARAT,SUBANG,CISALAK,14383,7405,21788
JAWA BARAT,SUBANG,JALANCAGAK,14437,10464,24901
JAWA BARAT,SUBANG,PUSAKANAGARA,6908,14810,21718
JAWA BARAT,SUBANG,PABUARAN,18201,16083,34284
JAWA BARAT,PURWAKARTA,WANAYASA,15844,6393,22237
JAWA BARAT,PURWAKARTA,PONDOKSALAM,11799,4409,16208
JAWA BARAT,PURWAKARTA,PASAWAHAN,18701,7078,25779
JAWA BARAT,PURWAKARTA,CIBATU,11603,6094,17697
JAWA BARAT,PURWAKARTA,BUNGURSARI,20520,8634,29154
JAWA BARAT,KARAWANG,TELAGASARI,24019,13403,37422
JAWA BARAT,SUBANG,BLANAKAN,12619,21173,33792
JAWA BARAT,KARAWANG,RAWAMERTA,18536,11045,29581
JAWA BARAT,PURWAKARTA,SUKATANI,25873,8689,34562
JAWA BARAT,PURWAKARTA,BABAKANCIKAO,18929,10049,28978
JAWA BARAT,PURWAKARTA,KIARAPEDES,9606,5075,14681
JAWA BARAT,PURWAKARTA,JATILUHUR,25653,9773,35426
JAWA BARAT,PURWAKARTA,PURWAKARTA,66104,27283,93387
JAWA BARAT,PURWAKARTA,MANIIS,9378,5677,15055
JAWA BARAT,PURWAKARTA,PLERED,28673,8135,36808
JAWA BARAT,PURWAKARTA,SUKASARI,5497,1952,7449
JAWA BARAT,PURWAKARTA,DARANGDAN,24669,9197,33866
JAWA BARAT,KARAWANG,TIRTAMULYA,18591,9294,27885
JAWA BARAT,KARAWANG,JAYAKERTA,16466,13440,29906
JAWA BARAT,KARAWANG,KARAWANG BARAT,0,0,0
JAWA BARAT,KARAWANG,TEMPURAN,20067,15617,35684
JAWA BARAT,PURWAKARTA,CAMPAKA,17318,7361,24679
JAWA BARAT,KARAWANG,PANGKALAN,0,0,0
JAWA BARAT,KARAWANG,TELUKJAMBE TIMUR,39307,23257,62564
JAWA BARAT,PURWAKARTA,TEGALWARU,18564,5632,24196
JAWA BARAT,KARAWANG,KLARI,0,0,0
JAWA BARAT,KARAWANG,CILAMAYA WETAN,0,0,0
JAWA BARAT,KARAWANG,KARAWANG TIMUR,37638,26956,64594
JAWA BARAT,KARAWANG,LEMAHABANG,24144,12579,36723
JAWA BARAT,KARAWANG,CIAMPEL,0,0,0
JAWA BARAT,KARAWANG,CILAMAYA KULON,0,0,0
JAWA BARAT,KARAWANG,TELUKJAMBE BARAT,19937,10094,30031
JAWA BARAT,KARAWANG,MAJALAYA,16638,9427,26065
JAWA BARAT,KARAWANG,RENGASDENGKLOK,0,0,0
JAWA BARAT,KARAWANG,CIBUAYA,14042,11461,25503
JAWA BARAT,KARAWANG,KOTA BARU,39077,24144,63221
JAWA BARAT,KARAWANG,BANYUSARI,0,0,0
JAWA BARAT,KARAWANG,TEGALWARU,14777,4671,19448
JAWA BARAT,KARAWANG,PURWASARI,0,0,0
JAWA BARAT,KARAWANG,PAKISJAYA,0,0,0
JAWA BARAT,KARAWANG,CILEBAR,0,0,0
JAWA BARAT,KARAWANG,TIRTAJAYA,19590,15152,34742
JAWA BARAT,BEKASI,CIKARANG PUSAT,0,0,0
JAWA BARAT,KARAWANG,BATUJAYA,22550,15006,37556
JAWA BARAT,KARAWANG,KUTAWALUYA,17271,14119,31390
JAWA BARAT,BEKASI,MUARAGEMBONG,0,0,0
JAWA BARAT,KARAWANG,PEDES,17848,19276,37124
JAWA BARAT,BEKASI,SUKAKARYA,0,0,0
JAWA BARAT,BEKASI,TARUMAJAYA,0,0,0
JAWA BARAT,BEKASI,PEBAYURAN,0,0,0
JAWA BARAT,BEKASI,CIBARUSAH,0,0,0
JAWA BARAT,BEKASI,CIKARANG SELATAN,0,0,0
JAWA BARAT,BEKASI,TAMBUN UTARA,0,0,0
JAWA BARAT,BEKASI,SUKATANI,0,0,0
JAWA BARAT,BEKASI,CIKARANG TIMUR,0,0,0
JAWA BARAT,KARAWANG,CIKAMPEK,0,0,0
JAWA BARAT,KARAWANG,JATISARI,0,0,0
JAWA BARAT,BEKASI,SETU,0,0,0
JAWA BARAT,BEKASI,TAMBELANG,0,0,0
JAWA BARAT,BEKASI,CABANGBUNGIN,0,0,0
JAWA BARAT,BANDUNG BARAT,CIPONGKOR,27612,13537,41149
JAWA BARAT,BEKASI,CIBITUNG,0,0,0
JAWA BARAT,BANDUNG BARAT,CILILIN,29662,16597,46259
JAWA BARAT,BEKASI,KEDUNG WARINGIN,0,0,0
JAWA BARAT,BEKASI,SERANG BARU,0,0,0
JAWA BARAT,BEKASI,BABELAN,0,0,0
JAWA BARAT,BANDUNG BARAT,SINDANGKERTA,21517,12037,33554
JAWA BARAT,BEKASI,BOJONGMANGU,0,0,0
JAWA BARAT,BEKASI,CIKARANG BARAT,0,0,0
JAWA BARAT,BEKASI,KARANG BAHAGIA,0,0,0
JAWA BARAT,BEKASI,SUKAWANGI,0,0,0
JAWA BARAT,BEKASI,TAMBUN SELATAN,0,0,0
JAWA BARAT,BANDUNG BARAT,CISARUA,22605,19403,42008
JAWA BARAT,BANDUNG BARAT,GUNUNGHALU,24211,12846,37057
JAWA BARAT,BANDUNG BARAT,LEMBANG,61223,46661,107884
JAWA BARAT,BANDUNG BARAT,PADALARANG,64064,29378,93442
JAWA BARAT,BANDUNG BARAT,CIPATAT,39499,28711,68210
JAWA BARAT,BEKASI,CIKARANG UTARA,0,0,0
JAWA BARAT,BANDUNG BARAT,RONGGA,17851,9433,27284
JAWA BARAT,BANDUNG BARAT,CIPEUNDEUY,27189,14595,41784
JAWA BARAT,KOTA BOGOR,BOGOR TIMUR,30962,24809,55771
JAWA BARAT,BANDUNG BARAT,BATUJAJAR,37174,14817,51991
JAWA BARAT,KOTA BOGOR,BOGOR BARAT,80800,45640,126440
JAWA BARAT,BANDUNG BARAT,CIHAMPELAS,38947,20765,59712
JAWA BARAT,KOTA BOGOR,TANAH SAREAL,70359,40038,110397
JAWA BARAT,KOTA SUKABUMI,GUNUNG PUYUH,17890,6826,24716
JAWA BARAT,KOTA BOGOR,BOGOR SELATAN,63572,40203,103775
JAWA BARAT,KOTA BANDUNG,SUKASARI,25632,18094,43726
JAWA BARAT,BANDUNG BARAT,NGAMPRAH,57936,32105,90041
JAWA BARAT,BANDUNG BARAT,CIKALONGWETAN,38236,25677,63913
JAWA BARAT,BANDUNG BARAT,SAGULING,9229,6993,16222
JAWA BARAT,BANDUNG BARAT,PARONGPONG,30776,28530,59306
JAWA BARAT,KOTA SUKABUMI,CITAMIANG,19578,7873,27451
JAWA BARAT,KOTA SUKABUMI,CIKOLE,21602,11405,33007
JAWA BARAT,KOTA BANDUNG,BANDUNG KIDUL,18936,12553,31489
JAWA BARAT,KOTA BOGOR,BOGOR TENGAH,35204,24812,60016
JAWA BARAT,KOTA SUKABUMI,CIBEUREUM,14888,4928,19816
JAWA BARAT,KOTA SUKABUMI,BAROS,13394,4363,17757
JAWA BARAT,KOTA BANDUNG,ARCAMANIK,23917,16172,40089
JAWA BARAT,KOTA BOGOR,BOGOR UTARA,59389,35076,94465
JAWA BARAT,KOTA BANDUNG,CIBIRU,25092,12619,37711
JAWA BARAT,KOTA BANDUNG,BOJONGLOA KIDUL,24017,23318,47335
JAWA BARAT,KOTA SUKABUMI,WARUDOYONG,19123,11009,30132
JAWA BARAT,KOTA BANDUNG,SUMUR BANDUNG,11017,8609,19626
JAWA BARAT,KOTA BANDUNG,COBLONG,38984,25687,64671
JAWA BARAT,KOTA SUKABUMI,LEMBURSITU,13643,6666,20309
JAWA BARAT,KOTA BANDUNG,BOJONGLOA KALER,34855,32257,67112
JAWA BARAT,KOTA BANDUNG,CINAMBO,8496,4349,12845
JAWA BARAT,KOTA BANDUNG,ANDIR,28655,27537,56192
JAWA BARAT,KOTA BANDUNG,KIARACONDONG,44161,28147,72308
JAWA BARAT,KOTA BANDUNG,BUAHBATU,33299,20405,53704
JAWA BARAT,KOTA BANDUNG,CIBEUNYING KALER,22881,15770,38651
JAWA BARAT,KOTA BANDUNG,ANTAPANI,25917,16876,42793
JAWA BARAT,KOTA BANDUNG,BABAKAN CIPARAY,36500,35783,72283
JAWA BARAT,KOTA BANDUNG,SUKAJADI,31762,24987,56749
JAWA BARAT,KOTA BANDUNG,GEDEBAGE,13205,6428,19633
JAWA BARAT,KOTA BANDUNG,PANYILEUKAN,14204,6699,20903
JAWA BARAT,KOTA BANDUNG,BANDUNG KULON,41286,30696,71982
JAWA BARAT,KOTA BANDUNG,REGOL,23693,21675,45368
JAWA BARAT,KOTA BANDUNG,RANCASARI,26610,16022,42632
JAWA BARAT,KOTA BANDUNG,UJUNG BERUNG,28181,14642,42823
JAWA BARAT,KOTA CIREBON,KEJAKSAN,12058,12504,24562
JAWA BARAT,KOTA BANDUNG,BANDUNG WETAN,8692,7826,16518
JAWA BARAT,KOTA BANDUNG,ASTANA ANYAR,20059,21995,42054
JAWA BARAT,KOTA CIREBON,PEKALIPAN,6264,11358,17622
JAWA BARAT,KOTA CIREBON,HARJAMUKTI,28150,28698,56848
JAWA BARAT,KOTA BANDUNG,LENGKONG,22918,17045,39963
JAWA BARAT,KOTA BANDUNG,CIBEUNYING KIDUL,36894,24708,61602
JAWA BARAT,KOTA BANDUNG,BATUNUNGGAL,40037,27050,67087
JAWA BARAT,KOTA BEKASI,RAWA LUMBU,54573,50487,105060
JAWA BARAT,KOTA BANDUNG,CIDADAP,16777,13729,30506
JAWA BARAT,KOTA BEKASI,PONDOK GEDE,66618,56454,123072
JAWA BARAT,KOTA BANDUNG,MANDALAJATI,23030,14068,37098
JAWA BARAT,KOTA BEKASI,BEKASI SELATAN,56601,50641,107242
JAWA BARAT,KOTA BANDUNG,CICENDO,28996,25276,54272
JAWA BARAT,KOTA DEPOK,CILODONG,41539,28362,69901
JAWA BARAT,KOTA CIREBON,LEMAH WUNGKUK,12261,18542,30803
JAWA BARAT,KOTA DEPOK,CINERE,25097,25017,50114
JAWA BARAT,KOTA BEKASI,MUSTIKA JAYA,49876,36325,86201
JAWA BARAT,KOTA DEPOK,PANCORAN MAS,65651,55245,120896
JAWA BARAT,KOTA BEKASI,BANTAR GEBANG,27707,14303,42010
JAWA BARAT,KOTA CIREBON,KESAMBI,19626,19977,39603
JAWA BARAT,KOTA BEKASI,BEKASI TIMUR,73480,64815,138295
JAWA BARAT,KOTA BEKASI,JATIASIH,62360,44480,106840
JAWA BARAT,KOTA DEPOK,TAPOS,77207,50247,127454
JAWA BARAT,KOTA DEPOK,SAWANGAN,45597,27542,73139
JAWA BARAT,KOTA BEKASI,PONDOK MELATI,34176,35050,69226
JAWA BARAT,KOTA BEKASI,JATI SEMPURNA,26884,23834,50718
JAWA BARAT,KOTA DEPOK,LIMO,24486,21754,46240
JAWA BARAT,KOTA BEKASI,BEKASI UTARA,96021,73139,169160
JAWA BARAT,KOTA BEKASI,MEDAN SATRIA,43566,38727,82293
JAWA BARAT,KOTA DEPOK,CIPAYUNG,42982,28859,71841
JAWA BARAT,KOTA BEKASI,BEKASI BARAT,79543,67270,146813
JAWA BARAT,KOTA CIMAHI,CIMAHI SELATAN,85382,43134,128516
JAWA BARAT,KOTA TASIKMALAYA,INDIHIANG,22235,6874,29109
JAWA BARAT,KOTA TASIKMALAYA,BUNGURSARI,20866,7088,27954
JAWA BARAT,KOTA DEPOK,SUKMAJAYA,72187,58823,131010
JAWA BARAT,KOTA TASIKMALAYA,CIBEUREUM,28649,8063,36712
JAWA BARAT,KOTA TASIKMALAYA,MANGKUBUMI,38334,12700,51034
JAWA BARAT,KOTA CIMAHI,CIMAHI TENGAH,59660,28868,88528
JAWA BARAT,KOTA DEPOK,BEJI,46679,35554,82233
JAWA BARAT,KOTA DEPOK,CIMANGGIS,67903,57582,125485
JAWA BARAT,KOTA BANJAR,PATARUMAN,17984,15160,33144
JAWA BARAT,KOTA TASIKMALAYA,KAWALU,38167,11917,50084
JAWA BARAT,KOTA BANJAR,LANGEN SARI,12508,15561,28069
JAWA TENGAH,CILACAP,DAYEUHLUHUR,0,0,0
JAWA BARAT,KOTA TASIKMALAYA,TAMANSARI,28315,8268,36583
JAWA BARAT,KOTA CIMAHI,CIMAHI UTARA,53456,32237,85693
JAWA BARAT,KOTA TASIKMALAYA,CIHIDEUNG,25963,16277,42240
JAWA BARAT,KOTA DEPOK,BOJONGSARI,33956,23710,57666
JAWA BARAT,KOTA TASIKMALAYA,TAWANG,26321,11037,37358
JAWA TENGAH,CILACAP,WANAREJA,0,0,0
JAWA BARAT,KOTA TASIKMALAYA,CIPEDES,33848,11706,45554
JAWA BARAT,KOTA BANJAR,PURWAHARJA,7099,5856,12955
JAWA BARAT,KOTA BANJAR,BANJAR,18978,13087,32065
JAWA TENGAH,CILACAP,KROYA,0,0,0
JAWA TENGAH,CILACAP,GANDRUNGMANGU,0,0,0
JAWA BARAT,KOTA TASIKMALAYA,PURBARATU,18967,5377,24344
JAWA TENGAH,CILACAP,SIDAREJA,0,0,0
JAWA TENGAH,CILACAP,BINANGUN,0,0,0
JAWA TENGAH,CILACAP,CILACAP SELATAN,0,0,0
JAWA TENGAH,CILACAP,KAWUNGANTEN,0,0,0
JAWA TENGAH,CILACAP,CILACAP TENGAH,0,0,0
JAWA TENGAH,CILACAP,CIPARI,0,0,0
JAWA TENGAH,CILACAP,ADIPALA,0,0,0
JAWA TENGAH,CILACAP,KARANGPUCUNG,0,0,0
JAWA TENGAH,CILACAP,JERUKLEGI,0,0,0
JAWA TENGAH,CILACAP,KESUGIHAN,0,0,0
JAWA TENGAH,CILACAP,PATIMUAN,0,0,0
JAWA TENGAH,BANYUMAS,LUMBIR,0,0,0
JAWA TENGAH,CILACAP,CILACAP UTARA,0,0,0
JAWA TENGAH,CILACAP,CIMANGGU,0,0,0
JAWA TENGAH,CILACAP,NUSAWUNGU,0,0,0
JAWA TENGAH,CILACAP,SAMPANG,0,0,0
JAWA TENGAH,CILACAP,MAJENANG,0,0,0
JAWA TENGAH,CILACAP,BANTARSARI,0,0,0
JAWA TENGAH,CILACAP,MAOS,0,0,0
JAWA TENGAH,BANYUMAS,PEKUNCEN,0,0,0
JAWA TENGAH,BANYUMAS,PURWOJATI,0,0,0
JAWA TENGAH,CILACAP,KAMPUNG LAUT,0,0,0
JAWA TENGAH,BANYUMAS,PURWOKERTO SELATAN,0,0,0
JAWA TENGAH,BANYUMAS,PURWOKERTO BARAT,0,0,0
JAWA TENGAH,BANYUMAS,SOKARAJA,0,0,0
JAWA TENGAH,BANYUMAS,KEMBARAN,0,0,0
JAWA TENGAH,BANYUMAS,KEMRANJEN,0,0,0
JAWA TENGAH,BANYUMAS,GUMELAR,0,0,0
JAWA TENGAH,BANYUMAS,WANGON,0,0,0
JAWA TENGAH,BANYUMAS,KARANG LEWAS,0,0,0
JAWA TENGAH,CILACAP,KEDUNGREJA,0,0,0
JAWA TENGAH,BANYUMAS,PURWOKERTO TIMUR,0,0,0
JAWA TENGAH,BANYUMAS,KEDUNG BANTENG,0,0,0
JAWA TENGAH,BANYUMAS,JATILAWANG,0,0,0
JAWA TENGAH,BANYUMAS,CILONGOK,0,0,0
JAWA TENGAH,BANYUMAS,KALIBAGOR,0,0,0
JAWA TENGAH,BANYUMAS,TAMBAK,0,0,0
JAWA TENGAH,BANYUMAS,PURWOKERTO UTARA,0,0,0
JAWA TENGAH,BANYUMAS,SUMBANG,0,0,0
JAWA TENGAH,PURBALINGGA,KEMANGKON,13931,19774,33705
JAWA TENGAH,BANYUMAS,RAWALO,0,0,0
JAWA TENGAH,BANYUMAS,AJIBARANG,0,0,0
JAWA TENGAH,BANYUMAS,BATURADEN,0,0,0
JAWA TENGAH,PURBALINGGA,KARANGREJA,7491,14615,22106
JAWA TENGAH,BANYUMAS,PATIKRAJA,0,0,0
JAWA TENGAH,PURBALINGGA,PURBALINGGA,15054,18887,33941
JAWA TENGAH,PURBALINGGA,REMBANG,8720,23459,32179
JAWA TENGAH,BANYUMAS,KEBASEN,0,0,0
JAWA TENGAH,BANYUMAS,SOMAGEDE,0,0,0
JAWA TENGAH,PURBALINGGA,PADAMARA,9478,14890,24368
JAWA TENGAH,PURBALINGGA,PENGADEGAN,5974,14530,20504
JAWA TENGAH,BANYUMAS,SUMPIUH,0,0,0
JAWA TENGAH,PURBALINGGA,KEJOBONG,7690,17272,24962
JAWA TENGAH,PURBALINGGA,KALIGONDANG,12111,22273,34384
JAWA TENGAH,BANYUMAS,BANYUMAS,0,0,0
JAWA TENGAH,PURBALINGGA,KARANGMONCOL,9902,17958,27860
JAWA TENGAH,BANJARNEGARA,KARANGKOBAR,7129,9373,16502
JAWA TENGAH,PURBALINGGA,BOBOTSARI,12439,15550,27989
JAWA TENGAH,PURBALINGGA,KALIMANAH,12142,19189,31331
JAWA TENGAH,PURBALINGGA,KARANGJAMBU,3463,9131,12594
JAWA TENGAH,PURBALINGGA,KARANGANYAR,6964,11818,18782
JAWA TENGAH,BANJARNEGARA,PAGENTAN,9118,11668,20786
JAWA TENGAH,PURBALINGGA,BOJONGSARI,12041,20961,33002
JAWA TENGAH,PURBALINGGA,KUTASARI,11227,21440,32667
JAWA TENGAH,PURBALINGGA,MREBET,13984,24042,38026
JAWA TENGAH,BANJARNEGARA,WANADADI,8648,8755,17403
JAWA TENGAH,BANJARNEGARA,KALIBENING,8477,14232,22709
JAWA TENGAH,BANJARNEGARA,SUSUKAN,8424,21251,29675
JAWA TENGAH,BANJARNEGARA,WANAYASA,11278,15366,26644
JAWA TENGAH,BANJARNEGARA,MANDIRAJA,10397,28500,38897
JAWA TENGAH,BANJARNEGARA,BANJARMANGU,10445,14949,25394
JAWA TENGAH,BANJARNEGARA,BAWANG,13130,19371,32501
JAWA TENGAH,PURBALINGGA,BUKATEJA,14990,24535,39525
JAWA TENGAH,PURBALINGGA,KERTANEGARA,6272,10380,16652
JAWA TENGAH,BANJARNEGARA,PURWONEGORO,12581,27956,40537
JAWA TENGAH,BANJARNEGARA,RAKIT,11091,16787,27878
JAWA TENGAH,BANJARNEGARA,PURWOREJO KLAMPOK,7931,16308,24239
JAWA TENGAH,BANJARNEGARA,PANDANARUM,2995,8403,11398
JAWA TENGAH,BANJARNEGARA,BATUR,9298,11097,20395
JAWA TENGAH,BANJARNEGARA,PEJAWARAN,11927,11288,23215
JAWA TENGAH,KEBUMEN,ROWOKELE,8509,15511,24020
JAWA TENGAH,BANJARNEGARA,PUNGGELAN,13062,25992,39054
JAWA TENGAH,KEBUMEN,KUWARASAN,10067,15930,25997
JAWA TENGAH,KEBUMEN,KARANGGAYAM,6107,20798,26905
JAWA TENGAH,BANJARNEGARA,MADUKARA,11070,15521,26591
JAWA TENGAH,KEBUMEN,SADANG,2220,6951,9171
JAWA TENGAH,KEBUMEN,GOMBONG,12332,15076,27408
JAWA TENGAH,KEBUMEN,PONCOWARNO,3246,5397,8643
JAWA TENGAH,KEBUMEN,SEMPOR,10001,22363,32364
JAWA TENGAH,KEBUMEN,AYAH,10641,23694,34335
JAWA TENGAH,BANJARNEGARA,BANJARNEGARA,17746,20147,37893
JAWA TENGAH,KEBUMEN,ADIMULYO,9066,11729,20795
JAWA TENGAH,BANJARNEGARA,SIGALUH,6561,11520,18081
JAWA TENGAH,KEBUMEN,AMBAL,12297,20296,32593
JAWA TENGAH,KEBUMEN,KUTOWINANGUN,11153,14001,25154
JAWA TENGAH,KEBUMEN,KARANGANYAR,7625,11814,19439
JAWA TENGAH,KEBUMEN,PETANAHAN,12904,19186,32090
JAWA TENGAH,KEBUMEN,BONOROWO,5504,5349,10853
JAWA TENGAH,KEBUMEN,ALIAN,11453,17734,29187
JAWA TENGAH,BANJARNEGARA,PAGEDONGAN,5590,13914,19504
JAWA TENGAH,PURWOREJO,LOANO,7521,13671,21192
JAWA TENGAH,KEBUMEN,BUAYAN,8410,22801,31211
JAWA TENGAH,KEBUMEN,MIRIT,10378,15578,25956
JAWA TENGAH,KEBUMEN,PREMBUN,6738,8532,15270
JAWA TENGAH,KEBUMEN,SRUWENG,10424,19320,29744
JAWA TENGAH,KEBUMEN,KEBUMEN,30788,36174,66962
JAWA TENGAH,PURWOREJO,KUTOARJO,12953,22397,35350
JAWA TENGAH,KEBUMEN,PEJAGOAN,10655,16232,26887
JAWA TENGAH,KEBUMEN,PADURESO,3261,4863,8124
JAWA TENGAH,KEBUMEN,KLIRONG,13143,20913,34056
JAWA TENGAH,PURWOREJO,BRUNO,8499,15908,24407
JAWA TENGAH,PURWOREJO,BAYAN,12064,15807,27871
JAWA TENGAH,KEBUMEN,KARANGSAMBUNG,6506,13853,20359
JAWA TENGAH,KEBUMEN,PURING,10742,20932,31674
JAWA TENGAH,KEBUMEN,BULUSPESANTREN,13136,17686,30822
JAWA TENGAH,PURWOREJO,PURWOREJO,18554,30028,48582
JAWA TENGAH,WONOSOBO,GARUNG,0,0,0
JAWA TENGAH,WONOSOBO,SUKOHARJO,0,0,0
JAWA TENGAH,PURWOREJO,GEBANG,8798,14459,23257
JAWA TENGAH,PURWOREJO,PURWODADI,9433,13627,23060
JAWA TENGAH,PURWOREJO,NGOMBOL,9261,10759,20020
JAWA TENGAH,PURWOREJO,BAGELEN,6328,11504,17832
JAWA TENGAH,PURWOREJO,GRABAG,10894,16055,26949
JAWA TENGAH,PURWOREJO,KALIGESING,6164,12561,18725
JAWA TENGAH,WONOSOBO,WONOSOBO,0,0,0
JAWA TENGAH,PURWOREJO,PITURUH,11661,17261,28922
JAWA TENGAH,PURWOREJO,BANYU URIP,11057,13138,24195
JAWA TENGAH,WONOSOBO,KALIKAJAR,0,0,0
JAWA TENGAH,PURWOREJO,BENER,9630,21076,30706
JAWA TENGAH,WONOSOBO,LEKSONO,0,0,0
JAWA TENGAH,PURWOREJO,BUTUH,11133,13463,24596
JAWA TENGAH,PURWOREJO,KEMIRI,12240,20532,32772
JAWA TENGAH,WONOSOBO,KALIBAWANG,0,0,0
JAWA TENGAH,WONOSOBO,KALIWIRO,0,0,0
JAWA TENGAH,WONOSOBO,KEJAJAR,0,0,0
JAWA TENGAH,MAGELANG,NGABLAK,9563,17025,26588
JAWA TENGAH,WONOSOBO,WATUMALANG,0,0,0
JAWA TENGAH,WONOSOBO,WADASLINTANG,0,0,0
JAWA TENGAH,MAGELANG,PAKIS,12748,22325,35073
JAWA TENGAH,WONOSOBO,MOJOTENGAH,0,0,0
JAWA TENGAH,MAGELANG,TEGALREJO,13883,18847,32730
JAWA TENGAH,WONOSOBO,KERTEK,0,0,0
JAWA TENGAH,WONOSOBO,SELOMERTO,0,0,0
JAWA TENGAH,WONOSOBO,KEPIL,0,0,0
JAWA TENGAH,MAGELANG,KALIANGKRIK,15494,15799,31293
JAWA TENGAH,WONOSOBO,SAPURAN,0,0,0
JAWA TENGAH,MAGELANG,MERTOYUDAN,33186,30995,64181
JAWA TENGAH,MAGELANG,GRABAG,19900,32681,52581
JAWA TENGAH,MAGELANG,BANDONGAN,17942,15428,33370
JAWA TENGAH,MAGELANG,CANDIMULYO,11691,17803,29494
JAWA TENGAH,MAGELANG,SRUMBUNG,16696,13113,29809
JAWA TENGAH,MAGELANG,KAJORAN,13389,18419,31808
JAWA TENGAH,MAGELANG,SALAMAN,17373,23159,40532
JAWA TENGAH,MAGELANG,TEMPURAN,12774,15842,28616
JAWA TENGAH,MAGELANG,SECANG,20741,24914,45655
JAWA TENGAH,MAGELANG,SAWANGAN,17488,18322,35810
JAWA TENGAH,BOYOLALI,ANDONG,0,0,0
JAWA TENGAH,MAGELANG,NGLUWAR,9337,10753,20090
JAWA TENGAH,BOYOLALI,SELO,0,0,0
JAWA TENGAH,BOYOLALI,WONOSEGORO,0,0,0
JAWA TENGAH,MAGELANG,DUKUN,14303,14673,28976
JAWA TENGAH,BOYOLALI,NGEMPLAK,0,0,0
JAWA TENGAH,MAGELANG,BOROBUDUR,15105,21472,36577
JAWA TENGAH,BOYOLALI,KARANGGEDE,0,0,0
JAWA TENGAH,BOYOLALI,KEMUSU,0,0,0
JAWA TENGAH,MAGELANG,MUNGKID,24554,19692,44246
JAWA TENGAH,BOYOLALI,MOJOSONGO,0,0,0
JAWA TENGAH,MAGELANG,WINDUSARI,13455,14745,28200
JAWA TENGAH,MAGELANG,SALAM,13752,14992,28744
JAWA TENGAH,BOYOLALI,BANYUDONO,0,0,0
JAWA TENGAH,MAGELANG,MUNTILAN,22031,26459,48490
JAWA TENGAH,BOYOLALI,KLEGO,0,0,0
JAWA TENGAH,BOYOLALI,NOGOSARI,0,0,0
JAWA TENGAH,KLATEN,PRAMBANAN,9270,21236,30506
JAWA TENGAH,KLATEN,DELANGGU,7808,18067,25875
JAWA TENGAH,KLATEN,WONOSARI,8479,29319,37798
JAWA TENGAH,KLATEN,POLANHARJO,6885,17727,24612
JAWA TENGAH,BOYOLALI,BOYOLALI,0,0,0
JAWA TENGAH,BOYOLALI,MUSUK,0,0,0
JAWA TENGAH,BOYOLALI,SIMO,0,0,0
JAWA TENGAH,BOYOLALI,SAMBI,0,0,0
JAWA TENGAH,BOYOLALI,CEPOGO,0,0,0
JAWA TENGAH,KLATEN,KALIKOTES,4765,15657,20422
JAWA TENGAH,KLATEN,KEMALANG,4732,17473,22205
JAWA TENGAH,BOYOLALI,JUWANGI,0,0,0
JAWA TENGAH,KLATEN,KARANGANOM,8006,19403,27409
JAWA TENGAH,BOYOLALI,TERAS,0,0,0
JAWA TENGAH,KLATEN,WEDI,7174,22879,30053
JAWA TENGAH,BOYOLALI,AMPEL,0,0,0
JAWA TENGAH,KLATEN,KLATEN TENGAH,6523,18523,25046
JAWA TENGAH,BOYOLALI,SAWIT,0,0,0
JAWA TENGAH,KLATEN,KARANGNONGKO,5401,16492,21893
JAWA TENGAH,KLATEN,KARANGDOWO,6134,20527,26661
JAWA TENGAH,KLATEN,BAYAT,6099,29007,35106
JAWA TENGAH,KLATEN,TULUNG,8231,22597,30828
JAWA TENGAH,KLATEN,JOGONALAN,7895,26771,34666
JAWA TENGAH,KLATEN,JUWIRING,8739,26529,35268
JAWA TENGAH,KLATEN,CEPER,9106,29853,38959
JAWA TENGAH,KLATEN,JATINOM,10251,24032,34283
JAWA TENGAH,KLATEN,TRUCUK,10171,35820,45991
JAWA TENGAH,SUKOHARJO,WERU,7190,25137,32327
JAWA TENGAH,KLATEN,PEDAN,5420,23192,28612
JAWA TENGAH,KLATEN,NGAWEN,9630,17000,26630
JAWA TENGAH,KLATEN,MANISRENGGO,6896,19169,26065
JAWA TENGAH,KLATEN,KLATEN UTARA,8653,19462,28115
JAWA TENGAH,KLATEN,CAWAS,6257,28114,34371
JAWA TENGAH,KLATEN,GANTIWARNO,5769,17131,22900
JAWA TENGAH,SUKOHARJO,GROGOL,13250,58599,71849
JAWA TENGAH,SUKOHARJO,BENDOSARI,6937,28495,35432
JAWA TENGAH,KLATEN,KEBONARUM,3429,8561,11990
JAWA TENGAH,WONOGIRI,PRACIMANTORO,0,0,0
JAWA TENGAH,SUKOHARJO,BAKI,7721,34193,41914
JAWA TENGAH,SUKOHARJO,GATAK,6873,24498,31371
JAWA TENGAH,SUKOHARJO,MOJOLABAN,11426,43611,55037
JAWA TENGAH,SUKOHARJO,NGUTER,6397,24346,30743
JAWA TENGAH,SUKOHARJO,SUKOHARJO,11529,43070,54599
JAWA TENGAH,KLATEN,KLATEN SELATAN,7312,18090,25402
JAWA TENGAH,SUKOHARJO,TAWANGSARI,5419,25354,30773
JAWA TENGAH,SUKOHARJO,POLOKARTO,9654,39609,49263
JAWA TENGAH,WONOGIRI,JATIROTO,0,0,0
JAWA TENGAH,SUKOHARJO,KARTASURA,16335,46712,63047
JAWA TENGAH,SUKOHARJO,BULU,3086,17874,20960
JAWA TENGAH,WONOGIRI,KARANGTENGAH,0,0,0
JAWA TENGAH,WONOGIRI,NGADIROJO,0,0,0
JAWA TENGAH,WONOGIRI,SLOGOHIMO,0,0,0
JAWA TENGAH,WONOGIRI,KISMANTORO,0,0,0
JAWA TENGAH,WONOGIRI,BATUWARNO,0,0,0
JAWA TENGAH,WONOGIRI,GIRIWOYO,0,0,0
JAWA TENGAH,WONOGIRI,BULUKERTO,0,0,0
JAWA TENGAH,WONOGIRI,JATISRONO,0,0,0
JAWA TENGAH,WONOGIRI,PURWANTORO,0,0,0
JAWA TENGAH,WONOGIRI,TIRTOMOYO,0,0,0
JAWA TENGAH,WONOGIRI,PARANGGUPITO,0,0,0
JAWA TENGAH,WONOGIRI,NGUNTORONADI,0,0,0
JAWA TENGAH,KARANGANYAR,KERJO,5938,15807,21745
JAWA TENGAH,WONOGIRI,GIRITONTRO,0,0,0
JAWA TENGAH,WONOGIRI,JATIPURNO,0,0,0
JAWA TENGAH,WONOGIRI,SIDOARJO,0,0,0
JAWA TENGAH,WONOGIRI,GIRIMARTO,0,0,0
JAWA TENGAH,WONOGIRI,WONOGIRI,0,0,0
JAWA TENGAH,KARANGANYAR,JATEN,14067,35499,49566
JAWA TENGAH,KARANGANYAR,GONDANGREJO,9237,37052,46289
JAWA TENGAH,KARANGANYAR,MOJOGEDANG,10628,28389,39017
JAWA TENGAH,WONOGIRI,BATURETNO,0,0,0
JAWA TENGAH,WONOGIRI,MANYARAN,0,0,0
JAWA TENGAH,KARANGANYAR,TASIKMADU,12679,24697,37376
JAWA TENGAH,KARANGANYAR,JATIPURO,5041,15091,20132
JAWA TENGAH,KARANGANYAR,KARANGPANDAN,6132,19212,25344
JAWA TENGAH,KARANGANYAR,TAWANGMANGU,7771,19101,26872
JAWA TENGAH,KARANGANYAR,MATESIH,8547,17353,25900
JAWA TENGAH,WONOGIRI,WURYANTORO,0,0,0
JAWA TENGAH,WONOGIRI,PUHPELEM,0,0,0
JAWA TENGAH,KARANGANYAR,JUMAPOLO,5192,18740,23932
JAWA TENGAH,WONOGIRI,EROMOKO,0,0,0
JAWA TENGAH,SRAGEN,KALIJAMBE,6955,21888,28843
JAWA TENGAH,KARANGANYAR,COLOMADU,9659,29553,39212
JAWA TENGAH,KARANGANYAR,JUMANTONO,7001,20883,27884
JAWA TENGAH,SRAGEN,SUMBERLAWANG,5418,22456,27874
JAWA TENGAH,WONOGIRI,SELOGIRI,0,0,0
JAWA TENGAH,KARANGANYAR,KEBAKKRAMAT,11593,27950,39543
JAWA TENGAH,KARANGANYAR,KARANGANYAR,15636,33038,48674
JAWA TENGAH,SRAGEN,SUKODONO,4950,13747,18697
JAWA TENGAH,SRAGEN,TANGEN,3721,12285,16006
JAWA TENGAH,KARANGANYAR,JATIYOSO,5870,18143,24013
JAWA TENGAH,KARANGANYAR,JENAWI,4628,11445,16073
JAWA TENGAH,KARANGANYAR,NGARGOYOSO,5936,15203,21139
JAWA TENGAH,SRAGEN,KEDAWUNG,8015,28446,36461
JAWA TENGAH,SRAGEN,SAMBIREJO,4598,16842,21440
JAWA TENGAH,SRAGEN,MASARAN,12587,31576,44163
JAWA TENGAH,SRAGEN,MONDOKAN,3017,16991,20008
JAWA TENGAH,SRAGEN,GEMOLONG,7463,21287,28750
JAWA TENGAH,SRAGEN,PLUPUH,5491,23320,28811
JAWA TENGAH,SRAGEN,TANON,7401,24706,32107
JAWA TENGAH,SRAGEN,SAMBUNGMACAN,6830,21354,28184
JAWA TENGAH,SRAGEN,GONDANG,6765,19745,26510
JAWA TENGAH,GROBOGAN,GODONG,13901,28913,42814
JAWA TENGAH,SRAGEN,MIRI,4092,16251,20343
JAWA TENGAH,SRAGEN,GESI,2482,10120,12602
JAWA TENGAH,SRAGEN,SRAGEN,11832,29784,41616
JAWA TENGAH,SRAGEN,SIDOHARJO,8627,24429,33056
JAWA TENGAH,GROBOGAN,PURWODADI,21586,50862,72448
JAWA TENGAH,GROBOGAN,BRATI,6648,18786,25434
JAWA TENGAH,SRAGEN,KARANGMALANG,11753,27460,39213
JAWA TENGAH,GROBOGAN,KEDUNGJATI,7492,14829,22321
JAWA TENGAH,GROBOGAN,NGARINGAN,9803,26044,35847
JAWA TENGAH,GROBOGAN,GUBUG,14325,26451,40776
JAWA TENGAH,SRAGEN,NGRAMPAL,5900,18235,24135
JAWA TENGAH,GROBOGAN,WIROSARI,12161,36063,48224
JAWA TENGAH,GROBOGAN,GEYER,7805,28142,35947
JAWA TENGAH,GROBOGAN,PULOKULON,11612,42594,54206
JAWA TENGAH,GROBOGAN,KRADENAN,0,0,0
JAWA TENGAH,GROBOGAN,TEGOWANU,0,0,0
JAWA TENGAH,GROBOGAN,KLAMBU,5873,13065,18938
JAWA TENGAH,GROBOGAN,TANGGUNGHARJO,5959,15222,21181
JAWA TENGAH,SRAGEN,JENAR,3148,13503,16651
JAWA TENGAH,BLORA,TUNJUNGAN,8613,17922,26535
JAWA TENGAH,BLORA,BOGOREJO,4608,10353,14961
JAWA TENGAH,BLORA,BANJAREJO,9915,23146,33061
JAWA TENGAH,GROBOGAN,TOROH,13613,45775,59388
JAWA TENGAH,GROBOGAN,PENAWANGAN,0,0,0
JAWA TENGAH,GROBOGAN,GABUS,7148,31642,38790
JAWA TENGAH,BLORA,NGAWEN,9861,22473,32334
JAWA TENGAH,BLORA,KUNDURAN,10510,26782,37292
JAWA TENGAH,GROBOGAN,GROBOGAN,0,0,0
JAWA TENGAH,GROBOGAN,TAWANGHARJO,6580,20819,27399
JAWA TENGAH,BLORA,RANDUBLATUNG,17055,26235,43290
JAWA TENGAH,BLORA,JATI,7985,20211,28196
JAWA TENGAH,REMBANG,KRAGAN,10997,27224,38221
JAWA TENGAH,BLORA,TODANAN,8624,28624,37248
JAWA TENGAH,REMBANG,PANCUR,6739,10696,17435
JAWA TENGAH,REMBANG,SLUKE,4362,11608,15970
JAWA TENGAH,REMBANG,SEDAN,14521,15279,29800
JAWA TENGAH,BLORA,JAPAH,5611,14762,20373
JAWA TENGAH,GROBOGAN,KARANGRAYUNG,9705,36188,45893
JAWA TENGAH,BLORA,CEPU,17183,26112,43295
JAWA TENGAH,REMBANG,PAMOTAN,10768,16246,27014
JAWA TENGAH,BLORA,JEPON,11059,25040,36099
JAWA TENGAH,BLORA,BLORA,17306,36975,54281
JAWA TENGAH,REMBANG,SARANG,18747,18177,36924
JAWA TENGAH,BLORA,JIKEN,8277,14033,22310
JAWA TENGAH,BLORA,KEDUNGTUBAN,12561,19001,31562
JAWA TENGAH,BLORA,KRADENAN,8749,14372,23121
JAWA TENGAH,REMBANG,BULU,4549,12279,16828
JAWA TENGAH,REMBANG,SUMBER,5634,16868,22502
JAWA TENGAH,BLORA,SAMBONG,6789,9135,15924
JAWA TENGAH,REMBANG,SALE,7307,14943,22250
JAWA TENGAH,PATI,GEMBONG,0,0,0
JAWA TENGAH,REMBANG,GUNEM,4882,9641,14523
JAWA TENGAH,REMBANG,KALIORI,5943,19617,25560
JAWA TENGAH,PATI,SUKOLILO,0,0,0
JAWA TENGAH,PATI,CLUWAK,0,0,0
JAWA TENGAH,REMBANG,REMBANG,16407,36968,53375
JAWA TENGAH,REMBANG,LASEM,9135,18839,27974
JAWA TENGAH,PATI,GUNUNGWUNGKAL,0,0,0
JAWA TENGAH,PATI,GABUS,0,0,0
JAWA TENGAH,REMBANG,SULANG,6463,17008,23471
JAWA TENGAH,PATI,PUCAKWANGI,0,0,0
JAWA TENGAH,PATI,WINONG,0,0,0
JAWA TENGAH,PATI,TAYU,0,0,0
JAWA TENGAH,PATI,JUWANA,0,0,0
JAWA TENGAH,PATI,MARGOREJO,0,0,0
JAWA TENGAH,KUDUS,JATI,26868,33698,60566
JAWA TENGAH,PATI,WEDARIJAKSA,0,0,0
JAWA TENGAH,PATI,JAKENAN,0,0,0
JAWA TENGAH,PATI,MARGOYOSO,0,0,0
JAWA TENGAH,KUDUS,UNDAAN,16934,23930,40864
JAWA TENGAH,PATI,TAMBAKROMO,0,0,0
JAWA TENGAH,PATI,TLOGOWUNGU,0,0,0
JAWA TENGAH,PATI,BATANGAN,0,0,0
JAWA TENGAH,KUDUS,BAE,18224,20862,39086
JAWA TENGAH,KUDUS,KALIWUNGU,23864,27994,51858
JAWA TENGAH,PATI,DUKUHSETI,0,0,0
JAWA TENGAH,JEPARA,KEMBANG,9721,29304,39025
JAWA TENGAH,JEPARA,KALINYAMATAN,13022,19165,32187
JAWA TENGAH,PATI,KAYEN,0,0,0
JAWA TENGAH,PATI,PATI,0,0,0
JAWA TENGAH,JEPARA,TAHUNAN,13514,44946,58460
JAWA TENGAH,KUDUS,KUDUS,22734,31777,54511
JAWA TENGAH,JEPARA,MLONGGO,12133,30670,42803
JAWA TENGAH,KUDUS,JEKULO,28108,31031,59139
JAWA TENGAH,JEPARA,BATEALIT,14389,29415,43804
JAWA TENGAH,PATI,JAKEN,0,0,0
JAWA TENGAH,PATI,TRANGKIL,0,0,0
JAWA TENGAH,KUDUS,MEJOBO,18295,24893,43188
JAWA TENGAH,JEPARA,JEPARA,12818,31196,44014
JAWA TENGAH,KUDUS,DAWE,19856,35716,55572
JAWA TENGAH,JEPARA,PAKIS AJI,8124,22394,30518
JAWA TENGAH,JEPARA,KARIMUN JAWA,988,3728,4716
JAWA TENGAH,JEPARA,KELING,8011,27254,35265
JAWA TENGAH,DEMAK,BONANG,17262,31864,49126
JAWA TENGAH,KUDUS,GEBOG,20288,30483,50771
JAWA TENGAH,DEMAK,DEMAK,23527,34470,57997
JAWA TENGAH,DEMAK,WEDUNG,13575,23916,37491
JAWA TENGAH,JEPARA,KEDUNG,11714,25211,36925
JAWA TENGAH,JEPARA,DONOROJO,8575,23119,31694
JAWA TENGAH,JEPARA,BANGSRI,12216,39188,51404
JAWA TENGAH,JEPARA,PECANGAAN,15351,28816,44167
JAWA TENGAH,JEPARA,NALUMSARI,11362,23815,35177
JAWA TENGAH,JEPARA,MAYONG,15329,31047,46376
JAWA TENGAH,DEMAK,KARANGANYAR,12057,24775,36832
JAWA TENGAH,DEMAK,SAYUNG,23464,32286,55750
JAWA TENGAH,DEMAK,WONOSALAM,13927,26713,40640
JAWA TENGAH,JEPARA,WELAHAN,13474,27142,40616
JAWA TENGAH,DEMAK,DEMPET,11194,18571,29765
JAWA TENGAH,SEMARANG,BANCAK,0,0,0
JAWA TENGAH,DEMAK,MRANGGEN,33483,53744,87227
JAWA TENGAH,DEMAK,MIJEN,7974,19891,27865
JAWA TENGAH,SEMARANG,BRINGIN,10165,15684,25849
JAWA TENGAH,SEMARANG,KALIWUNGU,4651,13254,17905
JAWA TENGAH,DEMAK,KARANGAWEN,21766,28299,50065
JAWA TENGAH,SEMARANG,UNGARAN TIMUR,18054,22367,40421
JAWA TENGAH,SEMARANG,AMBARAWA,11319,26255,37574
JAWA TENGAH,SEMARANG,BAWEN,12609,20824,33433
JAWA TENGAH,DEMAK,KARANGTENGAH,11281,21573,32854
JAWA TENGAH,DEMAK,GAJAH,10882,15342,26224
JAWA TENGAH,SEMARANG,PRINGAPUS,11579,17931,29510
JAWA TENGAH,SEMARANG,GETASAN,10042,22729,32771
JAWA TENGAH,SEMARANG,UNGARAN BARAT,0,0,0
JAWA TENGAH,SEMARANG,BANYUBIRU,10196,15343,25539
JAWA TENGAH,SEMARANG,SUMOWONO,8657,10658,19315
JAWA TENGAH,TEMANGGUNG,CANDIROTO,6064,14113,20177
JAWA TENGAH,DEMAK,GUNTUR,16180,25048,41228
JAWA TENGAH,SEMARANG,SUSUKAN,10269,16543,26812
JAWA TENGAH,DEMAK,KEBONAGUNG,7504,13234,20738
JAWA TENGAH,SEMARANG,TUNTANG,14732,24114,38846
JAWA TENGAH,TEMANGGUNG,BULU,10895,19248,30143
JAWA TENGAH,TEMANGGUNG,TRETEP,3881,9132,13013
JAWA TENGAH,SEMARANG,JAMBU,9185,15169,24354
JAWA TENGAH,TEMANGGUNG,KLEDUNG,4990,11960,16950
JAWA TENGAH,SEMARANG,BERGAS,17081,22598,39679
JAWA TENGAH,TEMANGGUNG,TLOGOMULYO,3440,11397,14837
JAWA TENGAH,TEMANGGUNG,KRANGGAN,10216,18722,28938
JAWA TENGAH,TEMANGGUNG,WONOBOYO,6252,9757,16009
JAWA TENGAH,SEMARANG,TENGARAN,16397,24177,40574
JAWA TENGAH,SEMARANG,SURUH,15181,22460,37641
JAWA TENGAH,TEMANGGUNG,TEMANGGUNG,20538,28791,49329
JAWA TENGAH,SEMARANG,BANDUNGAN,13504,20685,34189
JAWA TENGAH,TEMANGGUNG,BANSARI,2509,13190,15699
JAWA TENGAH,SEMARANG,PABELAN,9308,15980,25288
JAWA TENGAH,TEMANGGUNG,KALORAN,9958,17319,27277
JAWA TENGAH,TEMANGGUNG,SELOPAMPANG,5737,6112,11849
JAWA TENGAH,TEMANGGUNG,BEJEN,4610,8161,12771
JAWA TENGAH,TEMANGGUNG,JUMO,5997,12856,18853
JAWA TENGAH,TEMANGGUNG,GEMAWANG,7795,12372,20167
JAWA TENGAH,KENDAL,CEPIRING,12680,16947,29627
JAWA TENGAH,TEMANGGUNG,KEDU,14170,20595,34765
JAWA TENGAH,TEMANGGUNG,NGADIREJO,8857,25266,34123
JAWA TENGAH,KENDAL,RINGINARUM,6427,13844,20271
JAWA TENGAH,TEMANGGUNG,PRINGSURAT,11300,19903,31203
JAWA TENGAH,KENDAL,PLANTUNGAN,6437,9941,16378
JAWA TENGAH,TEMANGGUNG,TEMBARAK,6729,11013,17742
JAWA TENGAH,TEMANGGUNG,KANDANGAN,11985,18354,30339
JAWA TENGAH,KENDAL,KENDAL,16157,16732,32889
JAWA TENGAH,KENDAL,PATEBON,14226,19499,33725
JAWA TENGAH,TEMANGGUNG,PARAKAN,11289,20857,32146
JAWA TENGAH,KENDAL,GEMUH,9810,18419,28229
JAWA TENGAH,KENDAL,KANGKUNG,9276,17177,26453
JAWA TENGAH,KENDAL,BRANGSONG,11991,15921,27912
JAWA TENGAH,KENDAL,SUKOREJO,13853,20273,34126
JAWA TENGAH,KENDAL,PAGERUYUNG,7826,12020,19846
JAWA TENGAH,KENDAL,WELERI,12702,22469,35171
JAWA TENGAH,KENDAL,LIMBANGAN,10447,10122,20569
JAWA TENGAH,KENDAL,BOJA,20544,22772,43316
JAWA TENGAH,KENDAL,KALIWUNGU,17245,18495,35740
JAWA TENGAH,KENDAL,ROWOSARI,9254,19098,28352
JAWA TENGAH,KENDAL,NGAMPEL,7251,11861,19112
JAWA TENGAH,KENDAL,PATEAN,10922,18843,29765
JAWA TENGAH,KENDAL,SINGOROJO,11692,17006,28698
JAWA TENGAH,BATANG,BATANG,26277,46083,72360
JAWA TENGAH,KENDAL,KALIWUNGU SELATAN,11478,15649,27127
JAWA TENGAH,BATANG,WONOTUNGGAL,7244,11974,19218
JAWA TENGAH,KENDAL,PEGANDON,8490,12393,20883
JAWA TENGAH,BATANG,WARUNGASEM,8196,19604,27800
JAWA TENGAH,BATANG,REBAN,7790,13289,21079
JAWA TENGAH,PEKALONGAN,SIWALAN,5028,15551,20579
JAWA TENGAH,BATANG,PECALUNGAN,6124,11138,17262
JAWA TENGAH,BATANG,LIMPUNG,8581,16141,24722
JAWA TENGAH,BATANG,GRINGSING,11492,22122,33614
JAWA TENGAH,PEKALONGAN,BUARAN,8427,16765,25192
JAWA TENGAH,PEKALONGAN,KEDUNGWUNI,18124,34767,52891
JAWA TENGAH,BATANG,KANDEMAN,7706,19191,26897
JAWA TENGAH,BATANG,TULIS,6546,14175,20721
JAWA TENGAH,BATANG,SUBAH,9782,21225,31007
JAWA TENGAH,BATANG,BANDAR,11790,22628,34418
JAWA TENGAH,PEKALONGAN,KESESI,11207,22725,33932
JAWA TENGAH,PEKALONGAN,KARANGDADAP,5066,14802,19868
JAWA TENGAH,PEKALONGAN,KAJEN,13019,20409,33428
JAWA TENGAH,BATANG,BLADO,8343,14243,22586
JAWA TENGAH,BATANG,BAWANG,9845,19271,29116
JAWA TENGAH,PEKALONGAN,TIRTO,10309,27694,38003
JAWA TENGAH,BATANG,BANYUPUTIH,5860,14284,20144
JAWA TENGAH,BATANG,TERSONO,9443,13338,22781
JAWA TENGAH,PEKALONGAN,BOJONG,9744,26604,36348
JAWA TENGAH,PEKALONGAN,WIRADESA,11949,20788,32737
JAWA TENGAH,PEKALONGAN,WONOPRINGGO,7341,16203,23544
JAWA TENGAH,PEKALONGAN,KANDANGSERANG,5388,11494,16882
JAWA TENGAH,PEKALONGAN,LEBAKBARANG,1516,4156,5672
JAWA TENGAH,PEKALONGAN,TALUN,4520,10028,14548
JAWA TENGAH,PEMALANG,COMAL,14910,33516,48426
JAWA TENGAH,PEMALANG,PETARUKAN,24473,54920,79393
JAWA TENGAH,PEKALONGAN,PANINGGARAN,6528,11584,18112
JAWA TENGAH,PEKALONGAN,SRAGI,9207,23629,32836
JAWA TENGAH,PEMALANG,MOGA,16932,13775,30707
JAWA TENGAH,PEKALONGAN,KARANGANYAR,7534,13819,21353
JAWA TENGAH,PEKALONGAN,DORO,6561,15336,21897
JAWA TENGAH,PEMALANG,BELIK,15217,36218,51435
JAWA TENGAH,PEMALANG,RANDUDONGKAL,20286,30936,51222
JAWA TENGAH,PEMALANG,AMPELGADING,10478,24394,34872
JAWA TENGAH,PEKALONGAN,PETUNGKRIYONO,2105,4886,6991
JAWA TENGAH,TEGAL,MARGASARI,19655,29269,48924
JAWA TENGAH,PEMALANG,WATUKUMPUL,9018,24996,34014
JAWA TENGAH,PEKALONGAN,WONOKERTO,5019,17005,22024
JAWA TENGAH,PEMALANG,BODEH,9093,20539,29632
JAWA TENGAH,PEMALANG,WARUNGPRING,5630,12705,18335
JAWA TENGAH,PEMALANG,PEMALANG,36843,61976,98819
JAWA TENGAH,PEMALANG,BANTARBOLANG,11943,25472,37415
JAWA TENGAH,PEMALANG,ULUJAMI,14131,42849,56980
JAWA TENGAH,TEGAL,TARUB,14990,24449,39439
JAWA TENGAH,PEMALANG,TAMAN,30608,55755,86363
JAWA TENGAH,TEGAL,LEBAKSIU,15347,26150,41497
JAWA TENGAH,TEGAL,WARUREJA,10329,20342,30671
JAWA TENGAH,TEGAL,SURADADI,14611,28976,43587
JAWA TENGAH,TEGAL,ADIWERNA,25109,40877,65986
JAWA TENGAH,TEGAL,PAGERBARANG,8323,19173,27496
JAWA TENGAH,PEMALANG,PULOSARI,13131,15417,28548
JAWA TENGAH,BREBES,KETANGGUNGAN,26046,42651,68697
JAWA TENGAH,TEGAL,KEDUNGBANTENG,8217,13124,21341
JAWA TENGAH,TEGAL,DUKUHTURI,19389,26580,45969
JAWA TENGAH,TEGAL,KRAMAT,20621,37785,58406
JAWA TENGAH,BREBES,LARANGAN,22164,56845,79009
JAWA TENGAH,TEGAL,JATINEGARA,11341,15294,26635
JAWA TENGAH,TEGAL,BOJONG,15625,17585,33210
JAWA TENGAH,TEGAL,TALANG,21883,31342,53225
JAWA TENGAH,TEGAL,DUKUHWARU,10892,21175,32067
JAWA TENGAH,BREBES,KERSANA,10020,23549,33569
JAWA TENGAH,TEGAL,BALAPULANG,17672,23726,41398
JAWA TENGAH,TEGAL,SLAWI,18385,22878,41263
JAWA TENGAH,TEGAL,BUMIJAWA,20600,21796,42396
JAWA TENGAH,TEGAL,PANGKAH,24861,31440,56301
JAWA TENGAH,BREBES,TONJONG,16354,16615,32969
JAWA TENGAH,BREBES,SALEM,14237,18963,33200
JAWA TENGAH,BREBES,SONGGOM,11284,25903,37187
JAWA TENGAH,BREBES,SIRAMPOG,14264,16062,30326
JAWA TENGAH,BREBES,PAGUYANGAN,0,0,0
JAWA TENGAH,BREBES,WANASARI,22596,54137,76733
JAWA TENGAH,BREBES,JATIBARANG,16384,26810,43194
JAWA TENGAH,BREBES,BANTARKAWUNG,19423,28090,47513
JAWA TENGAH,BREBES,BREBES,30887,53922,84809
JAWA TENGAH,KOTA MAGELANG,MAGELANG TENGAH,10687,17662,28349
JAWA TENGAH,KOTA MAGELANG,MAGELANG SELATAN,10589,13871,24460
JAWA TENGAH,BREBES,BULAKAMBA,0,0,0
JAWA TENGAH,BREBES,LOSARI,19741,44362,64103
JAWA TENGAH,BREBES,TANJUNG,12520,35281,47801
JAWA TENGAH,BREBES,BUMIAYU,24154,29444,53598
JAWA TENGAH,KOTA SURAKARTA,SERENGAN,4760,27542,32302
JAWA TENGAH,BREBES,BANJARHARJO,19197,39128,58325
JAWA TENGAH,KOTA MAGELANG,MAGELANG UTARA,10897,10523,21420
JAWA TENGAH,KOTA SURAKARTA,PASAR KLIWON,9992,40553,50545
JAWA TENGAH,KOTA SEMARANG,MIJEN,15573,19602,35175
JAWA TENGAH,KOTA SURAKARTA,JEBRES,11173,77733,88906
JAWA TENGAH,KOTA SEMARANG,SEMARANG BARAT,25016,65319,90335
JAWA TENGAH,KOTA SURAKARTA,LAWEYAN,11424,47610,59034
JAWA TENGAH,KOTA SEMARANG,TEMBALANG,28756,63864,92620
JAWA TENGAH,KOTA SALATIGA,SIDOREJO,10885,19723,30608
JAWA TENGAH,KOTA SEMARANG,NGALIYAN,31692,45356,77048
JAWA TENGAH,KOTA SALATIGA,ARGOMULYO,9905,16292,26197
JAWA TENGAH,KOTA SEMARANG,SEMARANG TENGAH,7745,29858,37603
JAWA TENGAH,KOTA SURAKARTA,BANJARSARI,15354,90761,106115
JAWA TENGAH,KOTA SEMARANG,TUGU,8304,9716,18020
JAWA TENGAH,KOTA PEKALONGAN,PEKALONGAN BARAT,20534,31442,51976
JAWA TENGAH,KOTA SEMARANG,BANYUMANIK,28471,49308,77779
JAWA TENGAH,KOTA SALATIGA,SIDOMUKTI,9218,15535,24753
JAWA TENGAH,KOTA SEMARANG,CANDISARI,13810,33069,46879
JAWA TENGAH,KOTA PEKALONGAN,PEKALONGAN TIMUR,15273,21727,37000
JAWA TENGAH,KOTA TEGAL,TEGAL TIMUR,19531,23428,42959
JAWA TENGAH,KOTA SEMARANG,GUNUNGPATI,20928,29560,50488
JAWA TENGAH,KOTA SEMARANG,SEMARANG TIMUR,9049,34399,43448
JAWA TENGAH,KOTA SEMARANG,SEMARANG SELATAN,12467,29157,41624
JAWA TENGAH,KOTA SEMARANG,GAYAM SARI,11293,29708,41001
JAWA TENGAH,KOTA SALATIGA,TINGKIR,8620,17114,25734
JAWA TENGAH,KOTA SEMARANG,GAJAH MUNGKUR,11294,23001,34295
DAERAH ISTIMEWA YOGYAKARTA,KULON PROGO,NANGGULAN,9414,9160,18574
DAERAH ISTIMEWA YOGYAKARTA,KULON PROGO,SAMIGALUH,7711,9633,17344
JAWA TENGAH,KOTA SEMARANG,SEMARANG UTARA,16759,53375,70134
DAERAH ISTIMEWA YOGYAKARTA,KULON PROGO,KOKAP,9084,12178,21262
JAWA TENGAH,KOTA SEMARANG,GENUK,18179,37678,55857
JAWA TENGAH,KOTA SEMARANG,PEDURUNGAN,33160,71319,104479
DAERAH ISTIMEWA YOGYAKARTA,KULON PROGO,PENGASIH,14963,15224,30187
JAWA TENGAH,KOTA TEGAL,TEGAL BARAT,13286,22593,35879
DAERAH ISTIMEWA YOGYAKARTA,BANTUL,KASIHAN,29222,35376,64598
DAERAH ISTIMEWA YOGYAKARTA,KULON PROGO,GALUR,10959,9078,20037
DAERAH ISTIMEWA YOGYAKARTA,BANTUL,SEWON,27703,34081,61784
DAERAH ISTIMEWA YOGYAKARTA,KULON PROGO,PANJATAN,11131,11557,22688
JAWA TENGAH,KOTA PEKALONGAN,PEKALONGAN SELATAN,11589,20383,31972
JAWA TENGAH,KOTA PEKALONGAN,PEKALONGAN UTARA,17342,26262,43604
DAERAH ISTIMEWA YOGYAKARTA,BANTUL,PIYUNGAN,14949,17163,32112
JAWA TENGAH,KOTA TEGAL,TEGAL SELATAN,14964,18810,33774
DAERAH ISTIMEWA YOGYAKARTA,KULON PROGO,WATES,13880,15035,28915
DAERAH ISTIMEWA YOGYAKARTA,KULON PROGO,LENDAH,12493,12934,25427
DAERAH ISTIMEWA YOGYAKARTA,BANTUL,SRANDAKAN,8983,10818,19801
DAERAH ISTIMEWA YOGYAKARTA,KULON PROGO,SENTOLO,14700,15069,29769
JAWA TENGAH,KOTA TEGAL,MARGADANA,8131,13944,22075
DAERAH ISTIMEWA YOGYAKARTA,KULON PROGO,TEMON,8037,8308,16345
DAERAH ISTIMEWA YOGYAKARTA,BANTUL,PANDAK,14072,19020,33092
DAERAH ISTIMEWA YOGYAKARTA,KULON PROGO,GIRIMULYO,6704,8515,15219
DAERAH ISTIMEWA YOGYAKARTA,BANTUL,BAMBANGLIPURO,11585,14330,25915
DAERAH ISTIMEWA YOGYAKARTA,GUNUNGKIDUL,WONOSARI,22398,31101,53499
DAERAH ISTIMEWA YOGYAKARTA,BANTUL,KRETEK,9583,9976,19559
DAERAH ISTIMEWA YOGYAKARTA,KULON PROGO,KALIBAWANG,8069,10190,18259
DAERAH ISTIMEWA YOGYAKARTA,BANTUL,JETIS,16802,19291,36093
DAERAH ISTIMEWA YOGYAKARTA,BANTUL,BANTUL,18303,21892,40195
DAERAH ISTIMEWA YOGYAKARTA,BANTUL,DLINGO,8570,15742,24312
DAERAH ISTIMEWA YOGYAKARTA,BANTUL,BANGUNTAPAN,31177,35058,66235
DAERAH ISTIMEWA YOGYAKARTA,GUNUNGKIDUL,NGAWEN,5269,15028,20297
DAERAH ISTIMEWA YOGYAKARTA,BANTUL,PUNDONG,9925,12392,22317
DAERAH ISTIMEWA YOGYAKARTA,BANTUL,PAJANGAN,11335,10788,22123
DAERAH ISTIMEWA YOGYAKARTA,GUNUNGKIDUL,KARANGMOJO,11499,21820,33319
DAERAH ISTIMEWA YOGYAKARTA,BANTUL,PLERET,14595,14050,28645
DAERAH ISTIMEWA YOGYAKARTA,GUNUNGKIDUL,PONJONG,11529,22255,33784
DAERAH ISTIMEWA YOGYAKARTA,GUNUNGKIDUL,GEDANGSARI,5959,15997,21956
DAERAH ISTIMEWA YOGYAKARTA,GUNUNGKIDUL,TEPUS,10484,11824,22308
DAERAH ISTIMEWA YOGYAKARTA,BANTUL,IMOGIRI,17068,21086,38154
DAERAH ISTIMEWA YOGYAKARTA,GUNUNGKIDUL,SAPTOSARI,12112,11430,23542
DAERAH ISTIMEWA YOGYAKARTA,GUNUNGKIDUL,SEMIN,9097,23175,32272
DAERAH ISTIMEWA YOGYAKARTA,GUNUNGKIDUL,GIRISUBO,5073,10338,15411
DAERAH ISTIMEWA YOGYAKARTA,BANTUL,SANDEN,11478,9242,20720
DAERAH ISTIMEWA YOGYAKARTA,GUNUNGKIDUL,TANJUNGSARI,8243,10562,18805
DAERAH ISTIMEWA YOGYAKARTA,GUNUNGKIDUL,SEMANU,13007,23330,36337
DAERAH ISTIMEWA YOGYAKARTA,GUNUNGKIDUL,PATUK,9112,11423,20535
DAERAH ISTIMEWA YOGYAKARTA,GUNUNGKIDUL,PLAYEN,14709,22005,36714
DAERAH ISTIMEWA YOGYAKARTA,BANTUL,SEDAYU,16185,13078,29263
DAERAH ISTIMEWA YOGYAKARTA,GUNUNGKIDUL,PANGGANG,8173,9669,17842
DAERAH ISTIMEWA YOGYAKARTA,SLEMAN,GAMPING,25451,31468,56919
DAERAH ISTIMEWA YOGYAKARTA,GUNUNGKIDUL,RONGKOP,5673,13179,18852
DAERAH ISTIMEWA YOGYAKARTA,SLEMAN,SLEMAN,20163,21812,41975
DAERAH ISTIMEWA YOGYAKARTA,SLEMAN,KALASAN,19563,28393,47956
DAERAH ISTIMEWA YOGYAKARTA,SLEMAN,TURI,12594,10309,22903
DAERAH ISTIMEWA YOGYAKARTA,SLEMAN,PAKEM,10709,12803,23512
DAERAH ISTIMEWA YOGYAKARTA,GUNUNGKIDUL,PALIYAN,9713,9452,19165
DAERAH ISTIMEWA YOGYAKARTA,SLEMAN,SEYEGAN,15947,15002,30949
DAERAH ISTIMEWA YOGYAKARTA,SLEMAN,TEMPEL,18729,14968,33697
DAERAH ISTIMEWA YOGYAKARTA,SLEMAN,MINGGIR,10452,10471,20923
DAERAH ISTIMEWA YOGYAKARTA,SLEMAN,CANGKRINGAN,9108,10086,19194
DAERAH ISTIMEWA YOGYAKARTA,SLEMAN,PRAMBANAN,15005,17018,32023
DAERAH ISTIMEWA YOGYAKARTA,KOTA YOGYAKARTA,TEGALREJO,7783,14307,22090
DAERAH ISTIMEWA YOGYAKARTA,GUNUNGKIDUL,PURWOSARI,5972,6697,12669
DAERAH ISTIMEWA YOGYAKARTA,GUNUNGKIDUL,NGLIPAR,8779,10825,19604
DAERAH ISTIMEWA YOGYAKARTA,SLEMAN,NGEMPLAK,17016,20268,37284
DAERAH ISTIMEWA YOGYAKARTA,SLEMAN,NGAGLIK,24966,33453,58419
DAERAH ISTIMEWA YOGYAKARTA,SLEMAN,MLATI,24638,33318,57956
DAERAH ISTIMEWA YOGYAKARTA,KOTA YOGYAKARTA,MERGANGSAN,7990,11255,19245
DAERAH ISTIMEWA YOGYAKARTA,SLEMAN,BERBAH,14513,17812,32325
DAERAH ISTIMEWA YOGYAKARTA,KOTA YOGYAKARTA,UMBULHARJO,18563,21583,40146
DAERAH ISTIMEWA YOGYAKARTA,SLEMAN,DEPOK,30186,48189,78375
DAERAH ISTIMEWA YOGYAKARTA,KOTA YOGYAKARTA,NGAMPILAN,4916,6038,10954
DAERAH ISTIMEWA YOGYAKARTA,KOTA YOGYAKARTA,MANTRIJERON,8782,12333,21115
DAERAH ISTIMEWA YOGYAKARTA,SLEMAN,MOYUDAN,13727,8127,21854
DAERAH ISTIMEWA YOGYAKARTA,KOTA YOGYAKARTA,GONDOKUSUMAN,8896,17113,26009
DAERAH ISTIMEWA YOGYAKARTA,KOTA YOGYAKARTA,KRATON,5407,7760,13167
DAERAH ISTIMEWA YOGYAKARTA,KOTA YOGYAKARTA,GONDOMANAN,3646,5848,9494
DAERAH ISTIMEWA YOGYAKARTA,SLEMAN,GODEAN,20653,22478,43131
DAERAH ISTIMEWA YOGYAKARTA,KOTA YOGYAKARTA,GEDONGTENGEN,3465,8842,12307
JAWA TIMUR,PACITAN,TEGALOMBO,17277,8915,26192
JAWA TIMUR,PACITAN,BANDAR,15693,8153,23846
JAWA TIMUR,PACITAN,ARJOSARI,15613,6540,22153
DAERAH ISTIMEWA YOGYAKARTA,KOTA YOGYAKARTA,PAKUALAMAN,2362,4628,6990
DAERAH ISTIMEWA YOGYAKARTA,KOTA YOGYAKARTA,WIROBRAJAN,6422,9629,16051
JAWA TIMUR,PACITAN,NGADIROJO,17139,9779,26918
JAWA TIMUR,PACITAN,TULAKAN,26475,16301,42776
DAERAH ISTIMEWA YOGYAKARTA,KOTA YOGYAKARTA,DANUREJAN,4581,8127,12708
JAWA TIMUR,PACITAN,NAWANGAN,14975,10887,25862
JAWA TIMUR,PACITAN,PUNUNG,13649,7683,21332
JAWA TIMUR,PACITAN,KEBONAGUNG,19865,7227,27092
JAWA TIMUR,PACITAN,DONOROJO,9123,11467,20590
JAWA TIMUR,PACITAN,PRINGKUKU,12521,6407,18928
DAERAH ISTIMEWA YOGYAKARTA,KOTA YOGYAKARTA,KOTAGEDE,10404,9285,19689
DAERAH ISTIMEWA YOGYAKARTA,KOTA YOGYAKARTA,JETIS,5224,11152,16376
JAWA TIMUR,PONOROGO,SLAHUNG,14996,14666,29662
JAWA TIMUR,PONOROGO,BABADAN,14499,24784,39283
JAWA TIMUR,PONOROGO,KAUMAN,12564,12829,25393
JAWA TIMUR,PACITAN,PACITAN,34407,9916,44323
JAWA TIMUR,PONOROGO,JENANGAN,16777,16221,32998
JAWA TIMUR,PONOROGO,SAMPUNG,10632,12323,22955
JAWA TIMUR,PACITAN,SUDIMORO,8628,9057,17685
JAWA TIMUR,PONOROGO,SIMAN,12521,12897,25418
JAWA TIMUR,PONOROGO,SAWOO,15828,16810,32638
JAWA TIMUR,PONOROGO,JAMBON,11309,12064,23373
JAWA TIMUR,PONOROGO,SUKOREJO,15545,16161,31706
JAWA TIMUR,PONOROGO,BALONG,14788,11562,26350
JAWA TIMUR,PONOROGO,PULUNG,12483,17518,30001
JAWA TIMUR,PONOROGO,PONOROGO,18820,25393,44213
JAWA TIMUR,PONOROGO,NGEBEL,5685,6621,12306
JAWA TIMUR,PONOROGO,BADEGAN,8115,9204,17319
JAWA TIMUR,PONOROGO,SAMBIT,9681,11922,21603
JAWA TIMUR,PONOROGO,BUNGKAL,11809,10734,22543
JAWA TIMUR,TRENGGALEK,WATULIMO,10066,29747,39813
JAWA TIMUR,PONOROGO,SOOKO,6203,8336,14539
JAWA TIMUR,TRENGGALEK,PANGGUL,11137,28641,39778
JAWA TIMUR,TRENGGALEK,POGALAN,11172,18201,29373
JAWA TIMUR,TRENGGALEK,BENDUNGAN,5583,9649,15232
JAWA TIMUR,TRENGGALEK,KAMPAK,5902,16058,21960
JAWA TIMUR,PONOROGO,NGRAYUN,12722,21510,34232
JAWA TIMUR,TRENGGALEK,DONGKO,7825,25603,33428
JAWA TIMUR,PONOROGO,PUDAK,2970,2712,5682
JAWA TIMUR,TRENGGALEK,TUGU,12137,14949,27086
JAWA TIMUR,TRENGGALEK,DURENAN,11930,17569,29499
JAWA TIMUR,PONOROGO,MLARAK,12714,7859,20573
JAWA TIMUR,TULUNGAGUNG,BESUKI,7599,13921,21520
JAWA TIMUR,TRENGGALEK,TRENGGALEK,17039,21062,38101
JAWA TIMUR,TRENGGALEK,KARANGAN,12466,15590,28056
JAWA TIMUR,TULUNGAGUNG,BANDUNG,9980,17779,27759
JAWA TIMUR,PONOROGO,JETIS,9724,8563,18287
JAWA TIMUR,TRENGGALEK,GANDUSARI,11734,19249,30983
JAWA TIMUR,TULUNGAGUNG,PUCANGLABAN,4458,9089,13547
JAWA TIMUR,TRENGGALEK,SURUH,5876,9368,15244
JAWA TIMUR,TULUNGAGUNG,GONDANG,14908,19048,33956
JAWA TIMUR,TULUNGAGUNG,PAGERWOJO,8214,10649,18863
JAWA TIMUR,TULUNGAGUNG,PAKEL,11449,19477,30926
JAWA TIMUR,TULUNGAGUNG,TULUNGAGUNG,14699,23191,37890
JAWA TIMUR,TULUNGAGUNG,NGANTRU,8797,23505,32302
JAWA TIMUR,TULUNGAGUNG,KARANGREJO,9904,14804,24708
JAWA TIMUR,TRENGGALEK,MUNJUNGAN,7575,22342,29917
JAWA TIMUR,TRENGGALEK,PULE,10538,19744,30282
JAWA TIMUR,TULUNGAGUNG,CAMPURDARAT,9374,24051,33425
JAWA TIMUR,BLITAR,PANGGUNGREJO,0,0,0
JAWA TIMUR,TULUNGAGUNG,KAUMAN,11950,18955,30905
JAWA TIMUR,TULUNGAGUNG,KALIDAWIR,11955,28310,40265
JAWA TIMUR,TULUNGAGUNG,KEDUNGWARU,16708,35162,51870
JAWA TIMUR,TULUNGAGUNG,NGUNUT,13040,32010,45050
JAWA TIMUR,TULUNGAGUNG,SUMBERGEMPOL,11481,26470,37951
JAWA TIMUR,BLITAR,DOKO,0,0,0
JAWA TIMUR,BLITAR,UDANAWU,0,0,0
JAWA TIMUR,BLITAR,GARUM,0,0,0
JAWA TIMUR,TULUNGAGUNG,REJOTANGAN,14204,28079,42283
JAWA TIMUR,TULUNGAGUNG,BOYOLANGU,16835,30131,46966
JAWA TIMUR,TULUNGAGUNG,TANGGUNGGUNUNG,4552,10578,15130
JAWA TIMUR,TULUNGAGUNG,SENDANG,10865,16273,27138
JAWA TIMUR,BLITAR,WLINGI,0,0,0
JAWA TIMUR,BLITAR,BINANGUN,0,0,0
JAWA TIMUR,BLITAR,KESAMBEN,0,0,0
JAWA TIMUR,BLITAR,GANDUSARI,0,0,0
JAWA TIMUR,BLITAR,SANANKULON,0,0,0
JAWA TIMUR,BLITAR,SELOREJO,0,0,0
JAWA TIMUR,BLITAR,KADEMANGAN,0,0,0
JAWA TIMUR,BLITAR,WONODADI,0,0,0
JAWA TIMUR,KEDIRI,PURWOASRI,11936,21501,33437
JAWA TIMUR,KEDIRI,PLEMAHAN,12677,21906,34583
JAWA TIMUR,KEDIRI,PARE,20674,37748,58422
JAWA TIMUR,BLITAR,BAKUNG,0,0,0
JAWA TIMUR,BLITAR,WATES,0,0,0
JAWA TIMUR,BLITAR,NGLEGOK,0,0,0
JAWA TIMUR,BLITAR,SUTOJAYAN,0,0,0
JAWA TIMUR,BLITAR,PONGGOK,0,0,0
JAWA TIMUR,BLITAR,TALUN,0,0,0
JAWA TIMUR,KEDIRI,KAYEN KIDUL,9247,18699,27946
JAWA TIMUR,KEDIRI,KEPUNG,13876,32364,46240
JAWA TIMUR,BLITAR,SRENGAT,0,0,0
JAWA TIMUR,KEDIRI,NGASEM,13247,25408,38655
JAWA TIMUR,KEDIRI,GROGOL,9367,16467,25834
JAWA TIMUR,KEDIRI,SEMEN,9707,20914,30621
JAWA TIMUR,KEDIRI,BANYAKAN,11505,22148,33653
JAWA TIMUR,KEDIRI,WATES,13465,38746,52211
JAWA TIMUR,BLITAR,KANIGORO,0,0,0
JAWA TIMUR,KEDIRI,NGANCAR,5982,21727,27709
JAWA TIMUR,KEDIRI,KUNJANG,8254,12992,21246
JAWA TIMUR,BLITAR,SELOPURO,0,0,0
JAWA TIMUR,KEDIRI,TAROKAN,9554,22442,31996
JAWA TIMUR,BLITAR,WONOTIRTO,0,0,0
JAWA TIMUR,KEDIRI,GAMPENGREJO,7366,12518,19884
JAWA TIMUR,KEDIRI,PAGU,8230,15183,23413
JAWA TIMUR,KEDIRI,KANDANGAN,8494,19369,27863
JAWA TIMUR,KEDIRI,PUNCU,10074,25737,35811
JAWA TIMUR,KEDIRI,RINGINREJO,9061,21873,30934
JAWA TIMUR,MALANG,PAKISAJI,17836,31259,49095
JAWA TIMUR,KEDIRI,PAPAR,10871,18902,29773
JAWA TIMUR,MALANG,DAU,14642,23245,37887
JAWA TIMUR,KEDIRI,KRAS,10200,25411,35611
JAWA TIMUR,MALANG,WAGIR,14463,34501,48964
JAWA TIMUR,KEDIRI,BADAS,14019,21740,35759
JAWA TIMUR,MALANG,NGANTANG,13231,20276,33507
JAWA TIMUR,KEDIRI,NGADILUWIH,13208,31739,44947
JAWA TIMUR,KEDIRI,MOJO,16808,26336,43144
JAWA TIMUR,KEDIRI,KANDAT,9252,25869,35121
JAWA TIMUR,MALANG,PUJON,17902,21338,39240
JAWA TIMUR,MALANG,TIRTOYUDO,12393,23289,35682
JAWA TIMUR,MALANG,WONOSARI,9537,15171,24708
JAWA TIMUR,KEDIRI,GURAH,15386,32517,47903
JAWA TIMUR,MALANG,KROMENGAN,8705,14408,23113
JAWA TIMUR,KEDIRI,PLOSOKLATEN,11969,29200,41169
JAWA TIMUR,MALANG,KASEMBON,6467,10756,17223
JAWA TIMUR,MALANG,SINGOSARI,43782,47263,91045
JAWA TIMUR,MALANG,NGAJUNG,10923,17569,28492
JAWA TIMUR,MALANG,GEDANGAN,10392,19496,29888
JAWA TIMUR,MALANG,DONOMULYO,8124,28058,36182
JAWA TIMUR,MALANG,GONDANGLEGI,21691,20994,42685
JAWA TIMUR,MALANG,PAKIS,30173,45765,75938
JAWA TIMUR,MALANG,PAGAK,8556,16916,25472
JAWA TIMUR,MALANG,KEPANJEN,24592,33423,58015
JAWA TIMUR,MALANG,KARANG PLOSO,16550,26544,43094
JAWA TIMUR,MALANG,SUMBERMANJING WETAN,17100,35864,52964
JAWA TIMUR,MALANG,LAWANG,31481,27924,59405
JAWA TIMUR,MALANG,TAJINAN,12151,18668,30819
JAWA TIMUR,MALANG,WAJAK,17281,30008,47289
JAWA TIMUR,MALANG,BANTUR,11490,27125,38615
JAWA TIMUR,MALANG,PONCOKUSUMO,23156,31534,54690
JAWA TIMUR,LUMAJANG,TEMPURSARI,0,0,0
JAWA TIMUR,LUMAJANG,SUKODONO,14360,15200,29560
JAWA TIMUR,MALANG,AMPELGADING,11041,20283,31324
JAWA TIMUR,MALANG,KALIPARE,10357,25462,35819
JAWA TIMUR,LUMAJANG,KEDUNGJAJANG,0,0,0
JAWA TIMUR,MALANG,JABUNG,16375,24634,41009
JAWA TIMUR,MALANG,BULULAWANG,16368,22176,38544
JAWA TIMUR,LUMAJANG,JATIROTO,0,0,0
JAWA TIMUR,LUMAJANG,KLAKAH,16359,10336,26695
JAWA TIMUR,MALANG,TUMPANG,17312,27449,44761
JAWA TIMUR,LUMAJANG,GUCIALIT,0,0,0
JAWA TIMUR,MALANG,TUREN,24055,40702,64757
JAWA TIMUR,LUMAJANG,PRONOJIWO,6334,11428,17762
JAWA TIMUR,MALANG,DAMPIT,23493,44284,67777
JAWA TIMUR,LUMAJANG,YOSOWILANGUN,15243,18362,33605
JAWA TIMUR,MALANG,SUMBERPUCUNG,11167,19486,30653
JAWA TIMUR,LUMAJANG,RANDUAGUNG,0,0,0
JAWA TIMUR,LUMAJANG,PASRUJAMBE,7063,13338,20401
JAWA TIMUR,LUMAJANG,PADANG,0,0,0
JAWA TIMUR,LUMAJANG,TEKUNG,8668,10536,19204
JAWA TIMUR,LUMAJANG,PASIRIAN,16285,32152,48437
JAWA TIMUR,MALANG,PAGELARAN,16837,19771,36608
JAWA TIMUR,JEMBER,TEMPUREJO,0,0,0
JAWA TIMUR,JEMBER,ARJASA,0,0,0
JAWA TIMUR,LUMAJANG,ROWOKANGKUNG,8658,11691,20349
JAWA TIMUR,JEMBER,MUMBULSARI,0,0,0
JAWA TIMUR,JEMBER,JELBUK,0,0,0
JAWA TIMUR,LUMAJANG,SUMBERSUKO,0,0,0
JAWA TIMUR,LUMAJANG,TEMPEH,0,0,0
JAWA TIMUR,JEMBER,JOMBANG,0,0,0
JAWA TIMUR,JEMBER,KALIWATES,0,0,0
JAWA TIMUR,JEMBER,PATRANG,0,0,0
JAWA TIMUR,JEMBER,AJUNG,0,0,0
JAWA TIMUR,JEMBER,SILO,0,0,0
JAWA TIMUR,LUMAJANG,SENDURO,0,0,0
JAWA TIMUR,JEMBER,MAYANG,0,0,0
JAWA TIMUR,JEMBER,SUKOWONO,0,0,0
JAWA TIMUR,JEMBER,PAKUSARI,0,0,0
JAWA TIMUR,LUMAJANG,RANUYOSO,0,0,0
JAWA TIMUR,JEMBER,GUMUKMAS,0,0,0
JAWA TIMUR,LUMAJANG,CANDIPURO,11381,25790,37171
JAWA TIMUR,JEMBER,KALISAT,0,0,0
JAWA TIMUR,JEMBER,TANGGUL,0,0,0
JAWA TIMUR,LUMAJANG,KUNIR,0,0,0
JAWA TIMUR,JEMBER,SUMBERSARI,0,0,0
JAWA TIMUR,LUMAJANG,LUMAJANG,0,0,0
JAWA TIMUR,JEMBER,SEMBORO,0,0,0
JAWA TIMUR,JEMBER,JENGGAWAH,0,0,0
JAWA TIMUR,JEMBER,SUKORAMBI,0,0,0
JAWA TIMUR,JEMBER,RAMBIPUJI,0,0,0
JAWA TIMUR,JEMBER,BANGSALSARI,0,0,0
JAWA TIMUR,JEMBER,WULUHAN,0,0,0
JAWA TIMUR,BANYUWANGI,GIRI,0,0,0
JAWA TIMUR,JEMBER,AMBULU,0,0,0
JAWA TIMUR,JEMBER,KENCONG,0,0,0
JAWA TIMUR,JEMBER,UMBULSARI,0,0,0
JAWA TIMUR,BANYUWANGI,BANYUWANGI,0,0,0
JAWA TIMUR,JEMBER,LEDOKOMBO,0,0,0
JAWA TIMUR,JEMBER,SUMBERJAMBE,0,0,0
JAWA TIMUR,BANYUWANGI,SEMPU,0,0,0
JAWA TIMUR,BANYUWANGI,KABAT,0,0,0
JAWA TIMUR,BANYUWANGI,GLAGAH,0,0,0
JAWA TIMUR,JEMBER,PANTI,0,0,0
JAWA TIMUR,BANYUWANGI,SONGGON,0,0,0
JAWA TIMUR,JEMBER,SUMBERBARU,0,0,0
JAWA TIMUR,BANYUWANGI,BANGOREJO,0,0,0
JAWA TIMUR,BANYUWANGI,PURWOHARJO,0,0,0
JAWA TIMUR,JEMBER,BALUNG,0,0,0
JAWA TIMUR,JEMBER,PUGER,0,0,0
JAWA TIMUR,BANYUWANGI,GENTENG,0,0,0
JAWA TIMUR,BANYUWANGI,PESANGGARAN,0,0,0
JAWA TIMUR,BANYUWANGI,TEGALDLIMO,0,0,0
JAWA TIMUR,BANYUWANGI,SILIRAGUNG,0,0,0
JAWA TIMUR,BANYUWANGI,TEGALSARI,0,0,0
JAWA TIMUR,BANYUWANGI,KALIPURO,0,0,0
JAWA TIMUR,BANYUWANGI,WONGSOREJO,0,0,0
JAWA TIMUR,BANYUWANGI,ROGOJAMPI,0,0,0
JAWA TIMUR,BANYUWANGI,SINGOJURUH,0,0,0
JAWA TIMUR,BONDOWOSO,PAKEM,5547,8291,13838
JAWA TIMUR,BONDOWOSO,KLABANG,8031,3676,11707
JAWA TIMUR,BANYUWANGI,LICIN,0,0,0
JAWA TIMUR,BONDOWOSO,PRAJEKAN,11161,4564,15725
JAWA TIMUR,BONDOWOSO,TAMAN KROCOK,5982,4726,10708
JAWA TIMUR,BANYUWANGI,GAMBIRAN,0,0,0
JAWA TIMUR,BONDOWOSO,JAMBESARI DARUS SHOLAH,12528,6680,19208
JAWA TIMUR,BANYUWANGI,SRONO,0,0,0
JAWA TIMUR,BANYUWANGI,CLURING,0,0,0
JAWA TIMUR,BANYUWANGI,MUNCAR,0,0,0
JAWA TIMUR,BANYUWANGI,GLENMORE,0,0,0
JAWA TIMUR,BANYUWANGI,KALIBARU,0,0,0
JAWA TIMUR,BONDOWOSO,WRINGIN,11576,11353,22929
JAWA TIMUR,BONDOWOSO,CERMEE,19344,8345,27689
JAWA TIMUR,BONDOWOSO,TENGGARANG,13640,9602,23242
JAWA TIMUR,BONDOWOSO,BOTOLINGGO,14598,4859,19457
JAWA TIMUR,BONDOWOSO,TLOGOSARI,15739,9326,25065
JAWA TIMUR,BONDOWOSO,MAESAN,14705,11612,26317
JAWA TIMUR,BONDOWOSO,SUKOSARI,6200,2882,9082
JAWA TIMUR,BONDOWOSO,WONOSARI,13686,10364,24050
JAWA TIMUR,BONDOWOSO,BINAKAL,5158,4363,9521
JAWA TIMUR,BONDOWOSO,SUMBERWRINGIN,11085,8091,19176
JAWA TIMUR,BONDOWOSO,BONDOWOSO,24342,18119,42461
JAWA TIMUR,BONDOWOSO,SEMPOL,4944,2952,7896
JAWA TIMUR,BONDOWOSO,TAMANAN,11387,9849,21236
JAWA TIMUR,SITUBONDO,ASEMBAGUS,15018,10782,25800
JAWA TIMUR,SITUBONDO,BANYUPUTIH,10680,14886,25566
JAWA TIMUR,BONDOWOSO,TEGALAMPEL,7236,7193,14429
JAWA TIMUR,SITUBONDO,BANYUGLUGUR,7618,5393,13011
JAWA TIMUR,SITUBONDO,SITUBONDO,15940,12228,28168
JAWA TIMUR,SITUBONDO,KENDIT,10679,6654,17333
JAWA TIMUR,BONDOWOSO,PUJER,15999,7354,23353
JAWA TIMUR,SITUBONDO,JATIBANTENG,8429,4226,12655
JAWA TIMUR,SITUBONDO,BESUKI,22138,12514,34652
JAWA TIMUR,SITUBONDO,PANJI,24436,17923,42359
JAWA TIMUR,BONDOWOSO,CURAHDAMI,10973,7369,18342
JAWA TIMUR,SITUBONDO,KAPONGAN,12582,9648,22230
JAWA TIMUR,BONDOWOSO,GRUJUGAN,13533,6574,20107
JAWA TIMUR,BONDOWOSO,TAPEN,13384,7359,20743
JAWA TIMUR,PROBOLINGGO,KRAKSAAN,13405,20287,33692
JAWA TIMUR,SITUBONDO,MLANDINGAN,8914,4726,13640
JAWA TIMUR,PROBOLINGGO,KREJENGAN,9235,12275,21510
JAWA TIMUR,PROBOLINGGO,SUKAPURA,5871,6401,12272
JAWA TIMUR,SITUBONDO,JANGKAR,12085,7884,19969
JAWA TIMUR,SITUBONDO,BUNGATAN,8803,6113,14916
JAWA TIMUR,PROBOLINGGO,TEGALSIWALAN,9677,7648,17325
JAWA TIMUR,SITUBONDO,SUMBERMALANG,9919,4584,14503
JAWA TIMUR,SITUBONDO,PANARUKAN,17703,13201,30904
JAWA TIMUR,PROBOLINGGO,MARON,17383,14500,31883
JAWA TIMUR,PROBOLINGGO,LECES,15118,12018,27136
JAWA TIMUR,SITUBONDO,ARJASA,13148,9037,22185
JAWA TIMUR,PROBOLINGGO,BANYUANYAR,12941,12270,25211
JAWA TIMUR,PROBOLINGGO,SUMBERASIH,19163,13248,32411
JAWA TIMUR,SITUBONDO,MANGARAN,10536,8397,18933
JAWA TIMUR,SITUBONDO,SUBOH,11406,4822,16228
JAWA TIMUR,PROBOLINGGO,GENDING,10421,10308,20729
JAWA TIMUR,PROBOLINGGO,TONGAS,16535,16712,33247
JAWA TIMUR,PROBOLINGGO,TIRIS,11580,17293,28873
JAWA TIMUR,PROBOLINGGO,SUMBER,8015,7288,15303
JAWA TIMUR,PROBOLINGGO,PAITON,21951,16036,37987
JAWA TIMUR,PROBOLINGGO,WONOMERTO,10223,7428,17651
JAWA TIMUR,PROBOLINGGO,PAKUNIRAN,10794,14036,24830
JAWA TIMUR,PROBOLINGGO,PAJARAKAN,9262,9201,18463
JAWA TIMUR,PASURUAN,POHJENTREK,0,0,0
JAWA TIMUR,PROBOLINGGO,DRINGU,11281,19047,30328
JAWA TIMUR,PROBOLINGGO,GADING,11859,14885,26744
JAWA TIMUR,PROBOLINGGO,BANTARAN,11224,7097,18321
JAWA TIMUR,PASURUAN,KRATON,0,0,0
JAWA TIMUR,PASURUAN,PURWODADI,0,0,0
JAWA TIMUR,PASURUAN,GONDANGWETAN,0,0,0
JAWA TIMUR,PROBOLINGGO,KURIPAN,5210,6966,12176
JAWA TIMUR,PROBOLINGGO,LUMBANG,6545,9452,15997
JAWA TIMUR,PROBOLINGGO,BESUK,12430,12826,25256
JAWA TIMUR,PROBOLINGGO,KOTAANYAR,9805,11674,21479
JAWA TIMUR,PASURUAN,BANGIL,0,0,0
JAWA TIMUR,PASURUAN,REMBANG,0,0,0
JAWA TIMUR,PASURUAN,PASREPAN,0,0,0
JAWA TIMUR,PASURUAN,SUKOREJO,0,0,0
JAWA TIMUR,PROBOLINGGO,KRUCIL,10175,10798,20973
JAWA TIMUR,PASURUAN,GRATI,0,0,0
JAWA TIMUR,PASURUAN,PUSPO,0,0,0
JAWA TIMUR,PASURUAN,PURWOSARI,0,0,0
JAWA TIMUR,PASURUAN,REJOSO,0,0,0
JAWA TIMUR,PASURUAN,LUMBANG,0,0,0
JAWA TIMUR,PASURUAN,WINONGAN,0,0,0
JAWA TIMUR,SIDOARJO,TARIK,19530,19176,38706
JAWA TIMUR,PASURUAN,TUTUR,0,0,0
JAWA TIMUR,PASURUAN,LEKOK,0,0,0
JAWA TIMUR,SIDOARJO,BUDURAN,23782,21745,45527
JAWA TIMUR,SIDOARJO,KRIAN,26213,36760,62973
JAWA TIMUR,PASURUAN,WONOREJO,0,0,0
JAWA TIMUR,PASURUAN,NGULING,0,0,0
JAWA TIMUR,PASURUAN,GEMPOL,0,0,0
JAWA TIMUR,SIDOARJO,TAMAN,43812,59882,103694
JAWA TIMUR,SIDOARJO,SEDATI,21110,22040,43150
JAWA TIMUR,PASURUAN,PRIGEN,0,0,0
JAWA TIMUR,SIDOARJO,BALONGBENDO,18062,23003,41065
JAWA TIMUR,PASURUAN,BEJI,0,0,0
JAWA TIMUR,PASURUAN,KEJAYAN,0,0,0
JAWA TIMUR,SIDOARJO,PORONG,15734,21316,37050
JAWA TIMUR,PASURUAN,TOSARI,0,0,0
JAWA TIMUR,PASURUAN,PANDAAN,0,0,0
JAWA TIMUR,SIDOARJO,CANDI,35008,37657,72665
JAWA TIMUR,MOJOKERTO,DAWARBLANDONG,13119,19030,32149
JAWA TIMUR,MOJOKERTO,JATIREJO,9017,15006,24023
JAWA TIMUR,SIDOARJO,KREMBUNG,17793,20500,38293
JAWA TIMUR,SIDOARJO,TANGGULANGIN,23035,23700,46735
JAWA TIMUR,SIDOARJO,SUKODONO,24501,31668,56169
JAWA TIMUR,SIDOARJO,GEDANGAN,28290,29835,58125
JAWA TIMUR,MOJOKERTO,KEMLAGI,14608,19303,33911
JAWA TIMUR,SIDOARJO,WONOAYU,20766,22916,43682
JAWA TIMUR,MOJOKERTO,SOOKO,17418,21706,39124
JAWA TIMUR,SIDOARJO,SIDOARJO,46124,54639,100763
JAWA TIMUR,MOJOKERTO,MOJOSARI,18287,25289,43576
JAWA TIMUR,SIDOARJO,JABON,15516,12799,28315
JAWA TIMUR,MOJOKERTO,KUTOREJO,14576,21934,36510
JAWA TIMUR,SIDOARJO,TULANGAN,22890,28169,51059
JAWA TIMUR,SIDOARJO,PRAMBON,17740,25679,43419
JAWA TIMUR,MOJOKERTO,GEDEG,13890,19132,33022
JAWA TIMUR,JOMBANG,PLANDAAN,12794,10781,23575
JAWA TIMUR,MOJOKERTO,GONDANG,10145,14868,25013
JAWA TIMUR,MOJOKERTO,PACET,13049,20911,33960
JAWA TIMUR,SIDOARJO,WARU,44987,59242,104229
JAWA TIMUR,MOJOKERTO,JETIS,19497,28982,48479
JAWA TIMUR,MOJOKERTO,BANGSAL,13542,16438,29980
JAWA TIMUR,MOJOKERTO,TRAWAS,6709,11742,18451
JAWA TIMUR,JOMBANG,JOGOROTO,15377,19500,34877
JAWA TIMUR,JOMBANG,KUDU,8508,10420,18928
JAWA TIMUR,JOMBANG,KESAMBEN,16019,20891,36910
JAWA TIMUR,MOJOKERTO,PUNGGING,20125,25402,45527
JAWA TIMUR,JOMBANG,KABUH,12640,13211,25851
JAWA TIMUR,MOJOKERTO,DLANGGU,10625,20087,30712
JAWA TIMUR,JOMBANG,BARENG,8931,21853,30784
JAWA TIMUR,MOJOKERTO,TROWULAN,14058,27498,41556
JAWA TIMUR,JOMBANG,MEGALUH,10576,12117,22693
JAWA TIMUR,MOJOKERTO,NGORO,22878,22382,45260
JAWA TIMUR,JOMBANG,PETERONGAN,15825,20758,36583
JAWA TIMUR,JOMBANG,TEMBELANG,14058,16737,30795
JAWA TIMUR,JOMBANG,WONOSALAM,6233,12019,18252
JAWA TIMUR,MOJOKERTO,PURI,16389,25000,41389
JAWA TIMUR,JOMBANG,PERAK,13565,15109,28674
JAWA TIMUR,JOMBANG,BANDARKEDUNGMULYO,11269,13750,25019
JAWA TIMUR,MOJOKERTO,MOJOANYAR,12423,15555,27978
JAWA TIMUR,JOMBANG,MOJOWARNO,18213,32254,50467
JAWA TIMUR,JOMBANG,PLOSO,9845,14447,24292
JAWA TIMUR,JOMBANG,NGUSIKAN,6827,7016,13843
JAWA TIMUR,JOMBANG,MOJOAGUNG,16378,25980,42358
JAWA TIMUR,JOMBANG,GUDO,13321,17416,30737
JAWA TIMUR,NGANJUK,SUKOMORO,8794,17356,26150
JAWA TIMUR,NGANJUK,REJOSO,17830,24094,41924
JAWA TIMUR,NGANJUK,BERBEK,12635,19058,31693
JAWA TIMUR,JOMBANG,JOMBANG,34215,42307,76522
JAWA TIMUR,NGANJUK,TANJUNGANOM,21411,42068,63479
JAWA TIMUR,NGANJUK,LOCERET,14377,25685,40062
JAWA TIMUR,JOMBANG,DIWEK,5612,7843,13455
JAWA TIMUR,JOMBANG,NGORO,14571,25711,40282
JAWA TIMUR,JOMBANG,SUMOBITO,19243,26715,45958
JAWA TIMUR,NGANJUK,NGETOS,5556,13690,19246
JAWA TIMUR,NGANJUK,SAWAHAN,7974,13813,21787
JAWA TIMUR,NGANJUK,NGANJUK,14979,23401,38380
JAWA TIMUR,NGANJUK,LENGKONG,10154,9202,19356
JAWA TIMUR,NGANJUK,PACE,10805,24141,34946
JAWA TIMUR,NGANJUK,BAGOR,17014,18906,35920
JAWA TIMUR,MADIUN,SARADAN,17605,20689,38294
JAWA TIMUR,NGANJUK,WILANGAN,7701,9200,16901
JAWA TIMUR,NGANJUK,GONDANG,11161,20277,31438
JAWA TIMUR,MADIUN,BALEREJO,11601,15542,27143
JAWA TIMUR,NGANJUK,PATIANROWO,9968,13878,23846
JAWA TIMUR,NGANJUK,JATIKALEN,7009,5322,12331
JAWA TIMUR,MADIUN,MEJAYAN,11341,14648,25989
JAWA TIMUR,MADIUN,KEBONSARI,15796,16625,32421
JAWA TIMUR,MADIUN,JIWAN,15440,19457,34897
JAWA TIMUR,NGANJUK,NGLUYU,5164,3976,9140
JAWA TIMUR,NGANJUK,BARON,10408,18111,28519
JAWA TIMUR,MADIUN,DOLOPO,12674,20181,32855
JAWA TIMUR,MAGETAN,NGARIBOYO,12366,10067,22433
JAWA TIMUR,MADIUN,WONOASRI,8388,11668,20056
JAWA TIMUR,NGANJUK,KERTOSONO,11511,19047,30558
JAWA TIMUR,MADIUN,PILANGKENCENG,13025,18708,31733
JAWA TIMUR,NGANJUK,PRAMBON,13905,26361,40266
JAWA TIMUR,NGANJUK,NGRONGGOT,14150,29313,43463
JAWA TIMUR,MADIUN,GEMARANG,7190,11121,18311
JAWA TIMUR,MAGETAN,KARTOHARJO,7176,8465,15641
JAWA TIMUR,MADIUN,SAWAHAN,7170,8417,15587
JAWA TIMUR,MADIUN,WUNGU,13623,19978,33601
JAWA TIMUR,MADIUN,KARE,6878,11483,18361
JAWA TIMUR,MADIUN,MADIUN,9909,13976,23885
JAWA TIMUR,MAGETAN,PONCOL,10727,6962,17689
JAWA TIMUR,MADIUN,DAGANGAN,12267,15885,28152
JAWA TIMUR,MAGETAN,BARAT,8694,9536,18230
JAWA TIMUR,MADIUN,GEGER,15085,21624,36709
JAWA TIMUR,MAGETAN,KAWEDANAN,12294,12557,24851
JAWA TIMUR,MAGETAN,NGUNTORONADI,6169,6310,12479
JAWA TIMUR,MAGETAN,PLAOSAN,18155,13361,31516
JAWA TIMUR,MAGETAN,TAKERAN,11382,11362,22744
JAWA TIMUR,MAGETAN,KARANGREJO,7296,6784,14080
JAWA TIMUR,NGAWI,SINE,8202,16248,24450
JAWA TIMUR,MAGETAN,BENDO,11498,13687,25185
JAWA TIMUR,MAGETAN,KARAS,12431,8955,21386
JAWA TIMUR,MAGETAN,SIDOREJO,7791,8786,16577
JAWA TIMUR,MAGETAN,MAOSPATI,11678,14344,26022
JAWA TIMUR,NGAWI,GERIH,7386,12515,19901
JAWA TIMUR,MAGETAN,PARANG,15500,9689,25189
JAWA TIMUR,MAGETAN,MAGETAN,14083,12294,26377
JAWA TIMUR,MAGETAN,SUKOMORO,8999,10262,19261
JAWA TIMUR,NGAWI,KARANGJATI,11666,18579,30245
JAWA TIMUR,MAGETAN,PANEKAN,15700,16969,32669
JAWA TIMUR,NGAWI,PANGKUR,8302,9440,17742
JAWA TIMUR,NGAWI,PADAS,7621,14141,21762
JAWA TIMUR,NGAWI,KENDAL,11474,15830,27304
JAWA TIMUR,MAGETAN,LEMBEYAN,14007,10572,24579
JAWA TIMUR,NGAWI,PITU,8241,9004,17245
JAWA TIMUR,NGAWI,NGAWI,23226,26186,49412
JAWA TIMUR,NGAWI,KEDUNGGALAR,15004,24108,39112
JAWA TIMUR,NGAWI,MANTINGAN,8944,13519,22463
JAWA TIMUR,NGAWI,JOGOROGO,9149,13140,22289
JAWA TIMUR,NGAWI,BRINGIN,6436,12197,18633
JAWA TIMUR,NGAWI,GENENG,12644,18298,30942
JAWA TIMUR,NGAWI,NGRAMBE,8537,14927,23464
JAWA TIMUR,NGAWI,KARANGANYAR,4362,12728,17090
JAWA TIMUR,BOJONEGORO,KEDEWAN,2400,4750,7150
JAWA TIMUR,NGAWI,WIDODAREN,13695,24553,38248
JAWA TIMUR,BOJONEGORO,KALITIDU,15886,11999,27885
JAWA TIMUR,NGAWI,PARON,22225,29952,52177
JAWA TIMUR,NGAWI,KASREMAN,6070,8507,14577
JAWA TIMUR,NGAWI,KWADUNGAN,7551,9297,16848
JAWA TIMUR,BOJONEGORO,GONDANG,5783,8806,14589
JAWA TIMUR,BOJONEGORO,TEMAYANG,11098,9562,20660
JAWA TIMUR,BOJONEGORO,MALO,10359,7215,17574
JAWA TIMUR,BOJONEGORO,SUKOSEWU,12048,12173,24221
JAWA TIMUR,BOJONEGORO,PURWOSARI,7946,8210,16156
JAWA TIMUR,BOJONEGORO,NGRAHO,10501,14443,24944
JAWA TIMUR,BOJONEGORO,SUGIHWARAS,15117,11098,26215
JAWA TIMUR,BOJONEGORO,NGAMBON,3172,3403,6575
JAWA TIMUR,BOJONEGORO,TRUCUK,10258,10555,20813
JAWA TIMUR,BOJONEGORO,KASIMAN,7754,9636,17390
JAWA TIMUR,BOJONEGORO,PADANGAN,11060,12567,23627
JAWA TIMUR,BOJONEGORO,KEDUNGADEM,27605,18303,45908
JAWA TIMUR,BOJONEGORO,MARGOMULYO,4642,8076,12718
JAWA TIMUR,BOJONEGORO,NGASEM,16967,16385,33352
JAWA TIMUR,TUBAN,KENDURUAN,4949,10063,15012
JAWA TIMUR,BOJONEGORO,SUMBEREJO,24320,16116,40436
JAWA TIMUR,BOJONEGORO,DANDER,22647,21439,44086
JAWA TIMUR,TUBAN,SEMANDING,25771,32340,58111
JAWA TIMUR,BOJONEGORO,KANOR,19040,14050,33090
JAWA TIMUR,TUBAN,TUBAN,22366,26462,48828
JAWA TIMUR,BOJONEGORO,KAPAS,17280,14009,31289
JAWA TIMUR,TUBAN,RENGEL,16262,15994,32256
JAWA TIMUR,TUBAN,PALANG,19411,24792,44203
JAWA TIMUR,BOJONEGORO,GAYAM,9599,8504,18103
JAWA TIMUR,BOJONEGORO,BOJONEGORO,23221,25552,48773
JAWA TIMUR,BOJONEGORO,SEKAR,5445,9854,15299
JAWA TIMUR,TUBAN,MERAKURAK,14429,16454,30883
JAWA TIMUR,TUBAN,PLUMPANG,17267,23969,41236
JAWA TIMUR,TUBAN,SOKO,21288,25559,46847
JAWA TIMUR,BOJONEGORO,TAMBAKREJO,13961,16942,30903
JAWA TIMUR,BOJONEGORO,KEPOH BARU,20631,16057,36688
JAWA TIMUR,TUBAN,BANCAR,11226,22021,33247
JAWA TIMUR,BOJONEGORO,BUBULAN,4740,3598,8338
JAWA TIMUR,TUBAN,KEREK,12767,23355,36122
JAWA TIMUR,TUBAN,SENORI,9081,11976,21057
JAWA TIMUR,LAMONGAN,MANTUP,14300,13855,28155
JAWA TIMUR,LAMONGAN,SUKORAME,7102,5729,12831
JAWA TIMUR,BOJONEGORO,BAURENO,22694,21466,44160
JAWA TIMUR,BOJONEGORO,BALEN,21103,17539,38642
JAWA TIMUR,TUBAN,GRABAGAN,6433,13598,20031
JAWA TIMUR,LAMONGAN,KALITENGAH,9831,8859,18690
JAWA TIMUR,TUBAN,JENU,11668,16921,28589
JAWA TIMUR,LAMONGAN,KARANGGENENG,10862,11184,22046
JAWA TIMUR,TUBAN,MONTONG,11785,16656,28441
JAWA TIMUR,TUBAN,PARENGAN,14020,16089,30109
JAWA TIMUR,LAMONGAN,KEMBANGBAHU,12627,16429,29056
JAWA TIMUR,TUBAN,SINGGAHAN,9301,12478,21779
JAWA TIMUR,LAMONGAN,LAMONGAN,20436,18204,38640
JAWA TIMUR,LAMONGAN,GLAGAH,11767,9759,21526
JAWA TIMUR,TUBAN,BANGILAN,9935,13510,23445
JAWA TIMUR,TUBAN,WIDANG,10566,16566,27132
JAWA TIMUR,TUBAN,JATIROGO,10642,20652,31294
JAWA TIMUR,LAMONGAN,DEKET,13791,10648,24439
JAWA TIMUR,TUBAN,TAMBAKBOYO,8731,13744,22475
JAWA TIMUR,LAMONGAN,SUKODADI,15812,15535,31347
JAWA TIMUR,LAMONGAN,KARANGBINANGUN,10514,9538,20052
JAWA TIMUR,LAMONGAN,KEDUNGPRING,16723,14800,31523
JAWA TIMUR,LAMONGAN,TIKUNG,11189,14686,25875
JAWA TIMUR,LAMONGAN,TURI,15131,14147,29278
JAWA TIMUR,LAMONGAN,BLULUK,7367,5864,13231
JAWA TIMUR,LAMONGAN,MADURAN,8206,7851,16057
JAWA TIMUR,LAMONGAN,SOLOKURO,13703,9138,22841
JAWA TIMUR,LAMONGAN,PUCUK,10391,12886,23277
JAWA TIMUR,LAMONGAN,LAREN,12734,9263,21997
JAWA TIMUR,LAMONGAN,SUGIO,15325,18749,34074
JAWA TIMUR,LAMONGAN,NGIMBANG,14802,12903,27705
JAWA TIMUR,GRESIK,KEBOMAS,29405,25286,54691
JAWA TIMUR,GRESIK,SANGKAPURA,15366,8170,23536
JAWA TIMUR,LAMONGAN,SARIREJO,8021,5694,13715
JAWA TIMUR,LAMONGAN,MODO,15959,12673,28632
JAWA TIMUR,GRESIK,CERME,22480,21109,43589
JAWA TIMUR,LAMONGAN,BRONDONG,17302,16584,33886
JAWA TIMUR,LAMONGAN,PACIRAN,28905,18094,46999
JAWA TIMUR,GRESIK,BUNGAH,18548,16120,34668
JAWA TIMUR,LAMONGAN,BABAT,20396,23267,43663
JAWA TIMUR,GRESIK,SIDAYU,13176,8089,21265
JAWA TIMUR,LAMONGAN,SAMBENG,16081,15487,31568
JAWA TIMUR,GRESIK,DUDUKSAMPEYAN,17913,10315,28228
JAWA TIMUR,GRESIK,KEDAMEAN,14425,22297,36722
JAWA TIMUR,LAMONGAN,SEKARAN,9309,10423,19732
JAWA TIMUR,GRESIK,BALONGPANGGANG,16806,15889,32695
JAWA TIMUR,GRESIK,MANYAR,33493,22415,55908
JAWA TIMUR,GRESIK,MENGANTI,24456,40606,65062
JAWA TIMUR,GRESIK,DUKUN,21303,11191,32494
JAWA TIMUR,GRESIK,UJUNGPANGKAH,14888,10255,25143
JAWA TIMUR,GRESIK,WRINGINANOM,19753,21024,40777
JAWA TIMUR,BANGKALAN,MODUNG,27013,7302,34315
JAWA TIMUR,GRESIK,GRESIK,23747,18494,42241
JAWA TIMUR,GRESIK,DRIYOREJO,24881,28411,53292
JAWA TIMUR,GRESIK,PANCENG,15201,9317,24518
JAWA TIMUR,BANGKALAN,SEPULU,25947,10760,36707
JAWA TIMUR,GRESIK,TAMBAK,7131,4678,11809
JAWA TIMUR,BANGKALAN,KLAMPIS,35071,5322,40393
JAWA TIMUR,BANGKALAN,GEGER,39657,14196,53853
JAWA TIMUR,BANGKALAN,TRAGAH,26527,2508,29035
JAWA TIMUR,BANGKALAN,LABANG,21837,8576,30413
JAWA TIMUR,BANGKALAN,BURNEH,49663,7161,56824
JAWA TIMUR,GRESIK,BENJENG,17983,18830,36813
JAWA TIMUR,BANGKALAN,BLEGA,39253,9387,48640
JAWA TIMUR,BANGKALAN,KONANG,40085,7976,48061
JAWA TIMUR,SAMPANG,KETAPANG,0,0,0
JAWA TIMUR,BANGKALAN,AROSBAYA,23969,7952,31921
JAWA TIMUR,BANGKALAN,BANGKALAN,35749,13650,49399
JAWA TIMUR,BANGKALAN,TANJUNG BUMI,32684,5178,37862
JAWA TIMUR,BANGKALAN,KOKOP,40785,8605,49390
JAWA TIMUR,BANGKALAN,KWANYAR,40229,3440,43669
JAWA TIMUR,BANGKALAN,TANAH MERAH,59266,7564,66830
JAWA TIMUR,SAMPANG,KEDUNGDUNG,0,0,0
JAWA TIMUR,SAMPANG,KARANGPENANG,0,0,0
JAWA TIMUR,SAMPANG,SOKOBANAH,0,0,0
JAWA TIMUR,BANGKALAN,SOCAH,27195,11804,38999
JAWA TIMUR,SAMPANG,ROBATAL,31627,7634,39261
JAWA TIMUR,PAMEKASAN,KADUR,13490,10157,23647
JAWA TIMUR,BANGKALAN,GALIS,63938,7037,70975
JAWA TIMUR,SAMPANG,OMBEN,0,0,0
JAWA TIMUR,PAMEKASAN,PAKONG,13628,5560,19188
JAWA TIMUR,SAMPANG,SRESEH,0,0,0
JAWA TIMUR,SAMPANG,TAMBELANGAN,0,0,0
JAWA TIMUR,BANGKALAN,KAMAL,15740,10840,26580
JAWA TIMUR,SAMPANG,BANYUATES,0,0,0
JAWA TIMUR,SAMPANG,PANGARENGAN,0,0,0
JAWA TIMUR,SAMPANG,SAMPANG,0,0,0
JAWA TIMUR,PAMEKASAN,LARANGAN,16715,11508,28223
JAWA TIMUR,PAMEKASAN,PROPPO,41532,9576,51108
JAWA TIMUR,PAMEKASAN,PAMEKASAN,39331,11323,50654
JAWA TIMUR,PAMEKASAN,WARU,36813,6240,43053
JAWA TIMUR,SAMPANG,CAMPLONG,0,0,0
JAWA TIMUR,PAMEKASAN,TLANAKAN,19961,11977,31938
JAWA TIMUR,PAMEKASAN,PADEMAWU,31448,15022,46470
JAWA TIMUR,SUMENEP,KOTA SUMENEP,25784,14635,40419
JAWA TIMUR,PAMEKASAN,GALIS,9895,6541,16436
JAWA TIMUR,SAMPANG,JRENGIK,0,0,0
JAWA TIMUR,SAMPANG,TORJUN,0,0,0
JAWA TIMUR,PAMEKASAN,PEGANTENAN,35708,9944,45652
JAWA TIMUR,SUMENEP,NONGGUNONG,4252,3166,7418
JAWA TIMUR,SUMENEP,DUNGKEK,9106,9155,18261
JAWA TIMUR,SUMENEP,GAYAM,12430,5260,17690
JAWA TIMUR,SUMENEP,RUBARU,11981,8830,20811
JAWA TIMUR,PAMEKASAN,BATUMARMAR,53230,11809,65039
JAWA TIMUR,SUMENEP,BLUTO,15715,11357,27072
JAWA TIMUR,SUMENEP,PASONGSONGAN,14923,11451,26374
JAWA TIMUR,SUMENEP,SARONGGI,10329,10601,20930
JAWA TIMUR,SUMENEP,BATU PUTIH,11438,10733,22171
JAWA TIMUR,SUMENEP,MASALEMBU,3849,5462,9311
JAWA TIMUR,SUMENEP,GAPURA,8009,12136,20145
JAWA TIMUR,SUMENEP,KALIANGET,10848,10623,21471
JAWA TIMUR,SUMENEP,DASUK,9241,6717,15958
JAWA TIMUR,SUMENEP,BATANG BATANG,13332,14372,27704
JAWA TIMUR,SUMENEP,TALANGO,7983,11287,19270
JAWA TIMUR,SUMENEP,GILI GINTING,5115,5188,10303
JAWA TIMUR,PAMEKASAN,PASEAN,23833,9982,33815
JAWA TIMUR,SUMENEP,ARJASA,27270,10303,37573
JAWA TIMUR,SUMENEP,MANDING,8478,6652,15130
JAWA TIMUR,KOTA KEDIRI,KOTA,16532,33583,50115
JAWA TIMUR,SUMENEP,LENTENG,15212,18664,33876
JAWA TIMUR,SUMENEP,SAPEKEN,15691,5899,21590
JAWA TIMUR,KOTA KEDIRI,MOJOROTO,25896,35205,61101
JAWA TIMUR,SUMENEP,BATUAN,3578,2861,6439
JAWA TIMUR,KOTA BLITAR,SUKOREJO,8827,19603,28430
JAWA TIMUR,KOTA MALANG,KLOJEN,23595,35657,59252
JAWA TIMUR,KOTA MALANG,KEDUNGKANDANG,42327,56501,98828
JAWA TIMUR,SUMENEP,KANGAYAN,8215,2822,11037
JAWA TIMUR,KOTA KEDIRI,PESANTREN,17033,31704,48737
JAWA TIMUR,SUMENEP,PRAGAAN,27194,15251,42445
JAWA TIMUR,KOTA PROBOLINGGO,KADEMANGAN,12942,10230,23172
JAWA TIMUR,KOTA BLITAR,SANANWETAN,12217,18605,30822
JAWA TIMUR,SUMENEP,GANDING,9872,8476,18348
JAWA TIMUR,SUMENEP,AMBUNTEN,11912,10781,22693
JAWA TIMUR,KOTA PROBOLINGGO,KEDOPAK,10921,7361,18282
JAWA TIMUR,KOTA BLITAR,KEPANJENKIDUL,8305,16391,24696
JAWA TIMUR,KOTA PROBOLINGGO,MAYANGAN,16727,18771,35498
JAWA TIMUR,KOTA MALANG,LOWOKWARU,37623,52068,89691
JAWA TIMUR,KOTA PROBOLINGGO,KANIGARAN,17950,14000,31950
JAWA TIMUR,KOTA MALANG,SUKUN,37508,68839,106347
JAWA TIMUR,KOTA MALANG,BLIMBING,41075,57906,98981
JAWA TIMUR,KOTA PROBOLINGGO,WONOASIH,10572,7787,18359
JAWA TIMUR,KOTA MADIUN,KARTOHARJO,12437,17578,30015
JAWA TIMUR,KOTA SURABAYA,GAYUNGAN,0,0,0
JAWA TIMUR,KOTA SURABAYA,DUKUHPAKIS,0,0,0
JAWA TIMUR,KOTA MOJOKERTO,MAGERSARI,0,0,0
JAWA TIMUR,KOTA MOJOKERTO,PRAJURIT KULON,0,0,0
JAWA TIMUR,KOTA PASURUAN,PANGGUNGREJO,19286,14585,33871
JAWA TIMUR,KOTA SURABAYA,SUKOMANUNGGAL,0,0,0
JAWA TIMUR,KOTA PASURUAN,BUGUL KIDUL,9681,6086,15767
JAWA TIMUR,KOTA SURABAYA,PAKAL,0,0,0
JAWA TIMUR,KOTA PASURUAN,PURWOREJO,17463,12898,30361
JAWA TIMUR,KOTA SURABAYA,TENGGILIS MEJOYO,0,0,0
JAWA TIMUR,KOTA PASURUAN,GADINGREJO,12537,10327,22864
JAWA TIMUR,KOTA SURABAYA,WIYUNG,0,0,0
JAWA TIMUR,KOTA SURABAYA,JAMBANGAN,0,0,0
JAWA TIMUR,KOTA MADIUN,MANGUHARJO,11306,19986,31292
JAWA TIMUR,KOTA MADIUN,TAMAN,17305,27495,44800
JAWA TIMUR,KOTA SURABAYA,LAKARSANTRI,0,0,0
JAWA TIMUR,KOTA SURABAYA,BENOWO,0,0,0
JAWA TIMUR,KOTA SURABAYA,KENJERAN,0,0,0
JAWA TIMUR,KOTA SURABAYA,KARANGPILANG,0,0,0
JAWA TIMUR,KOTA SURABAYA,GUNUNG ANYAR,0,0,0
JAWA TIMUR,KOTA SURABAYA,MULYOREJO,0,0,0
JAWA TIMUR,KOTA SURABAYA,SEMAMPIR,0,0,0
JAWA TIMUR,KOTA SURABAYA,TAMBAKSARI,0,0,0
JAWA TIMUR,KOTA SURABAYA,ASEM ROWO,0,0,0
JAWA TIMUR,KOTA SURABAYA,BUBUTAN,0,0,0
JAWA TIMUR,KOTA SURABAYA,TEGALSARI,0,0,0
JAWA TIMUR,KOTA SURABAYA,SUKOLILO,0,0,0
JAWA TIMUR,KOTA SURABAYA,BULAK,0,0,0
JAWA TIMUR,KOTA SURABAYA,RUNGKUT,0,0,0
JAWA TIMUR,KOTA SURABAYA,WONOKROMO,0,0,0
JAWA TIMUR,KOTA SURABAYA,SAWAHAN,0,0,0
JAWA TIMUR,KOTA SURABAYA,KREMBANGAN,0,0,0
JAWA TIMUR,KOTA SURABAYA,WONOCOLO,0,0,0
JAWA TIMUR,KOTA SURABAYA,GENTENG,0,0,0
BANTEN,PANDEGLANG,CISATA,9683,2455,12138
BANTEN,PANDEGLANG,SUMUR,5055,6898,11953
JAWA TIMUR,KOTA BATU,BATU,46979,73055,120034
JAWA TIMUR,KOTA SURABAYA,GUBENG,0,0,0
JAWA TIMUR,KOTA SURABAYA,PABEAN CANTIKAN,0,0,0
BANTEN,PANDEGLANG,CADASARI,11948,4479,16427
BANTEN,PANDEGLANG,CIBITUNG,5140,5657,10797
JAWA TIMUR,KOTA SURABAYA,TANDES,0,0,0
JAWA TIMUR,KOTA SURABAYA,SIMOKERTO,0,0,0
JAWA TIMUR,KOTA SURABAYA,SAMBIKEREP,0,0,0
JAWA TIMUR,KOTA BATU,JUNREJO,11900,17326,29226
BANTEN,PANDEGLANG,MAJASARI,17833,5918,23751
JAWA TIMUR,KOTA BATU,BUMIAJI,13441,22958,36399
BANTEN,PANDEGLANG,CIMANGGU,7732,12702,20434
BANTEN,PANDEGLANG,SINDANGRESMI,6020,5343,11363
BANTEN,PANDEGLANG,BANJAR,9541,5456,14997
BANTEN,PANDEGLANG,SUKARESMI,7632,9595,17227
BANTEN,PANDEGLANG,KARANG TANJUNG,12399,5679,18078
BANTEN,PANDEGLANG,CIGEULIS,7566,10590,18156
BANTEN,PANDEGLANG,PANDEGLANG,16470,6766,23236
BANTEN,PANDEGLANG,PATIA,7040,6279,13319
BANTEN,PANDEGLANG,CIMANUK,13790,4769,18559
BANTEN,PANDEGLANG,CIBALIUNG,6012,8110,14122
BANTEN,PANDEGLANG,MEKARJAYA,5278,4214,9492
BANTEN,PANDEGLANG,CIKEUSIK,11525,15178,26703
BANTEN,PANDEGLANG,PANIMBANG,9401,15941,25342
BANTEN,PANDEGLANG,PULOSARI,9049,4253,13302
BANTEN,PANDEGLANG,KORONCONG,6129,3073,9202
BANTEN,PANDEGLANG,CIKEDAL,10915,5759,16674
BANTEN,PANDEGLANG,MANDALAWANGI,16404,6987,23391
BANTEN,PANDEGLANG,CARITA,9244,8676,17920
BANTEN,PANDEGLANG,PICUNG,10398,6266,16664
BANTEN,PANDEGLANG,PAGELARAN,11501,6863,18364
BANTEN,PANDEGLANG,JIPUT,11277,4758,16035
BANTEN,PANDEGLANG,KADUHEJO,13538,4326,17864
BANTEN,PANDEGLANG,SOBANG,7257,12555,19812
BANTEN,PANDEGLANG,CIPEUCANG,8987,3732,12719
BANTEN,LEBAK,CIKULUR,12433,9247,21680
BANTEN,LEBAK,SOBANG,7063,9692,16755
BANTEN,PANDEGLANG,BOJONG,10868,5834,16702
BANTEN,LEBAK,MALINGPING,14752,15648,30400
BANTEN,PANDEGLANG,MUNJUL,7005,5584,12589
BANTEN,PANDEGLANG,SAKETI,13977,6920,20897
BANTEN,LEBAK,LEBAKGEDONG,5747,5835,11582
BANTEN,PANDEGLANG,ANGSANA,6105,7671,13776
BANTEN,LEBAK,WANASALAM,11197,13744,24941
BANTEN,LEBAK,CILOGRANG,9250,8418,17668
BANTEN,LEBAK,CIJAKU,6275,8044,14319
BANTEN,PANDEGLANG,MENES,14142,4274,18416
BANTEN,LEBAK,CIHARA,6347,9133,15480
BANTEN,LEBAK,CIBADAK,19314,10543,29857
BANTEN,LEBAK,CIBEBER,13450,22294,35744
BANTEN,LEBAK,WARUNGGUNUNG,15579,9572,25151
BANTEN,LEBAK,CURUG BITUNG,6759,9342,16101
BANTEN,LEBAK,RANGKASBITUNG,40613,24328,64941
BANTEN,PANDEGLANG,LABUAN,15326,12021,27347
BANTEN,LEBAK,LEUWIDAMAR,12332,10252,22584
BANTEN,LEBAK,MAJA,16192,8555,24747
BANTEN,LEBAK,KALANGANYAR,10134,5147,15281
BANTEN,LEBAK,MUNCANG,9346,6712,16058
BANTEN,LEBAK,PANGGARANGAN,9664,11490,21154
BANTEN,LEBAK,CILELES,11007,10858,21865
BANTEN,LEBAK,CIPANAS,15284,8145,23429
BANTEN,LEBAK,GUNUNGKENCANA,9206,7864,17070
BANTEN,LEBAK,SAJIRA,14681,8501,23182
BANTEN,LEBAK,CIRINTEN,7567,6169,13736
BANTEN,LEBAK,BAYAH,11193,13468,24661
BANTEN,LEBAK,BOJONGMANIK,5689,5934,11623
BANTEN,TANGERANG,CURUG,44755,33089,77844
BANTEN,TANGERANG,SOLEAR,20497,17170,37667
BANTEN,TANGERANG,PANONGAN,31391,22998,54389
BANTEN,LEBAK,CIMARGA,16815,13379,30194
BANTEN,TANGERANG,SEPATAN TIMUR,26998,16633,43631
BANTEN,TANGERANG,CIKUPA,63493,32222,95715
BANTEN,LEBAK,BANJARSARI,15665,11109,26774
BANTEN,TANGERANG,CISAUK,20048,16854,36902
BANTEN,TANGERANG,GUNUNG KALER,13826,11073,24899
BANTEN,TANGERANG,JAMBE,15012,9144,24156
BANTEN,TANGERANG,KELAPA DUA,40733,46848,87581
BANTEN,LEBAK,CIGEMLONG,4146,7445,11591
BANTEN,TANGERANG,PAKUHAJI,33985,26880,60865
BANTEN,TANGERANG,BALARAJA,39104,18981,58085
BANTEN,TANGERANG,PAGEDANGAN,29536,18646,48182
BANTEN,TANGERANG,LEGOK,32888,20300,53188
BANTEN,TANGERANG,KRONJO,19026,11861,30887
BANTEN,TANGERANG,MAUK,30769,13589,44358
BANTEN,TANGERANG,TIGARAKSA,40059,25080,65139
BANTEN,TANGERANG,SUKAMULYA,23353,10793,34146
BANTEN,TANGERANG,SINDANG JAYA,27342,14178,41520
BANTEN,TANGERANG,SEPATAN,32779,16584,49363
BANTEN,TANGERANG,KOSAMBI,25108,35506,60614
BANTEN,TANGERANG,RAJEG,45269,27902,73171
BANTEN,SERANG,PAMARAYAN,12101,12684,24785
BANTEN,SERANG,JAWILAN,19192,8234,27426
BANTEN,TANGERANG,KRESEK,22182,12108,34290
BANTEN,SERANG,CIKEUSAL,21699,13006,34705
BANTEN,SERANG,PADARINCANG,18270,11529,29799
BANTEN,TANGERANG,JAYANTI,20691,9887,30578
BANTEN,TANGERANG,PASAR KEMIS,69213,57309,126522
BANTEN,SERANG,ANYAR,16989,11387,28376
BANTEN,SERANG,KOPO,16607,7425,24032
BANTEN,TANGERANG,MEKAR BARU,11270,8124,19394
BANTEN,SERANG,KRAMATWATU,31836,18045,49881
BANTEN,SERANG,MANCAK,13335,7734,21069
BANTEN,TANGERANG,KEMIRI,12979,8209,21188
BANTEN,TANGERANG,SUKADIRI,22560,9933,32493
BANTEN,TANGERANG,CISOKA,25126,16221,41347
BANTEN,SERANG,CIOMAS,12340,5931,18271
BANTEN,SERANG,TUNJUNG TEJA,12568,7453,20021
BANTEN,SERANG,PABUARAN,12377,7764,20141
BANTEN,SERANG,BAROS,17315,7295,24610
BANTEN,TANGERANG,TELUKNAGA,38693,38334,77027
BANTEN,SERANG,CINANGKA,16585,11976,28561
BANTEN,SERANG,BOJONEGARA,15047,9288,24335
BANTEN,SERANG,KRAGILAN,23628,12761,36389
BANTEN,SERANG,CIKANDE,32217,17611,49828
BANTEN,SERANG,KIBIN,18502,10851,29353
BANTEN,SERANG,PETIR,14918,10299,25217
BANTEN,SERANG,PULO AMPEL,13291,6633,19924
BANTEN,SERANG,LEBAK WANGI,12980,6254,19234
BANTEN,SERANG,BANDUNG,9904,6766,16670
BANTEN,SERANG,TIRTAYASA,13676,8001,21677
BANTEN,SERANG,CIRUAS,25889,14344,40233
BANTEN,SERANG,TANARA,15799,4281,20080
BANTEN,SERANG,WARINGINKURUNG,12661,8050,20711
BANTEN,SERANG,GUNUNG SARI,5421,3132,8553
BANTEN,SERANG,PONTANG,13612,8276,21888
BANTEN,KOTA TANGERANG,TANGERANG,41589,41813,83402
BANTEN,KOTA TANGERANG,KARANG TENGAH,32147,29097,61244
BANTEN,SERANG,CARENANG,13879,4422,18301
BANTEN,KOTA TANGERANG,JATIUWUNG,35243,16181,51424
BANTEN,KOTA TANGERANG,CIPONDOH,58913,47285,106198
BANTEN,KOTA TANGERANG,BENDA,25208,18692,43900
BANTEN,SERANG,BINUANG,10907,5231,16138
BANTEN,KOTA TANGERANG,PINANG,50422,33996,84418
BANTEN,KOTA TANGERANG,CIBODAS,40032,34592,74624
BANTEN,KOTA TANGERANG,PERIUK,34094,32920,67014
BANTEN,KOTA TANGERANG,NEGLASARI,28628,29040,57668
BANTEN,KOTA TANGERANG,CILEDUG,37918,33140,71058
BANTEN,KOTA SERANG,SERANG,64458,45562,110020
BANTEN,KOTA SERANG,WALANTAKA,25052,15256,40308
BANTEN,KOTA CILEGON,CIBEBER,15916,11200,27116
BANTEN,KOTA CILEGON,JOMBANG,17258,15164,32422
BANTEN,KOTA SERANG,KASEMEN,25699,18964,44663
BANTEN,KOTA TANGERANG,KARAWACI,48089,46921,95010
BANTEN,KOTA CILEGON,CIWANDAN,17696,7343,25039
BANTEN,KOTA CILEGON,GEROGOL,14408,7491,21899
BANTEN,KOTA SERANG,TAKTAKAN,26277,15287,41564
BANTEN,KOTA TANGERANG,BATUCEPER,27323,20340,47663
BANTEN,KOTA CILEGON,PULOMERAK,13529,10593,24122
BANTEN,KOTA TANGERANG,LARANGAN,40981,41328,82309
BANTEN,KOTA CILEGON,CILEGON,14216,8610,22826
BALI,JEMBRANA,PEKUTATAN,5935,10668,16603
BANTEN,KOTA SERANG,CURUG,14319,10185,24504
BALI,JEMBRANA,MELAYA,9342,19691,29033
BANTEN,KOTA TANGERANG SELATAN,CIPUTAT TIMUR,45593,49146,94739
BANTEN,KOTA TANGERANG SELATAN,PAMULANG,79800,82822,162622
BANTEN,KOTA CILEGON,CITANGKIL,24153,13119,37272
BALI,TABANAN,PENEBEL,10863,22707,33570
BALI,TABANAN,BATURITI,9761,20496,30257
BANTEN,KOTA CILEGON,PURWAKARTA,14434,8388,22822
BALI,JEMBRANA,NEGARA,18440,26407,44847
BALI,TABANAN,TABANAN,12549,34325,46874
BALI,JEMBRANA,MENDOYO,9256,26555,35811
BALI,TABANAN,KEDIRI,16087,34102,50189
BANTEN,KOTA TANGERANG SELATAN,SERPONG,34215,38978,73193
BALI,TABANAN,PUPUAN,6225,21677,27902
BALI,TABANAN,MARGA,8134,21654,29788
BANTEN,KOTA SERANG,CIPOCOK JAYA,26411,16768,43179
BALI,BADUNG,ABIANSEMAL,16355,40988,57343
BANTEN,KOTA TANGERANG SELATAN,PONDOK AREN,76335,78592,154927
BALI,TABANAN,SELEMADEG,2096,13427,15523
BALI,TABANAN,KERAMBITAN,8241,20049,28290
BANTEN,KOTA TANGERANG SELATAN,SERPONG UTARA,28053,37231,65284
BALI,JEMBRANA,JEMBRANA,10305,21480,31785
BANTEN,KOTA TANGERANG SELATAN,SETU,21305,17609,38914
BANTEN,KOTA TANGERANG SELATAN,CIPUTAT,50840,55410,106250
BALI,TABANAN,SELEMADEG TIMUR,4196,11969,16165
BALI,BADUNG,PETANG,6285,12191,18476
BALI,KLUNGKUNG,NUSA PENIDA,12150,15767,27917
BALI,TABANAN,SELEMADEG BARAT,4062,10490,14552
BALI,GIANYAR,UBUD,9296,33929,43225
BALI,KLUNGKUNG,KLUNGKUNG,10963,22422,33385
BALI,GIANYAR,BLAHBATUH,9542,28930,38472
BALI,BADUNG,KUTA SELATAN,15350,32360,47710
BALI,BADUNG,MENGWI,21692,52545,74237
BALI,BADUNG,KUTA,6269,18968,25237
BALI,KLUNGKUNG,BANJARANGKAN,6850,16632,23482
BALI,GIANYAR,SUKAWATI,11333,47388,58721
BALI,GIANYAR,TEGALALLANG,8193,25905,34098
BALI,BANGLI,BANGLI,9187,22608,31795
BALI,BADUNG,KUTA UTARA,12115,32165,44280
BALI,GIANYAR,TAMPAKSIRING,5717,25216,30933
BALI,KARANGASEM,RENDANG,8907,14686,23593
BALI,GIANYAR,GIANYAR,13280,40808,54088
BALI,KARANGASEM,ABANG,10958,25620,36578
BALI,GIANYAR,PAYANGAN,6592,20949,27541
BALI,BULELENG,SERIRIT,14950,23685,38635
BALI,KARANGASEM,MANGGIS,6901,18169,25070
BALI,KARANGASEM,SIDEMEN,5905,16453,22358
BALI,KLUNGKUNG,DAWAN,5958,16010,21968
BALI,BANGLI,SUSUT,8102,20530,28632
BALI,KARANGASEM,SELAT,7165,17980,25145
BALI,BANGLI,KINTAMANI,14039,40783,54822
BALI,BULELENG,GEROKGAK,15376,26829,42205
BALI,BULELENG,TEJAKULA,4421,22360,26781
BALI,BANGLI,TEMBUKU,5989,18607,24596
BALI,KARANGASEM,BEBANDEM,10830,18368,29198
BALI,KARANGASEM,KARANGASEM,17124,31766,48890
BALI,KOTA DENPASAR,DENPASAR BARAT,26363,68230,94593
BALI,BULELENG,BANJAR,12583,28070,40653
BALI,BULELENG,BUSUNG BIU,7294,17486,24780
NUSA TENGGARA BARAT,LOMBOK BARAT,LINGSAR,28021,10248,38269
BALI,BULELENG,SUKASADA,12050,24730,36780
BALI,KARANGASEM,KUBU,12970,16822,29792
NUSA TENGGARA BARAT,LOMBOK BARAT,LEMBAR,17663,6825,24488
BALI,KOTA DENPASAR,DENPASAR UTARA,18503,63473,81976
NUSA TENGGARA BARAT,LOMBOK BARAT,LABUAPI,29243,6295,35538
NUSA TENGGARA BARAT,LOMBOK TENGAH,PRAYA TENGAH,26887,7597,34484
BALI,KOTA DENPASAR,DENPASAR TIMUR,12967,46845,59812
BALI,BULELENG,KUBUTAMBAHAN,7441,19231,26672
BALI,BULELENG,BULELENG,20569,45577,66146
NUSA TENGGARA BARAT,LOMBOK TENGAH,PRAYA,46096,12956,59052
NUSA TENGGARA BARAT,LOMBOK BARAT,GUNUNGSARI,36017,10051,46068
NUSA TENGGARA BARAT,LOMBOK BARAT,SEKOTONG,19572,9377,28949
NUSA TENGGARA BARAT,LOMBOK BARAT,KURIPAN,14754,3518,18272
BALI,BULELENG,SAWAN,8168,24260,32428
NUSA TENGGARA BARAT,LOMBOK TENGAH,JANAPRIA,32028,8038,40066
BALI,KOTA DENPASAR,DENPASAR SELATAN,22047,63072,85119
NUSA TENGGARA BARAT,LOMBOK BARAT,GERUNG,35127,8377,43504
NUSA TENGGARA BARAT,LOMBOK TENGAH,JONGGAT,37787,12812,50599
NUSA TENGGARA BARAT,LOMBOK TENGAH,PRAYA BARAT,28144,10197,38341
NUSA TENGGARA BARAT,LOMBOK BARAT,BATU LAYAR,20702,5925,26627
NUSA TENGGARA BARAT,LOMBOK BARAT,KEDIRI,25993,4354,30347
NUSA TENGGARA BARAT,LOMBOK TENGAH,PRAYA BARAT DAYA,20063,6895,26958
NUSA TENGGARA BARAT,LOMBOK TENGAH,PRAYA TIMUR,27544,12019,39563
NUSA TENGGARA BARAT,LOMBOK BARAT,NARMADA,37474,14159,51633
NUSA TENGGARA BARAT,LOMBOK TIMUR,WANASABA,29945,7421,37366
NUSA TENGGARA BARAT,LOMBOK TENGAH,PRINGGARATA,22808,11330,34138
NUSA TENGGARA BARAT,LOMBOK TIMUR,KERUAK,20366,6057,26423
NUSA TENGGARA BARAT,LOMBOK TIMUR,SAMBELIA,10475,5775,16250
NUSA TENGGARA BARAT,LOMBOK TIMUR,SIKUR,29868,9454,39322
NUSA TENGGARA BARAT,LOMBOK TIMUR,SURALAGA,20089,8854,28943
NUSA TENGGARA BARAT,LOMBOK TIMUR,TERARA,28186,8338,36524
NUSA TENGGARA BARAT,LOMBOK TENGAH,BATUKLIANG,29263,12250,41513
NUSA TENGGARA BARAT,LOMBOK TIMUR,SAKRA TIMUR,15562,6510,22072
NUSA TENGGARA BARAT,LOMBOK TENGAH,BATUKLIANG UTARA,20233,6817,27050
NUSA TENGGARA BARAT,LOMBOK TENGAH,KOPANG,33793,10706,44499
NUSA TENGGARA BARAT,LOMBOK TIMUR,PRINGGASELA,22359,6865,29224
NUSA TENGGARA BARAT,LOMBOK TIMUR,SEMBALUN,7845,3466,11311
NUSA TENGGARA BARAT,LOMBOK TENGAH,PUJUT,37982,17423,55405
NUSA TENGGARA BARAT,LOMBOK TIMUR,SUKAMULIA,13822,3510,17332
NUSA TENGGARA BARAT,LOMBOK TIMUR,AIKMEL,35889,16393,52282
NUSA TENGGARA BARAT,SUMBAWA,RHEE,2033,2082,4115
NUSA TENGGARA BARAT,LOMBOK TIMUR,SUWELA,15264,6188,21452
NUSA TENGGARA BARAT,LOMBOK TIMUR,MASBAGIK,44466,10279,54745
NUSA TENGGARA BARAT,LOMBOK TIMUR,LABUHAN HAJI,24367,6505,30872
NUSA TENGGARA BARAT,LOMBOK TIMUR,SAKRA BARAT,18774,7668,26442
NUSA TENGGARA BARAT,SUMBAWA,LABANGKA,3444,1766,5210
NUSA TENGGARA BARAT,LOMBOK TIMUR,PRINGGABAYA,36013,13434,49447
NUSA TENGGARA BARAT,SUMBAWA,ORONG TELU,1634,999,2633
NUSA TENGGARA BARAT,SUMBAWA,BUER,4508,3363,7871
NUSA TENGGARA BARAT,LOMBOK TIMUR,JEROWARU,20828,8098,28926
NUSA TENGGARA BARAT,SUMBAWA,ALAS BARAT,7630,3679,11309
NUSA TENGGARA BARAT,LOMBOK TIMUR,SAKRA,23304,6451,29755
NUSA TENGGARA BARAT,LOMBOK TIMUR,MONTONG GADING,17521,6041,23562
NUSA TENGGARA BARAT,LOMBOK TIMUR,SELONG,36603,8288,44891
NUSA TENGGARA BARAT,SUMBAWA,TARANO,4879,3688,8567
NUSA TENGGARA BARAT,SUMBAWA,LABUHAN BADAS,10407,6264,16671
NUSA TENGGARA BARAT,SUMBAWA,SUMBAWA,20983,9951,30934
NUSA TENGGARA BARAT,SUMBAWA,LUNYUK,6484,3889,10373
NUSA TENGGARA BARAT,SUMBAWA,MARONGE,3767,1984,5751
NUSA TENGGARA BARAT,SUMBAWA,UTAN,10274,6027,16301
NUSA TENGGARA BARAT,SUMBAWA,ALAS,9407,5921,15328
NUSA TENGGARA BARAT,SUMBAWA,LANTUNG,1149,646,1795
NUSA TENGGARA BARAT,SUMBAWA,EMPANG,7815,5527,13342
NUSA TENGGARA BARAT,SUMBAWA,ROPANG,2065,1110,3175
NUSA TENGGARA BARAT,SUMBAWA,LENANGGUAR,2751,1403,4154
NUSA TENGGARA BARAT,SUMBAWA,UNTER IWES,8807,2732,11539
NUSA TENGGARA BARAT,SUMBAWA,LOPOK,7142,4039,11181
NUSA TENGGARA BARAT,SUMBAWA,LAPE,6934,3081,10015
NUSA TENGGARA BARAT,SUMBAWA,MOYO UTARA,4420,1639,6059
NUSA TENGGARA BARAT,SUMBAWA,MOYO HILIR,10159,3976,14135
NUSA TENGGARA BARAT,SUMBAWA,MOYO HULU,8516,4749,13265
NUSA TENGGARA BARAT,DOMPU,DOMPU,20307,7573,27880
NUSA TENGGARA BARAT,SUMBAWA,PLAMPANG,10389,5546,15935
NUSA TENGGARA BARAT,DOMPU,WOJA,23787,6455,30242
NUSA TENGGARA BARAT,DOMPU,PEKAT,11348,4409,15757
NUSA TENGGARA BARAT,SUMBAWA,BATU LANTEH,4458,1478,5936
NUSA TENGGARA BARAT,DOMPU,KILO,4173,2907,7080
NUSA TENGGARA BARAT,DOMPU,KEMPO,5876,4334,10210
NUSA TENGGARA BARAT,BIMA,LAMBU,9291,7400,16691
NUSA TENGGARA BARAT,DOMPU,PAJO,3946,2613,6559
NUSA TENGGARA BARAT,BIMA,DONGGO,6796,3926,10722
NUSA TENGGARA BARAT,BIMA,MONTA,12132,4158,16290
NUSA TENGGARA BARAT,BIMA,WAWO,6694,2243,8937
NUSA TENGGARA BARAT,BIMA,PARADO,3459,1210,4669
NUSA TENGGARA BARAT,BIMA,LAMBITU,1899,897,2796
NUSA TENGGARA BARAT,DOMPU,MANGGELEWA,10634,4799,15433
NUSA TENGGARA BARAT,BIMA,LANGGUDU,9581,4432,14013
NUSA TENGGARA BARAT,BIMA,WERA,10583,3909,14492
NUSA TENGGARA BARAT,BIMA,BELO,9428,3198,12626
NUSA TENGGARA BARAT,BIMA,TAMBORA,2977,898,3875
NUSA TENGGARA BARAT,BIMA,SOROMANDI,6099,2925,9024
NUSA TENGGARA BARAT,BIMA,MADAPANGGA,11572,4056,15628
NUSA TENGGARA BARAT,BIMA,BOLO,18939,6451,25390
NUSA TENGGARA BARAT,BIMA,AMBALAWI,7547,2223,9770
NUSA TENGGARA BARAT,LOMBOK UTARA,GANGGA,19140,6418,25558
NUSA TENGGARA BARAT,BIMA,SANGGAR,4389,1890,6279
NUSA TENGGARA BARAT,BIMA,SAPE,18741,8296,27037
NUSA TENGGARA BARAT,SUMBAWA BARAT,SEKONGKANG,2490,1626,4116
NUSA TENGGARA BARAT,LOMBOK UTARA,TANJUNG,16376,10895,27271
NUSA TENGGARA BARAT,SUMBAWA BARAT,BRANG ENE,2316,902,3218
NUSA TENGGARA BARAT,BIMA,WOHA,17163,6135,23298
NUSA TENGGARA BARAT,LOMBOK UTARA,KAYANGAN,18048,5380,23428
NUSA TENGGARA BARAT,BIMA,PALIBELO,11550,3089,14639
NUSA TENGGARA BARAT,SUMBAWA BARAT,BRANG REA,5402,2320,7722
NUSA TENGGARA BARAT,KOTA MATARAM,SEKARBELA,20223,5899,26122
NUSA TENGGARA BARAT,SUMBAWA BARAT,POTO TANO,3410,2295,5705
NUSA TENGGARA BARAT,SUMBAWA BARAT,JEREWEH,3518,1366,4884
NUSA TENGGARA BARAT,SUMBAWA BARAT,TALIWANG,17911,8002,25913
NUSA TENGGARA BARAT,SUMBAWA BARAT,SETELUK,6027,3421,9448
NUSA TENGGARA BARAT,KOTA BIMA,RASANAE TIMUR,7781,1924,9705
NUSA TENGGARA BARAT,KOTA BIMA,RASANAE BARAT,11255,5313,16568
NUSA TENGGARA BARAT,KOTA MATARAM,SANDUBAYA,0,0,0
NUSA TENGGARA BARAT,SUMBAWA BARAT,MALUK,2860,2253,5113
NUSA TENGGARA BARAT,KOTA MATARAM,MATARAM,0,0,0
NUSA TENGGARA BARAT,KOTA BIMA,RABA,16782,4233,21015
NUSA TENGGARA TIMUR,KUPANG,AMARASI TIMUR,1774,1661,3435
NUSA TENGGARA TIMUR,KUPANG,AMABI OEFETO TIMUR,3626,2481,6107
NUSA TENGGARA BARAT,KOTA BIMA,ASAKOTA,11720,3835,15555
NUSA TENGGARA BARAT,KOTA MATARAM,CAKRANEGARA,0,0,0
NUSA TENGGARA BARAT,KOTA MATARAM,SELAPARANG,0,0,0
NUSA TENGGARA BARAT,LOMBOK UTARA,BAYAN,17154,8682,25836
NUSA TENGGARA BARAT,KOTA MATARAM,AMPENAN,29978,12509,42487
NUSA TENGGARA TIMUR,KUPANG,KUPANG TIMUR,10288,9635,19923
NUSA TENGGARA BARAT,LOMBOK UTARA,PEMENANG,12621,4471,17092
NUSA TENGGARA BARAT,KOTA BIMA,MPUNDA,12356,3611,15967
NUSA TENGGARA TIMUR,KUPANG,SULAMU,3016,4088,7104
NUSA TENGGARA TIMUR,KUPANG,AMFOANG TIMUR,1885,1252,3137
NUSA TENGGARA TIMUR,KUPANG,KUPANG BARAT,4276,4098,8374
NUSA TENGGARA TIMUR,KUPANG,SEMAU,1138,1993,3131
NUSA TENGGARA TIMUR,KUPANG,AMFOANG BARAT DAYA,1261,899,2160
NUSA TENGGARA TIMUR,KUPANG,FATULEU TENGAH,1816,604,2420
NUSA TENGGARA TIMUR,KUPANG,AMARASI SELATAN,2260,2596,4856
NUSA TENGGARA TIMUR,KUPANG,AMARASI,4200,3663,7863
NUSA TENGGARA TIMUR,KUPANG,TAEBENU,4328,3603,7931
NUSA TENGGARA TIMUR,KUPANG,FATULEU BARAT,2798,1227,4025
NUSA TENGGARA TIMUR,KUPANG,SEMAU SELATAN,1056,1148,2204
NUSA TENGGARA TIMUR,KUPANG,AMFOANG BARAT LAUT,1653,2381,4034
NUSA TENGGARA TIMUR,KUPANG,AMABI OEFETO,2073,1575,3648
NUSA TENGGARA TIMUR,KUPANG,FATULEU,5439,5342,10781
NUSA TENGGARA TIMUR,TIMOR TENGAH SELATAN,KOK BAUN,0,0,0
NUSA TENGGARA TIMUR,KUPANG,AMFOANG TENGAH,2039,662,2701
NUSA TENGGARA TIMUR,KUPANG,AMARASI BARAT,3976,3329,7305
NUSA TENGGARA TIMUR,KUPANG,NEKAMESE,3006,2001,5007
NUSA TENGGARA TIMUR,TIMOR TENGAH SELATAN,KOTA SOE,0,0,0
NUSA TENGGARA TIMUR,KUPANG,KUPANG TENGAH,7440,10073,17513
NUSA TENGGARA TIMUR,KUPANG,TAKARI,5807,4042,9849
NUSA TENGGARA TIMUR,TIMOR TENGAH SELATAN,OENINO,0,0,0
NUSA TENGGARA TIMUR,KUPANG,AMFOANG SELATAN,2334,1722,4056
NUSA TENGGARA TIMUR,KUPANG,AMFOANG UTARA,1614,1521,3135
NUSA TENGGARA TIMUR,TIMOR TENGAH SELATAN,KOLBANO,0,0,0
NUSA TENGGARA TIMUR,TIMOR TENGAH SELATAN,KOT OLIN,0,0,0
NUSA TENGGARA TIMUR,TIMOR TENGAH SELATAN,AMANUBAN TENGAH,0,0,0
NUSA TENGGARA TIMUR,TIMOR TENGAH SELATAN,FATUKOPA,0,0,0
NUSA TENGGARA TIMUR,TIMOR TENGAH SELATAN,FAUTMOLO,0,0,0
NUSA TENGGARA TIMUR,TIMOR TENGAH SELATAN,NOEBEBA,0,0,0
NUSA TENGGARA TIMUR,TIMOR TENGAH SELATAN,KUALIN,0,0,0
NUSA TENGGARA TIMUR,TIMOR TENGAH SELATAN,MOLLO UTARA,0,0,0
NUSA TENGGARA TIMUR,TIMOR TENGAH SELATAN,MOLLO BARAT,0,0,0
NUSA TENGGARA TIMUR,TIMOR TENGAH SELATAN,AMANUBAN TIMUR,0,0,0
NUSA TENGGARA TIMUR,TIMOR TENGAH SELATAN,AMANATUN UTARA,0,0,0
NUSA TENGGARA TIMUR,TIMOR TENGAH SELATAN,NOEBANA,0,0,0
NUSA TENGGARA TIMUR,TIMOR TENGAH SELATAN,NUNKOLO,0,0,0
NUSA TENGGARA TIMUR,TIMOR TENGAH SELATAN,AMANUBAN SELATAN,0,0,0
NUSA TENGGARA TIMUR,TIMOR TENGAH SELATAN,KUATNANA,0,0,0
NUSA TENGGARA TIMUR,TIMOR TENGAH SELATAN,MOLLO TENGAH,0,0,0
NUSA TENGGARA TIMUR,TIMOR TENGAH SELATAN,SANTIAN,0,0,0
NUSA TENGGARA TIMUR,TIMOR TENGAH UTARA,BIKOMI SELATAN,2097,2374,4471
NUSA TENGGARA TIMUR,TIMOR TENGAH SELATAN,TOIANAS,0,0,0
NUSA TENGGARA TIMUR,TIMOR TENGAH UTARA,BIKOMI NILULAT,1017,1171,2188
NUSA TENGGARA TIMUR,TIMOR TENGAH SELATAN,TOBU,0,0,0
NUSA TENGGARA TIMUR,TIMOR TENGAH SELATAN,AMANATUN SELATAN,0,0,0
NUSA TENGGARA TIMUR,TIMOR TENGAH SELATAN,MOLLO SELATAN,0,0,0
NUSA TENGGARA TIMUR,TIMOR TENGAH UTARA,INSANA TENGAH,1743,2938,4681
NUSA TENGGARA TIMUR,TIMOR TENGAH UTARA,INSANA BARAT,1605,2440,4045
NUSA TENGGARA TIMUR,TIMOR TENGAH UTARA,BIKOMI TENGAH,1562,1725,3287
NUSA TENGGARA TIMUR,TIMOR TENGAH SELATAN,BOKING,0,0,0
NUSA TENGGARA TIMUR,TIMOR TENGAH SELATAN,BATU PUTIH,0,0,0
NUSA TENGGARA TIMUR,TIMOR TENGAH SELATAN,AMANUBAN BARAT,0,0,0
NUSA TENGGARA TIMUR,TIMOR TENGAH UTARA,BIKOMI UTARA,1278,1729,3007
NUSA TENGGARA TIMUR,TIMOR TENGAH SELATAN,NUNBENA,0,0,0
NUSA TENGGARA TIMUR,TIMOR TENGAH SELATAN,KUANFATU,0,0,0
NUSA TENGGARA TIMUR,TIMOR TENGAH UTARA,BIBOKI TAN PAH,1260,1046,2306
NUSA TENGGARA TIMUR,TIMOR TENGAH UTARA,BIBOKI MOENLEU,1426,1498,2924
NUSA TENGGARA TIMUR,TIMOR TENGAH UTARA,INSANA FAFINESU,575,1887,2462
NUSA TENGGARA TIMUR,TIMOR TENGAH SELATAN,FATUMNASI,0,0,0
NUSA TENGGARA TIMUR,TIMOR TENGAH UTARA,NAIBENU,1233,1173,2406
NUSA TENGGARA TIMUR,TIMOR TENGAH SELATAN,POLEN,0,0,0
NUSA TENGGARA TIMUR,TIMOR TENGAH UTARA,MIOMAFO TIMUR,2365,3118,5483
NUSA TENGGARA TIMUR,TIMOR TENGAH UTARA,MIOMAFO BARAT,2102,4818,6920
NUSA TENGGARA TIMUR,TIMOR TENGAH UTARA,MIOMAFFO TENGAH,1224,1519,2743
NUSA TENGGARA TIMUR,BELU,LAEN MANEN,973,3719,4692
NUSA TENGGARA TIMUR,TIMOR TENGAH UTARA,INSANA UTARA,1351,2748,4099
NUSA TENGGARA TIMUR,TIMOR TENGAH UTARA,BIBOKI UTARA,2434,1994,4428
NUSA TENGGARA TIMUR,TIMOR TENGAH UTARA,KOTA KEFAMENANU,9860,10179,20039
NUSA TENGGARA TIMUR,BELU,WELIMAN,1599,5422,7021
NUSA TENGGARA TIMUR,TIMOR TENGAH UTARA,MUTIS,1030,1877,2907
NUSA TENGGARA TIMUR,BELU,LASIOLAT,1041,1826,2867
NUSA TENGGARA TIMUR,TIMOR TENGAH UTARA,NOEMUTI,1248,4561,5809
NUSA TENGGARA TIMUR,TIMOR TENGAH UTARA,NOEMUTI TIMUR,534,1456,1990
NUSA TENGGARA TIMUR,BELU,WEWIKU,1634,5143,6777
NUSA TENGGARA TIMUR,TIMOR TENGAH UTARA,BIBOKI SELATAN,1721,1771,3492
NUSA TENGGARA TIMUR,TIMOR TENGAH UTARA,INSANA,2973,5449,8422
NUSA TENGGARA TIMUR,TIMOR TENGAH UTARA,MUSI,515,1645,2160
NUSA TENGGARA TIMUR,BELU,RAIHAT,3932,1684,5616
NUSA TENGGARA TIMUR,BELU,LAMAKNEN SELATAN,1023,1938,2961
NUSA TENGGARA TIMUR,BELU,ATAMBUA BARAT,4030,4922,8952
NUSA TENGGARA TIMUR,BELU,LAMAKNEN,3065,1912,4977
NUSA TENGGARA TIMUR,TIMOR TENGAH UTARA,BIBOKI ANLEU,2905,3429,6334
NUSA TENGGARA TIMUR,BELU,TASIFETOTIMUR,5595,3965,9560
NUSA TENGGARA TIMUR,TIMOR TENGAH UTARA,BIBOKI FEOTLEU,898,845,1743
NUSA TENGGARA TIMUR,BELU,NANAET DUABESI,601,1016,1617
NUSA TENGGARA TIMUR,BELU,MALAKA BARAT,1851,6446,8297
NUSA TENGGARA TIMUR,BELU,BOTIN LEO BELE,596,1339,1935
NUSA TENGGARA TIMUR,BELU,IO KUFEU,1104,2115,3219
NUSA TENGGARA TIMUR,BELU,ATAMBUA SELATAN,5209,4914,10123
NUSA TENGGARA TIMUR,BELU,KOBALIMA TIMUR,1306,1026,2332
NUSA TENGGARA TIMUR,ALOR,PANTAR TIMUR,2674,2910,5584
NUSA TENGGARA TIMUR,BELU,RINHAT,2106,3369,5475
NUSA TENGGARA TIMUR,BELU,TASIFETO BARAT,4421,4315,8736
NUSA TENGGARA TIMUR,BELU,SASITAMEAN,838,2660,3498
NUSA TENGGARA TIMUR,ALOR,PULAU PURA,1027,1732,2759
NUSA TENGGARA TIMUR,BELU,KOTA ATAMBUA,7072,4497,11569
NUSA TENGGARA TIMUR,BELU,MALAKA TENGAH,5237,9300,14537
NUSA TENGGARA TIMUR,BELU,RAIMANUK,2527,3086,5613
NUSA TENGGARA TIMUR,BELU,KAKULUK MESAK,5591,2679,8270
NUSA TENGGARA TIMUR,ALOR,KABOLA,1675,2521,4196
NUSA TENGGARA TIMUR,ALOR,ALOR TIMUR LAUT,1107,3082,4189
NUSA TENGGARA TIMUR,ALOR,TELUK MUTIARA,13512,11536,25048
NUSA TENGGARA TIMUR,ALOR,MATARU,1104,1836,2940
NUSA TENGGARA TIMUR,BELU,KOBALIMA,3864,3187,7051
NUSA TENGGARA TIMUR,BELU,MALAKA TIMUR,1353,2508,3861
NUSA TENGGARA TIMUR,ALOR,PUREMAN,328,1257,1585
NUSA TENGGARA TIMUR,ALOR,ALOR TENGAH UTARA,2169,3456,5625
NUSA TENGGARA TIMUR,ALOR,PANTAR,2907,1884,4791
NUSA TENGGARA TIMUR,ALOR,PANTAR BARAT,2300,902,3202
NUSA TENGGARA TIMUR,FLORES TIMUR,ADONARA TENGAH,1076,3948,5024
NUSA TENGGARA TIMUR,ALOR,PANTAR TENGAH,2925,1941,4866
NUSA TENGGARA TIMUR,ALOR,ALOR BARAT DAYA,4136,6653,10789
NUSA TENGGARA TIMUR,ALOR,LEMBUR,709,1626,2335
NUSA TENGGARA TIMUR,FLORES TIMUR,KELUBAGOLIT,1121,4650,5771
NUSA TENGGARA TIMUR,ALOR,ALOR SELATAN,1481,3212,4693
NUSA TENGGARA TIMUR,FLORES TIMUR,WULANGGITANG,771,5693,6464
NUSA TENGGARA TIMUR,FLORES TIMUR,WITIHAMA,985,6830,7815
NUSA TENGGARA TIMUR,FLORES TIMUR,LEWOLEMA,728,3337,4065
NUSA TENGGARA TIMUR,FLORES TIMUR,ILE BURA,373,2842,3215
NUSA TENGGARA TIMUR,FLORES TIMUR,WOTAN ULUMANDO,802,2792,3594
NUSA TENGGARA TIMUR,FLORES TIMUR,ADONARA TIMUR,4819,6765,11584
NUSA TENGGARA TIMUR,FLORES TIMUR,ILE MANDIRI,681,4161,4842
NUSA TENGGARA TIMUR,FLORES TIMUR,ADONARA,1702,2929,4631
NUSA TENGGARA TIMUR,FLORES TIMUR,ILE BOLENG,1364,5491,6855
NUSA TENGGARA TIMUR,ALOR,PANTAR BARAT LAUT,1376,905,2281
NUSA TENGGARA TIMUR,ALOR,ALOR TIMUR,1553,2485,4038
NUSA TENGGARA TIMUR,SIKKA,ALOK TIMUR,5088,9300,14388
NUSA TENGGARA TIMUR,FLORES TIMUR,SOLOR TIMUR,3524,2406,5930
NUSA TENGGARA TIMUR,FLORES TIMUR,SOLOR BARAT,679,3673,4352
NUSA TENGGARA TIMUR,FLORES TIMUR,DEMON PAGONG,234,2222,2456
NUSA TENGGARA TIMUR,ALOR,ALOR BARAT LAUT,6511,4020,10531
NUSA TENGGARA TIMUR,SIKKA,HEWOKLOANG,615,3370,3985
NUSA TENGGARA TIMUR,FLORES TIMUR,SOLOR SELATAN,268,2039,2307
NUSA TENGGARA TIMUR,FLORES TIMUR,TANJUNG BUNGA,911,4830,5741
NUSA TENGGARA TIMUR,SIKKA,WAIBLAMA,859,2495,3354
NUSA TENGGARA TIMUR,SIKKA,KEWAPANTE,1406,4729,6135
NUSA TENGGARA TIMUR,SIKKA,PAGA,1139,6066,7205
NUSA TENGGARA TIMUR,SIKKA,TANA WAWO,966,3236,4202
NUSA TENGGARA TIMUR,FLORES TIMUR,ADONARA BARAT,1233,4314,5547
NUSA TENGGARA TIMUR,SIKKA,MAGEPANDA,867,4492,5359
NUSA TENGGARA TIMUR,SIKKA,KOTING,621,2932,3553
NUSA TENGGARA TIMUR,SIKKA,NELLE,507,2643,3150
NUSA TENGGARA TIMUR,SIKKA,MAPITARA,322,2712,3034
NUSA TENGGARA TIMUR,SIKKA,ALOK,3735,10479,14214
NUSA TENGGARA TIMUR,SIKKA,MEGO,937,4528,5465
NUSA TENGGARA TIMUR,FLORES TIMUR,TITEHENA,1035,4651,5686
NUSA TENGGARA TIMUR,FLORES TIMUR,LARANTUKA,4811,12877,17688
NUSA TENGGARA TIMUR,SIKKA,BOLA,1092,4041,5133
NUSA TENGGARA TIMUR,SIKKA,KANGAE,2104,6064,8168
NUSA TENGGARA TIMUR,SIKKA,ALOK BARAT,2459,5280,7739
NUSA TENGGARA TIMUR,ENDE,NDONA TIMUR,296,2008,2304
NUSA TENGGARA TIMUR,SIKKA,NITA,1177,9850,11027
NUSA TENGGARA TIMUR,SIKKA,WAIGETE,1627,7910,9537
NUSA TENGGARA TIMUR,SIKKA,TALIBURA,2845,6288,9133
NUSA TENGGARA TIMUR,SIKKA,DORENG,871,3749,4620
NUSA TENGGARA TIMUR,SIKKA,PALUE,479,3490,3969
NUSA TENGGARA TIMUR,SIKKA,LELA,661,5257,5918
NUSA TENGGARA TIMUR,ENDE,ENDE TENGAH,3316,9188,12504
NUSA TENGGARA TIMUR,ENDE,PULAU ENDE,3213,1027,4240
NUSA TENGGARA TIMUR,ENDE,ENDE TIMUR,2832,7081,9913
NUSA TENGGARA TIMUR,ENDE,KOTA BARU,513,4048,4561
NUSA TENGGARA TIMUR,ENDE,MAUKARO,452,2953,3405
NUSA TENGGARA TIMUR,ENDE,NANGAPANDA,3396,7971,11367
NUSA TENGGARA TIMUR,ENDE,ENDE,908,7647,8555
NUSA TENGGARA TIMUR,ENDE,KELIMUTU,350,3033,3383
NUSA TENGGARA TIMUR,ENDE,MAUROLE,961,3990,4951
NUSA TENGGARA TIMUR,ENDE,ENDE UTARA,4259,4501,8760
NUSA TENGGARA TIMUR,ENDE,DETUKELI,435,2541,2976
NUSA TENGGARA TIMUR,ENDE,LIO TIMUR,574,2774,3348
NUSA TENGGARA TIMUR,ENDE,NDONA,1621,5545,7166
NUSA TENGGARA TIMUR,NGADA,JEREBUU,663,2482,3145
NUSA TENGGARA TIMUR,NGADA,GOLEWA SELATAN,1381,3449,4830
NUSA TENGGARA TIMUR,NGADA,BAJAWA UTARA,1091,2697,3788
NUSA TENGGARA TIMUR,NGADA,WOLOMEZE,630,1993,2623
NUSA TENGGARA TIMUR,ENDE,NDORI,1415,1152,2567
NUSA TENGGARA TIMUR,ENDE,DETUSOKO,513,6460,6973
NUSA TENGGARA TIMUR,ENDE,ENDE SELATAN,7877,4510,12387
NUSA TENGGARA TIMUR,NGADA,BAJAWA,4962,11058,16020
NUSA TENGGARA TIMUR,ENDE,LEPEMBUSU KELISOKE,341,2231,2572
NUSA TENGGARA TIMUR,NGADA,GOLEWA,1544,6114,7658
NUSA TENGGARA TIMUR,ENDE,WEWARIA,1373,7010,8383
NUSA TENGGARA TIMUR,ENDE,WOLOJITA,496,2731,3227
NUSA TENGGARA TIMUR,ENDE,WOLOWARU,2838,5010,7848
NUSA TENGGARA TIMUR,MANGGARAI,SATAR MESE,3392,9395,12787
NUSA TENGGARA TIMUR,NGADA,AIMERE,1232,2877,4109
NUSA TENGGARA TIMUR,MANGGARAI,WAE RII,2685,9469,12154
NUSA TENGGARA TIMUR,MANGGARAI,CIBAL,2833,8776,11609
NUSA TENGGARA TIMUR,NGADA,GOLEWA BARAT,1568,2604,4172
NUSA TENGGARA TIMUR,MANGGARAI,LELAK,970,3989,4959
NUSA TENGGARA TIMUR,NGADA,SOA,2551,3622,6173
NUSA TENGGARA TIMUR,MANGGARAI,SATAR MESE BARAT,3566,9561,13127
NUSA TENGGARA TIMUR,NGADA,RIUNG,2459,4068,6527
NUSA TENGGARA TIMUR,MANGGARAI,REOK BARAT,1764,4548,6312
NUSA TENGGARA TIMUR,NGADA,RIUNG BARAT,1466,2087,3553
NUSA TENGGARA TIMUR,MANGGARAI,LANGKE REMBONG,8209,21318,29527
NUSA TENGGARA TIMUR,SUMBA TIMUR,KOTA WAINGAPU,5444,9825,15269
NUSA TENGGARA TIMUR,SUMBA TIMUR,KARERA,976,2485,3461
NUSA TENGGARA TIMUR,SUMBA TIMUR,NGADU NGALA,429,1797,2226
NUSA TENGGARA TIMUR,NGADA,INERIE,796,2509,3305
NUSA TENGGARA TIMUR,MANGGARAI,RUTENG,3454,13886,17340
NUSA TENGGARA TIMUR,MANGGARAI,RAHONG UTARA,2247,6514,8761
NUSA TENGGARA TIMUR,SUMBA TIMUR,KAMBATA MAPAMBUHANG,466,1242,1708
NUSA TENGGARA TIMUR,MANGGARAI,REOK,3439,5436,8875
NUSA TENGGARA TIMUR,SUMBA TIMUR,LEWA,1620,4827,6447
NUSA TENGGARA TIMUR,SUMBA TIMUR,UMALULU,2605,4977,7582
NUSA TENGGARA TIMUR,SUMBA TIMUR,MATAWAI LA PAWU,589,1798,2387
NUSA TENGGARA TIMUR,SUMBA TIMUR,PABERIWAI,475,1671,2146
NUSA TENGGARA TIMUR,SUMBA TIMUR,KAHAUNGU ETI,1074,2576,3650
NUSA TENGGARA TIMUR,MANGGARAI,CIBAL BARAT,1469,4460,5929
NUSA TENGGARA TIMUR,SUMBA TIMUR,LEWA TIDAHU,648,2139,2787
NUSA TENGGARA TIMUR,SUMBA TIMUR,PINU PAHAR,869,2494,3363
NUSA TENGGARA TIMUR,SUMBA TIMUR,KAMBERA,3417,11945,15362
NUSA TENGGARA TIMUR,SUMBA BARAT,LOLI,3456,7113,10569
NUSA TENGGARA TIMUR,SUMBA BARAT,LAMBOYA,1860,4630,6490
NUSA TENGGARA TIMUR,SUMBA TIMUR,KANATANG,898,3001,3899
NUSA TENGGARA TIMUR,SUMBA TIMUR,KATALA HAMU LINGU,380,1309,1689
NUSA TENGGARA TIMUR,SUMBA TIMUR,WULLA WAIJELU,1078,2458,3536
NUSA TENGGARA TIMUR,SUMBA TIMUR,HAHARU,644,1715,2359
NUSA TENGGARA TIMUR,SUMBA TIMUR,RINDI,1428,2756,4184
NUSA TENGGARA TIMUR,SUMBA BARAT,KOTA WAIKABUBAK,4389,7931,12320
NUSA TENGGARA TIMUR,SUMBA TIMUR,NGGAHA ORI ANGU,1124,2702,3826
NUSA TENGGARA TIMUR,SUMBA TIMUR,TABUNDUNG,1195,2919,4114
NUSA TENGGARA TIMUR,SUMBA TIMUR,PANDAWAI,1730,5574,7304
NUSA TENGGARA TIMUR,SUMBA TIMUR,PAHUNGA LODU,1938,3692,5630
NUSA TENGGARA TIMUR,ROTE NDAO,NDAO NUSE,161,1328,1489
NUSA TENGGARA TIMUR,LEMBATA,NAGA WUTUNG,0,0,0
NUSA TENGGARA TIMUR,SUMBA TIMUR,MAHU,788,1000,1788
NUSA TENGGARA TIMUR,LEMBATA,OMESURI,0,0,0
NUSA TENGGARA TIMUR,SUMBA BARAT,LABOYA BARAT,897,2089,2986
NUSA TENGGARA TIMUR,SUMBA BARAT,WANOKAKA,1736,4501,6237
NUSA TENGGARA TIMUR,LEMBATA,NUBATUKAN,0,0,0
NUSA TENGGARA TIMUR,SUMBA BARAT,TANA RIGHU,1253,5860,7113
NUSA TENGGARA TIMUR,LEMBATA,LEBATUKAN,0,0,0
NUSA TENGGARA TIMUR,LEMBATA,ILE APE TIMUR,0,0,0
NUSA TENGGARA TIMUR,ROTE NDAO,ROTE BARAT,804,2572,3376
NUSA TENGGARA TIMUR,LEMBATA,ATADEI,0,0,0
NUSA TENGGARA TIMUR,ROTE NDAO,ROTE TIMUR,1543,4457,6000
NUSA TENGGARA TIMUR,LEMBATA,WULANDONI,0,0,0
NUSA TENGGARA TIMUR,ROTE NDAO,LOBALAIN,2279,10009,12288
NUSA TENGGARA TIMUR,LEMBATA,BUYASURI,0,0,0
NUSA TENGGARA TIMUR,ROTE NDAO,ROTE  SELATAN,658,1780,2438
NUSA TENGGARA TIMUR,LEMBATA,ILE APE,0,0,0
NUSA TENGGARA TIMUR,ROTE NDAO,ROTE TENGAH,1226,2459,3685
NUSA TENGGARA TIMUR,MANGGARAI BARAT,NDOSO,1826,8086,9912
NUSA TENGGARA TIMUR,MANGGARAI BARAT,WELAK,2019,8054,10073
NUSA TENGGARA TIMUR,MANGGARAI BARAT,KUWUS,2813,9559,12372
NUSA TENGGARA TIMUR,NAGEKEO,AESESA,3131,13398,16529
NUSA TENGGARA TIMUR,ROTE NDAO,LANDU LEKO,712,1378,2090
NUSA TENGGARA TIMUR,ROTE NDAO,ROTE BARAT DAYA,1371,7588,8959
NUSA TENGGARA TIMUR,MANGGARAI BARAT,MBELILING,1637,4411,6048
NUSA TENGGARA TIMUR,NAGEKEO,MAUPONGGO,1479,9386,10865
NUSA TENGGARA TIMUR,MANGGARAI BARAT,MACANG PACAR,1776,11692,13468
NUSA TENGGARA TIMUR,MANGGARAI BARAT,LEMBOR,4283,10726,15009
NUSA TENGGARA TIMUR,ROTE NDAO,ROTE BARAT LAUT,2016,7978,9994
NUSA TENGGARA TIMUR,MANGGARAI BARAT,BOLENG,3227,6077,9304
NUSA TENGGARA TIMUR,MANGGARAI BARAT,LEMBOR SELATAN,3628,6945,10573
NUSA TENGGARA TIMUR,NAGEKEO,WOLOWAE,360,2109,2469
NUSA TENGGARA TIMUR,NAGEKEO,NANGARORO,1049,8201,9250
NUSA TENGGARA TIMUR,ROTE NDAO,PANTAI BARU,1092,4933,6025
NUSA TENGGARA TIMUR,SUMBA TENGAH,KATIKU TANA,1080,3573,4653
NUSA TENGGARA TIMUR,SUMBA BARAT DAYA,KOTA TAMBOLAKA,3045,9933,12978
NUSA TENGGARA TIMUR,MANGGARAI BARAT,SANO NGGOANG,1781,4270,6051
NUSA TENGGARA TIMUR,SUMBA BARAT DAYA,LOURA,1191,5726,6917
NUSA TENGGARA TIMUR,SUMBA TENGAH,KATIKU TANA SELATAN,0,0,0
NUSA TENGGARA TIMUR,MANGGARAI BARAT,KOMODO,8090,11996,20086
NUSA TENGGARA TIMUR,SUMBA BARAT DAYA,WEWEWA SELATAN,5303,5936,11239
NUSA TENGGARA TIMUR,NAGEKEO,BOAWAE,1647,14469,16116
NUSA TENGGARA TIMUR,SUMBA TENGAH,UMBU RATU NGGAY,0,0,0
NUSA TENGGARA TIMUR,SUMBA TENGAH,MAMBORO,0,0,0
NUSA TENGGARA TIMUR,SUMBA BARAT DAYA,KODI BALAGHAR,2177,3791,5968
NUSA TENGGARA TIMUR,NAGEKEO,KEO TENGAH,667,6481,7148
NUSA TENGGARA TIMUR,SUMBA BARAT DAYA,WEWEWA TENGAH,10088,13276,23364
NUSA TENGGARA TIMUR,NAGEKEO,AESESA SELATAN,295,2382,2677
NUSA TENGGARA TIMUR,SUMBA BARAT DAYA,KODI,2417,16285,18702
NUSA TENGGARA TIMUR,SUMBA BARAT DAYA,KODI BANGEDO,2692,10449,13141
NUSA TENGGARA TIMUR,SUMBA BARAT DAYA,WEWEWA TIMUR,6599,9111,15710
NUSA TENGGARA TIMUR,SABU RAIJUA,SABU TENGAH,1307,2034,3341
NUSA TENGGARA TIMUR,MANGGARAI TIMUR,RANA MESE,1917,9762,11679
NUSA TENGGARA TIMUR,SUMBA TENGAH,UMBU RATU NGGAY BARAT,0,0,0
NUSA TENGGARA TIMUR,MANGGARAI TIMUR,SAMBI RAMPAS,4812,6799,11611
NUSA TENGGARA TIMUR,SUMBA BARAT DAYA,KODI UTARA,2744,21582,24326
NUSA TENGGARA TIMUR,MANGGARAI TIMUR,BORONG,4729,12064,16793
NUSA TENGGARA TIMUR,SABU RAIJUA,SABU BARAT,4931,8473,13404
NUSA TENGGARA TIMUR,SABU RAIJUA,RAIJUA,545,3232,3777
NUSA TENGGARA TIMUR,SABU RAIJUA,HAWU MEHARA,2063,5124,7187
NUSA TENGGARA TIMUR,MANGGARAI TIMUR,ELAR,2014,3885,5899
NUSA TENGGARA TIMUR,MANGGARAI TIMUR,POCO RANAKA TIMUR,2188,8381,10569
NUSA TENGGARA TIMUR,SUMBA BARAT DAYA,WEWEWA BARAT,10160,16705,26865
NUSA TENGGARA TIMUR,MANGGARAI TIMUR,LAMBA LEDA,3947,9445,13392
NUSA TENGGARA TIMUR,MANGGARAI TIMUR,POCO RANAKA,3666,10401,14067
NUSA TENGGARA TIMUR,SABU RAIJUA,SABU TIMUR,1087,2664,3751
NUSA TENGGARA TIMUR,MANGGARAI TIMUR,ELAR SELATAN,1245,6037,7282
NUSA TENGGARA TIMUR,SUMBA BARAT DAYA,WEWEWA UTARA,4180,6384,10564
NUSA TENGGARA TIMUR,KOTA KUPANG,KOTA LAMA,6555,9020,15575
KALIMANTAN BARAT,SAMBAS,SALATIGA,3294,4748,8042
NUSA TENGGARA TIMUR,MANGGARAI TIMUR,KOTA KOMBA,5188,15459,20647
KALIMANTAN BARAT,SAMBAS,SAMBAS,12143,12524,24667
NUSA TENGGARA TIMUR,KOTA KUPANG,KELAPA LIMA,11236,19350,30586
KALIMANTAN BARAT,SAMBAS,SUBAH,3498,7953,11451
NUSA TENGGARA TIMUR,KOTA KUPANG,ALAK,13433,16174,29607
NUSA TENGGARA TIMUR,KOTA KUPANG,MAULAFA,16342,20772,37114
NUSA TENGGARA TIMUR,SABU RAIJUA,SABU LIAE,1230,3070,4300
KALIMANTAN BARAT,SAMBAS,SAJAD,1764,3262,5026
KALIMANTAN BARAT,SAMBAS,SEBAWI,3584,4732,8316
KALIMANTAN BARAT,SAMBAS,PALOH,5078,7186,12264
NUSA TENGGARA TIMUR,KOTA KUPANG,KOTA RAJA,10007,15302,25309
NUSA TENGGARA TIMUR,KOTA KUPANG,OEBOBO,14788,26656,41444
KALIMANTAN BARAT,SAMBAS,TEKARANG,3597,3940,7537
KALIMANTAN BARAT,SAMBAS,TELUK KERAMAT,15253,17614,32867
KALIMANTAN BARAT,SAMBAS,TANGARAN,6152,4870,11022
KALIMANTAN BARAT,SAMBAS,GALING,4933,7066,11999
KALIMANTAN BARAT,SAMBAS,JAWAI,8663,9338,18001
KALIMANTAN BARAT,SAMBAS,SEMPARUK,6175,6990,13165
KALIMANTAN BARAT,SAMBAS,JAWAI SELATAN,3803,5271,9074
KALIMANTAN BARAT,PONTIANAK,ANJONGAN,4912,3985,8897
KALIMANTAN BARAT,PONTIANAK,SIANTAN,12876,8091,20967
KALIMANTAN BARAT,SAMBAS,SELAKAU TIMUR,2315,2931,5246
KALIMANTAN BARAT,SAMBAS,SAJINGAN BESAR,549,5406,5955
KALIMANTAN BARAT,SAMBAS,SELAKAU,6291,8821,15112
KALIMANTAN BARAT,SAMBAS,SEJANGKUNG,4745,6427,11172
KALIMANTAN BARAT,PONTIANAK,SUNGAI KUNYIT,7486,4056,11542
KALIMANTAN BARAT,PONTIANAK,MEMPAWAH HILIR,13070,5145,18215
KALIMANTAN BARAT,PONTIANAK,TOHO,2366,7692,10058
KALIMANTAN BARAT,PONTIANAK,MEMPAWAH TIMUR,10554,2530,13084
KALIMANTAN BARAT,SAMBAS,PEMANGKAT,7989,14105,22094
KALIMANTAN BARAT,PONTIANAK,SUNGAI PINYUH,15483,9330,24813
KALIMANTAN BARAT,SAMBAS,TEBAS,12993,21819,34812
KALIMANTAN BARAT,PONTIANAK,SEGEDONG,6245,3888,10133
KALIMANTAN BARAT,SANGGAU,KAPUAS,20954,27512,48466
KALIMANTAN BARAT,SANGGAU,TOBA,793,7217,8010
KALIMANTAN BARAT,SANGGAU,BALAI,1869,12864,14733
KALIMANTAN BARAT,SANGGAU,TAYAN HULU,3146,17721,20867
KALIMANTAN BARAT,SANGGAU,MELIAU,10149,17941,28090
KALIMANTAN BARAT,SANGGAU,SEKAYAM,5367,11957,17324
KALIMANTAN BARAT,PONTIANAK,SADANIANG,503,5130,5633
KALIMANTAN BARAT,KETAPANG,DELTA PAWAN,20416,14981,35397
KALIMANTAN BARAT,SANGGAU,MUKOK,4080,6951,11031
KALIMANTAN BARAT,SANGGAU,NOYAN,454,5709,6163
KALIMANTAN BARAT,SANGGAU,BONTI,3037,10728,13765
KALIMANTAN BARAT,SANGGAU,BEDUAI,1385,5339,6724
KALIMANTAN BARAT,KETAPANG,BENUA KAYONG,14965,4811,19776
KALIMANTAN BARAT,KETAPANG,MARAU,1279,6723,8002
KALIMANTAN BARAT,SANGGAU,KEMBAYAN,3977,13693,17670
KALIMANTAN BARAT,KETAPANG,MUARA PAWAN,4103,3009,7112
KALIMANTAN BARAT,KETAPANG,SIMPANG DUA,429,4856,5285
KALIMANTAN BARAT,SANGGAU,TAYAN HILIR,5818,13020,18838
KALIMANTAN BARAT,KETAPANG,JELAI HULU,1634,8185,9819
KALIMANTAN BARAT,SANGGAU,PARINDU,2581,18821,21402
KALIMANTAN BARAT,SANGGAU,JANGKANG,2209,14450,16659
KALIMANTAN BARAT,KETAPANG,MATAN HILIR UTARA,3674,3535,7209
KALIMANTAN BARAT,KETAPANG,SINGKUP,1442,2336,3778
KALIMANTAN BARAT,KETAPANG,HULU SUNGAI,516,6185,6701
KALIMANTAN BARAT,SANGGAU,ENTIKONG,1853,7297,9150
KALIMANTAN BARAT,KETAPANG,SANDAI,5488,8770,14258
KALIMANTAN BARAT,KETAPANG,AIR UPAS,1968,7882,9850
KALIMANTAN BARAT,SINTANG,KELAM PERMAI,2017,8265,10282
KALIMANTAN BARAT,KETAPANG,TUMBANG TITI,3304,8678,11982
KALIMANTAN BARAT,SINTANG,SINTANG,23222,16480,39702
KALIMANTAN BARAT,KETAPANG,PEMAHAN,1152,1356,2508
KALIMANTAN BARAT,KETAPANG,NANGA TAYAP,6038,10097,16135
KALIMANTAN BARAT,KETAPANG,MATAN HILIR SELATAN,8604,5894,14498
KALIMANTAN BARAT,KETAPANG,MANIS MATA,4662,10735,15397
KALIMANTAN BARAT,SINTANG,SUNGAI TEBELIAN,6573,10767,17340
KALIMANTAN BARAT,KETAPANG,SUNGAI LAUR,3178,7265,10443
KALIMANTAN BARAT,KETAPANG,SUNGAI MELAYU RAYAK,2340,4687,7027
KALIMANTAN BARAT,KETAPANG,KENDAWANGAN,5207,12565,17772
KALIMANTAN BARAT,KETAPANG,SIMPANG HULU,1491,17594,19085
KALIMANTAN BARAT,SINTANG,SERAWAI,3297,9761,13058
KALIMANTAN BARAT,SINTANG,DEDAI,7128,11680,18808
KALIMANTAN BARAT,SINTANG,KETUNGAU HILIR,1712,11590,13302
KALIMANTAN BARAT,KAPUAS HULU,SILAT HILIR,2468,7182,9650
KALIMANTAN BARAT,SINTANG,KETUNGAU TENGAH,1787,15700,17487
KALIMANTAN BARAT,KAPUAS HULU,BOYAN TANJUNG,2880,3100,5980
KALIMANTAN BARAT,SINTANG,AMBALAU,1243,7422,8665
KALIMANTAN BARAT,SINTANG,KAYAN HULU,5029,12707,17736
KALIMANTAN BARAT,KAPUAS HULU,KALIS,1659,6384,8043
KALIMANTAN BARAT,SINTANG,KAYAN HILIR,3406,16144,19550
KALIMANTAN BARAT,KAPUAS HULU,BADAU,984,2441,3425
KALIMANTAN BARAT,SINTANG,KETUNGAU HULU,1697,10234,11931
KALIMANTAN BARAT,KAPUAS HULU,SEBERUANG,436,6004,6440
KALIMANTAN BARAT,SINTANG,TEMPUNAK,4008,13032,17040
KALIMANTAN BARAT,KAPUAS HULU,EMBALOH HILIR,727,2298,3025
KALIMANTAN BARAT,KAPUAS HULU,SILAT HULU,2031,4817,6848
KALIMANTAN BARAT,KAPUAS HULU,BATANG LUPAR,635,2214,2849
KALIMANTAN BARAT,SINTANG,BINJAI HULU,2607,4081,6688
KALIMANTAN BARAT,KAPUAS HULU,EMBALOH HULU,220,2492,2712
KALIMANTAN BARAT,SINTANG,SEPAUK,7129,22776,29905
KALIMANTAN BARAT,KAPUAS HULU,BUNUT HULU,4033,3440,7473
KALIMANTAN BARAT,KAPUAS HULU,PUTUSSIBAU UTARA,4717,9033,13750
KALIMANTAN BARAT,KAPUAS HULU,MENTEBAH,1715,3057,4772
KALIMANTAN BARAT,KAPUAS HULU,JONGKONG,3214,2734,5948
KALIMANTAN BARAT,KAPUAS HULU,PUTUSSIBAU SELATAN,4301,7411,11712
KALIMANTAN BARAT,KAPUAS HULU,EMPANANG,201,1940,2141
KALIMANTAN BARAT,KAPUAS HULU,BIKA,251,2294,2545
KALIMANTAN BARAT,BENGKAYANG,SUNGAI RAYA,4666,5208,9874
KALIMANTAN BARAT,KAPUAS HULU,SUHAID,1309,3371,4680
KALIMANTAN BARAT,BENGKAYANG,SUNGAI BETUNG,508,4268,4776
KALIMANTAN BARAT,KAPUAS HULU,PENGKADAN,2619,2253,4872
KALIMANTAN BARAT,KAPUAS HULU,SEMITAU,878,3995,4873
KALIMANTAN BARAT,KAPUAS HULU,SELIMBAU,2336,4955,7291
KALIMANTAN BARAT,BENGKAYANG,CAPKALA,793,3111,3904
KALIMANTAN BARAT,KAPUAS HULU,HULU GURUNG,5534,2626,8160
KALIMANTAN BARAT,KAPUAS HULU,BUNUT HILIR,2094,3057,5151
KALIMANTAN BARAT,BENGKAYANG,SANGGAU LEDO,2242,4272,6514
KALIMANTAN BARAT,BENGKAYANG,SIDING,363,2727,3090
KALIMANTAN BARAT,KAPUAS HULU,PURING KENCANA,104,1236,1340
KALIMANTAN BARAT,BENGKAYANG,LEMBAH BAWANG,501,2366,2867
KALIMANTAN BARAT,BENGKAYANG,JAGOI BABANG,803,3616,4419
KALIMANTAN BARAT,BENGKAYANG,LUMAR,462,3383,3845
KALIMANTAN BARAT,BENGKAYANG,TERIAK,850,7423,8273
KALIMANTAN BARAT,LANDAK,KUALA BEHE,2280,8409,10689
KALIMANTAN BARAT,BENGKAYANG,MONTERADO,3363,10207,13570
KALIMANTAN BARAT,LANDAK,BANYUKE HULU,781,7877,8658
KALIMANTAN BARAT,BENGKAYANG,SUNGAI RAYA KEPULAUAN,5406,5192,10598
KALIMANTAN BARAT,BENGKAYANG,SAMALANTAN,1606,9796,11402
KALIMANTAN BARAT,LANDAK,MENJALIN,1025,10957,11982
KALIMANTAN BARAT,BENGKAYANG,SUTI SEMARANG,617,2562,3179
KALIMANTAN BARAT,BENGKAYANG,SELUAS,2211,6125,8336
KALIMANTAN BARAT,LANDAK,AIR BESAR,2864,13136,16000
KALIMANTAN BARAT,LANDAK,MANDOR,2831,14278,17109
KALIMANTAN BARAT,LANDAK,SEBANGKI,5394,6104,11498
KALIMANTAN BARAT,BENGKAYANG,BENGKAYANG,2540,10584,13124
KALIMANTAN BARAT,LANDAK,MEMPAWAH HULU,1932,21359,23291
KALIMANTAN BARAT,LANDAK,MENYUKE,2869,16176,19045
KALIMANTAN BARAT,SEKADAU,NANGA TAMAN,3275,12587,15862
KALIMANTAN BARAT,LANDAK,JELIMPO,2358,15321,17679
KALIMANTAN BARAT,BENGKAYANG,LEDO,1271,5846,7117
KALIMANTAN BARAT,SEKADAU,BELITANG,2481,4461,6942
KALIMANTAN BARAT,BENGKAYANG,TUJUH BELAS,2524,4740,7264
KALIMANTAN BARAT,LANDAK,NGABANG,9248,31249,40497
KALIMANTAN BARAT,LANDAK,SENGAH TEMILA,3991,35825,39816
KALIMANTAN BARAT,LANDAK,MERANTI,1057,5511,6568
KALIMANTAN BARAT,SEKADAU,SEKADAU HILIR,12641,21454,34095
KALIMANTAN BARAT,SEKADAU,SEKADAU HULU,4095,12297,16392
KALIMANTAN BARAT,SEKADAU,BELITANG HULU,1493,12457,13950
KALIMANTAN BARAT,LANDAK,SOMPAK,993,9408,10401
KALIMANTAN BARAT,MELAWI,BELIMBING HULU,2220,4734,6954
KALIMANTAN BARAT,SEKADAU,BELITANG HILIR,3630,10303,13933
KALIMANTAN BARAT,MELAWI,TANAH PINOH BARAT,2908,7371,10279
KALIMANTAN BARAT,MELAWI,ELLA HILIR,4788,6729,11517
KALIMANTAN BARAT,MELAWI,NANGA PINOH,15066,11774,26840
KALIMANTAN BARAT,KAYONG UTARA,TELUK BATANG,4752,3424,8176
KALIMANTAN BARAT,SEKADAU,NANGA MAHAP,3381,10754,14135
KALIMANTAN BARAT,MELAWI,SOKAN,6034,6901,12935
KALIMANTAN BARAT,MELAWI,MENUKUNG,3162,10427,13589
KALIMANTAN BARAT,MELAWI,PINOH SELATAN,3435,4892,8327
KALIMANTAN BARAT,KAYONG UTARA,SUKADANA,7391,4448,11839
KALIMANTAN BARAT,MELAWI,BELIMBING,4538,9771,14309
KALIMANTAN BARAT,KAYONG UTARA,SEPONTI,2559,3082,5641
KALIMANTAN BARAT,MELAWI,TANAH PINOH,6332,4771,11103
KALIMANTAN BARAT,KUBU RAYA,TERENTANG,2689,2688,5377
KALIMANTAN BARAT,KUBU RAYA,SUNGAI AMBAWANG,24972,16621,41593
KALIMANTAN BARAT,KAYONG UTARA,PULAU MAYA,3566,2426,5992
KALIMANTAN BARAT,MELAWI,PINOH UTARA,5578,5918,11496
KALIMANTAN BARAT,KUBU RAYA,RASAU JAYA,6735,6637,13372
KALIMANTAN BARAT,KUBU RAYA,KUALA MANDOR B,10661,3869,14530
KALIMANTAN BARAT,KUBU RAYA,TELUK PAKEDAI,5388,3201,8589
KALIMANTAN BARAT,MELAWI,SAYAN,5289,7942,13231
KALIMANTAN BARAT,KAYONG UTARA,KEPULAUAN KARIMATA,632,886,1518
KALIMANTAN BARAT,KOTA PONTIANAK,PONTIANAK TENGGARA,14293,9343,23636
KALIMANTAN BARAT,KUBU RAYA,BATU AMPAR,9131,6180,15311
KALIMANTAN BARAT,KUBU RAYA,SUNGAI RAYA,57329,47012,104341
KALIMANTAN BARAT,KUBU RAYA,SUNGAI KAKAP,35781,18500,54281
KALIMANTAN BARAT,KUBU RAYA,KUBU,10737,8158,18895
KALIMANTAN BARAT,KOTA PONTIANAK,PONTIANAK TIMUR,31481,12740,44221
KALIMANTAN TENGAH,KOTAWARINGIN BARAT,ARUT SELATAN,27766,25190,52956
KALIMANTAN BARAT,KAYONG UTARA,SIMPANG HILIR,7403,6403,13806
KALIMANTAN BARAT,KOTA PONTIANAK,PONTIANAK SELATAN,19200,27249,46449
KALIMANTAN BARAT,KOTA PONTIANAK,PONTIANAK KOTA,37525,25009,62534
KALIMANTAN TENGAH,KOTAWARINGIN BARAT,KOTAWARINGIN LAMA,4206,5724,9930
KALIMANTAN BARAT,KOTA SINGKAWANG,SINGKAWANG BARAT,6243,15843,22086
KALIMANTAN BARAT,KOTA SINGKAWANG,SINGKAWANG TIMUR,2089,7834,9923
KALIMANTAN BARAT,KOTA PONTIANAK,PONTIANAK UTARA,34513,29021,63534
KALIMANTAN TENGAH,KOTAWARINGIN BARAT,KUMAI,14631,10152,24783
KALIMANTAN BARAT,KOTA SINGKAWANG,SINGKAWANG TENGAH,17577,12370,29947
KALIMANTAN TENGAH,KOTAWARINGIN TIMUR,CEMPAGA HULU,2817,9799,12616
KALIMANTAN BARAT,KOTA SINGKAWANG,SINGKAWANG UTARA,7189,5517,12706
KALIMANTAN BARAT,KOTA PONTIANAK,PONTIANAK BARAT,45640,22915,68555
KALIMANTAN TENGAH,KOTAWARINGIN TIMUR,TELAWANG,2278,9310,11588
KALIMANTAN TENGAH,KOTAWARINGIN TIMUR,KOTA BESI,2640,5479,8119
KALIMANTAN TENGAH,KOTAWARINGIN BARAT,PANGKALAN BANTENG,6264,9349,15613
KALIMANTAN TENGAH,KOTAWARINGIN TIMUR,ANTANG KALANG,1483,7385,8868
KALIMANTAN TENGAH,KOTAWARINGIN TIMUR,BUKIT SANTUAI,1406,5022,6428
KALIMANTAN BARAT,KOTA SINGKAWANG,SINGKAWANG SELATAN,6107,14026,20133
KALIMANTAN TENGAH,KOTAWARINGIN TIMUR,TELUK SAMPIT,2067,2080,4147
KALIMANTAN TENGAH,KOTAWARINGIN BARAT,PANGKALAN LADA,6837,10940,17777
KALIMANTAN TENGAH,KOTAWARINGIN TIMUR,MENTAYA HULU,4118,10643,14761
KALIMANTAN TENGAH,KOTAWARINGIN BARAT,ARUT UTARA,1589,3886,5475
KALIMANTAN TENGAH,KOTAWARINGIN TIMUR,TUALAN HULU,1353,4950,6303
KALIMANTAN TENGAH,KAPUAS,DADAHUP,2394,3114,5508
KALIMANTAN TENGAH,KOTAWARINGIN TIMUR,PULAU HANAUT,3120,3880,7000
KALIMANTAN TENGAH,KOTAWARINGIN TIMUR,MENTAWA BARU KETAPANG,23328,20087,43415
KALIMANTAN TENGAH,KOTAWARINGIN TIMUR,SERANAU,2468,2855,5323
KALIMANTAN TENGAH,KAPUAS,SELAT,20087,11276,31363
KALIMANTAN TENGAH,KAPUAS,KAPUAS HULU,535,4208,4743
KALIMANTAN TENGAH,KOTAWARINGIN TIMUR,MENTAYA HILIR SELATAN,5386,4543,9929
KALIMANTAN TENGAH,KAPUAS,MANDAU TALAWANG,271,2139,2410
KALIMANTAN TENGAH,KAPUAS,MANTANGAI,6179,9578,15757
KALIMANTAN TENGAH,KAPUAS,KAPUAS MURUNG,6091,5793,11884
KALIMANTAN TENGAH,KOTAWARINGIN TIMUR,MENTAYA HILIR UTARA,3057,4975,8032
KALIMANTAN TENGAH,KOTAWARINGIN TIMUR,BAAMANG,14164,12625,26789
KALIMANTAN TENGAH,KOTAWARINGIN TIMUR,PARENGGEAN,3899,10398,14297
KALIMANTAN TENGAH,KOTAWARINGIN TIMUR,CEMPAGA,3353,5966,9319
KALIMANTAN TENGAH,KAPUAS,KAPUAS HILIR,3084,3600,6684
KALIMANTAN TENGAH,KAPUAS,BATAGUH,7811,7929,15740
KALIMANTAN TENGAH,KAPUAS,KAPUAS TIMUR,7219,4399,11618
KALIMANTAN TENGAH,KOTAWARINGIN TIMUR,TELAGA ANTANG,2269,7681,9950
KALIMANTAN TENGAH,BARITO UTARA,GUNUNG TIMANG,0,0,0
KALIMANTAN TENGAH,KAPUAS,KAPUAS BARAT,4029,4389,8418
KALIMANTAN TENGAH,BARITO SELATAN,DUSUN SELATAN,12490,14068,26558
KALIMANTAN TENGAH,BARITO SELATAN,DUSUN UTARA,2150,5801,7951
KALIMANTAN TENGAH,KAPUAS,TIMPAH,988,3298,4286
KALIMANTAN TENGAH,KAPUAS,PASAK TALAWANG,604,2399,3003
KALIMANTAN TENGAH,KAPUAS,PULAU PETAK,5036,3795,8831
KALIMANTAN TENGAH,KAPUAS,TAMBAN CATUR,3191,3654,6845
KALIMANTAN TENGAH,KAPUAS,KAPUAS TENGAH,1039,5480,6519
KALIMANTAN TENGAH,KAPUAS,BASARANG,4827,3812,8639
KALIMANTAN TENGAH,BARITO UTARA,TEWEH TIMUR,0,0,0
KALIMANTAN TENGAH,BARITO UTARA,MONTALLAT,0,0,0
KALIMANTAN TENGAH,KAPUAS,KAPUAS KUALA,4770,4539,9309
KALIMANTAN TENGAH,BARITO UTARA,LAHEI BARAT,0,0,0
KALIMANTAN TENGAH,BARITO SELATAN,JENAMAS,1969,2254,4223
KALIMANTAN TENGAH,KATINGAN,TASIK PAYAWAN,1403,2008,3411
KALIMANTAN TENGAH,KATINGAN,KAMIPANG,1133,1669,2802
KALIMANTAN TENGAH,BARITO SELATAN,DUSUN HILIR,3948,3551,7499
KALIMANTAN TENGAH,BARITO UTARA,TEWEH TENGAH,0,0,0
KALIMANTAN TENGAH,BARITO SELATAN,KARAU KUALA,2584,4846,7430
KALIMANTAN TENGAH,KATINGAN,KATINGAN HILIR,4907,8912,13819
KALIMANTAN TENGAH,KATINGAN,TEWANG SANGALANG GARING,1268,4607,5875
KALIMANTAN TENGAH,BARITO UTARA,GUNUNG PUREI,0,0,0
KALIMANTAN TENGAH,KATINGAN,SANAMAN MANTIKEI,1167,4357,5524
KALIMANTAN TENGAH,KATINGAN,KATINGAN HULU,1026,2974,4000
KALIMANTAN TENGAH,BARITO UTARA,LAHEI,0,0,0
KALIMANTAN TENGAH,BARITO UTARA,TEWEH BARU,0,0,0
KALIMANTAN TENGAH,BARITO UTARA,TEWEH SELATAN,0,0,0
KALIMANTAN TENGAH,SERUYAN,DANAU SELULUK,3470,7490,10960
KALIMANTAN TENGAH,KATINGAN,KATINGAN TENGAH,3673,8836,12509
KALIMANTAN TENGAH,KATINGAN,PETAK MALAI,269,1284,1553
KALIMANTAN TENGAH,SERUYAN,BATU AMPAR,1546,3407,4953
KALIMANTAN TENGAH,KATINGAN,MENDAWAI,1027,819,1846
KALIMANTAN TENGAH,SERUYAN,SERUYAN HULU,1837,3671,5508
KALIMANTAN TENGAH,KATINGAN,BUKIT RAYA,448,1984,2432
KALIMANTAN TENGAH,SERUYAN,SERUYAN TENGAH,3573,9003,12576
KALIMANTAN TENGAH,SERUYAN,SERUYAN RAYA,2125,7681,9806
KALIMANTAN TENGAH,SERUYAN,SERUYAN HILIR TIMUR,1874,1703,3577
KALIMANTAN TENGAH,KATINGAN,KATINGAN KUALA,4553,4998,9551
KALIMANTAN TENGAH,SUKAMARA,SUKAMARA,4254,6648,10902
KALIMANTAN TENGAH,KATINGAN,MARIKIT,571,2748,3319
KALIMANTAN TENGAH,KATINGAN,PULAU MALAN,1150,3049,4199
KALIMANTAN TENGAH,SUKAMARA,PANTAI LUNCI,1103,1295,2398
KALIMANTAN TENGAH,LAMANDAU,MENTHOBI RAYA,1565,3671,5236
KALIMANTAN TENGAH,SUKAMARA,BALAI RIAM,1218,2692,3910
KALIMANTAN TENGAH,SERUYAN,SERUYAN HILIR,6712,8441,15153
KALIMANTAN TENGAH,LAMANDAU,BULIK,4014,6705,10719
KALIMANTAN TENGAH,SERUYAN,SULING TAMBUN,626,821,1447
KALIMANTAN TENGAH,SERUYAN,DANAU SEMBULUH,1999,3765,5764
KALIMANTAN TENGAH,GUNUNG MAS,RUNGAN HULU,0,0,0
KALIMANTAN TENGAH,SERUYAN,HANAU,4827,5678,10505
KALIMANTAN TENGAH,LAMANDAU,BATANG KAWA,349,1060,1409
KALIMANTAN TENGAH,LAMANDAU,BELANTIKAN RAYA,979,1979,2958
KALIMANTAN TENGAH,LAMANDAU,LAMANDAU,950,2110,3060
KALIMANTAN TENGAH,LAMANDAU,SEMATU JAYA,1811,4149,5960
KALIMANTAN TENGAH,GUNUNG MAS,RUNGAN BARAT,0,0,0
KALIMANTAN TENGAH,GUNUNG MAS,KAHAYAN HULU UTARA,0,0,0
KALIMANTAN TENGAH,GUNUNG MAS,SEPANG SIMIN,0,0,0
KALIMANTAN TENGAH,SUKAMARA,JELAI,932,1224,2156
KALIMANTAN TENGAH,SUKAMARA,PERMATA KECUBUNG,928,2340,3268
KALIMANTAN TENGAH,GUNUNG MAS,TEWAH,0,0,0
KALIMANTAN TENGAH,GUNUNG MAS,MIRI MANASA,0,0,0
KALIMANTAN TENGAH,GUNUNG MAS,KURUN,0,0,0
KALIMANTAN TENGAH,PULANG PISAU,KAHAYAN TENGAH,685,3638,4323
KALIMANTAN TENGAH,LAMANDAU,BULIK TIMUR,1279,2250,3529
KALIMANTAN TENGAH,GUNUNG MAS,MANUHING,0,0,0
KALIMANTAN TENGAH,PULANG PISAU,SEBANGAU KUALA,935,1758,2693
KALIMANTAN TENGAH,GUNUNG MAS,MAHUNING RAYA,0,0,0
KALIMANTAN TENGAH,LAMANDAU,DELANG,792,1965,2757
KALIMANTAN TENGAH,PULANG PISAU,MALIKU,5122,6908,12030
KALIMANTAN TENGAH,GUNUNG MAS,DAMANG BATU,0,0,0
KALIMANTAN TENGAH,MURUNG RAYA,PERMATA INTAN,2203,2582,4785
KALIMANTAN TENGAH,GUNUNG MAS,RUNGAN,0,0,0
KALIMANTAN TENGAH,PULANG PISAU,KAHAYAN KUALA,4174,3666,7840
KALIMANTAN TENGAH,GUNUNG MAS,MIHING RAYA,0,0,0
KALIMANTAN TENGAH,MURUNG RAYA,TANAH SIANG,1011,4467,5478
KALIMANTAN TENGAH,MURUNG RAYA,BARITO TUHUP RAYA,759,1580,2339
KALIMANTAN TENGAH,PULANG PISAU,PANDIH BATU,4552,6173,10725
KALIMANTAN TENGAH,BARITO TIMUR,DUSUN TIMUR,4528,8618,13146
KALIMANTAN TENGAH,MURUNG RAYA,SUNGAI BABUAT,218,1051,1269
KALIMANTAN TENGAH,MURUNG RAYA,LAUNG TUHUP,4228,3999,8227
KALIMANTAN TENGAH,MURUNG RAYA,TANAH SIANG SELATAN,457,1732,2189
KALIMANTAN TENGAH,BARITO TIMUR,PEMATANG KARAU,3344,2984,6328
KALIMANTAN TENGAH,BARITO TIMUR,DUSUN TENGAH,5297,6576,11873
KALIMANTAN TENGAH,BARITO TIMUR,PAKU,910,3416,4326
KALIMANTAN TENGAH,PULANG PISAU,BANAMA TINGANG,626,4299,4925
KALIMANTAN TENGAH,PULANG PISAU,JABIREN,1401,2850,4251
KALIMANTAN TENGAH,PULANG PISAU,KAHAYAN HILIR,5700,7699,13399
KALIMANTAN TENGAH,MURUNG RAYA,SERIBU RIAM,304,1233,1537
KALIMANTAN TENGAH,BARITO TIMUR,PAJU EPAT,996,1798,2794
KALIMANTAN TENGAH,MURUNG RAYA,SUMBER BARITO,773,2111,2884
KALIMANTAN TENGAH,KOTA PALANGKARAYA,JEKAN RAYA,26344,35339,61683
KALIMANTAN SELATAN,TANAH LAUT,BAJUIN,4386,4436,8822
KALIMANTAN TENGAH,MURUNG RAYA,MURUNG,10398,5786,16184
KALIMANTAN TENGAH,BARITO TIMUR,RAREN BATUAH,1395,2927,4322
KALIMANTAN TENGAH,KOTA PALANGKARAYA,BUKIT BATU,2195,4143,6338
KALIMANTAN SELATAN,TANAH LAUT,BATU AMPAR,6238,6690,12928
KALIMANTAN TENGAH,BARITO TIMUR,KARUSEN JANANG,703,1750,2453
KALIMANTAN TENGAH,MURUNG RAYA,UUT MURUNG,381,927,1308
KALIMANTAN SELATAN,TANAH LAUT,KURAU,2688,3466,6154
KALIMANTAN TENGAH,KOTA PALANGKARAYA,RAKUMPIT,464,1168,1632
KALIMANTAN TENGAH,BARITO TIMUR,PATANGKEP TUTUI,880,2839,3719
KALIMANTAN SELATAN,KOTABARU,PULAUSEMBILAN,0,0,0
KALIMANTAN TENGAH,KOTA PALANGKARAYA,SABANGAU,4008,4054,8062
KALIMANTAN SELATAN,TANAH LAUT,JORONG,5597,7989,13586
KALIMANTAN SELATAN,KOTABARU,PAMUKAN UTARA,0,0,0
KALIMANTAN TENGAH,KOTA PALANGKARAYA,PAHANDUT,21676,19147,40823
KALIMANTAN SELATAN,KOTABARU,HAMPANG,0,0,0
KALIMANTAN SELATAN,TANAH LAUT,TAKISUNG,7242,7522,14764
KALIMANTAN TENGAH,BARITO TIMUR,BANUA LIMA,1144,2278,3422
KALIMANTAN SELATAN,TANAH LAUT,TAMBANG ULANG,4021,4163,8184
KALIMANTAN SELATAN,TANAH LAUT,KINTAP,6495,12524,19019
KALIMANTAN SELATAN,KOTABARU,KELUMPANG HILIR,0,0,0
KALIMANTAN SELATAN,KOTABARU,PAMUKAN BARAT,0,0,0
KALIMANTAN TENGAH,BARITO TIMUR,AWANG,710,2866,3576
KALIMANTAN SELATAN,KOTABARU,SUNGAIDURIAN,0,0,0
KALIMANTAN SELATAN,TANAH LAUT,PELAIHARI,19918,15205,35123
KALIMANTAN SELATAN,KOTABARU,PULAULAUT KEPULAUAN,0,0,0
KALIMANTAN SELATAN,KOTABARU,KELUMPANG BARAT,0,0,0
KALIMANTAN SELATAN,KOTABARU,PULAUSEBUKU,0,0,0
KALIMANTAN SELATAN,KOTABARU,PAMUKAN SELATAN,0,0,0
KALIMANTAN SELATAN,KOTABARU,PULAULAUT TENGAH,0,0,0
KALIMANTAN SELATAN,TANAH LAUT,BUMI MAKMUR,2293,3295,5588
KALIMANTAN SELATAN,TANAH LAUT,PANYIPATAN,4213,6476,10689
KALIMANTAN SELATAN,KOTABARU,KELUMPANG SELATAN,0,0,0
KALIMANTAN SELATAN,KOTABARU,PULAULAUT TIMUR,0,0,0
KALIMANTAN SELATAN,TANAH LAUT,BATI BATI,9004,10126,19130
KALIMANTAN SELATAN,KOTABARU,PULAULAUT SELATAN,0,0,0
KALIMANTAN SELATAN,KOTABARU,PULAULAUT UTARA,0,0,0
KALIMANTAN SELATAN,KOTABARU,KELUMPANG HULU,0,0,0
KALIMANTAN SELATAN,BANJAR,SUNGAI PINANG,0,0,0
KALIMANTAN SELATAN,BANJAR,MARTAPURA BARAT,0,0,0
KALIMANTAN SELATAN,BANJAR,BERUNTUNG BARU,0,0,0
KALIMANTAN SELATAN,BANJAR,ALUH ALUH,0,0,0
KALIMANTAN SELATAN,BANJAR,TELAGA BAUNTUNG,0,0,0
KALIMANTAN SELATAN,KOTABARU,PULAULAUT BARAT,0,0,0
KALIMANTAN SELATAN,BANJAR,PENGAROM,0,0,0
KALIMANTAN SELATAN,KOTABARU,SAMPANAHAN,0,0,0
KALIMANTAN SELATAN,KOTABARU,KELUMPANG UTARA,0,0,0
KALIMANTAN SELATAN,BANJAR,SIMPANG EMPAT,0,0,0
KALIMANTAN SELATAN,KOTABARU,KELUMPANG TENGAH,0,0,0
KALIMANTAN SELATAN,BANJAR,ASTAMBUL,0,0,0
KALIMANTAN SELATAN,BARITO KUALA,TABUNGANEN,3875,5014,8889
KALIMANTAN SELATAN,BANJAR,SAMBUNG MAKMUR,0,0,0
KALIMANTAN SELATAN,BANJAR,MATARAMAN,0,0,0
KALIMANTAN SELATAN,BANJAR,KERTAK HANYAR,0,0,0
KALIMANTAN SELATAN,BANJAR,ARANIO,0,0,0
KALIMANTAN SELATAN,BARITO KUALA,MARABAHAN,6232,4569,10801
KALIMANTAN SELATAN,KOTABARU,PULAULAUT TANJUNG SELAYAR,0,0,0
KALIMANTAN SELATAN,BARITO KUALA,BAKUMPAI,2544,2275,4819
KALIMANTAN SELATAN,BANJAR,PARAMASAN,0,0,0
KALIMANTAN SELATAN,BANJAR,MARTAPURA TIMUR,0,0,0
KALIMANTAN SELATAN,BANJAR,SUNGAI TABUK,0,0,0
KALIMANTAN SELATAN,BANJAR,GAMBUT,0,0,0
KALIMANTAN SELATAN,BANJAR,MARTAPURA,0,0,0
KALIMANTAN SELATAN,BARITO KUALA,TABUKAN,1730,2449,4179
KALIMANTAN SELATAN,BARITO KUALA,WANARAYA,3375,4194,7569
KALIMANTAN SELATAN,BARITO KUALA,MANDASTANA,3821,4160,7981
KALIMANTAN SELATAN,BANJAR,KARANG INTAN,0,0,0
KALIMANTAN SELATAN,BARITO KUALA,ANJIR MUARA,5356,4948,10304
KALIMANTAN SELATAN,BANJAR,TATAH MAKMUR,0,0,0
KALIMANTAN SELATAN,TAPIN,HATUNGUN,3103,2073,5176
KALIMANTAN SELATAN,BARITO KUALA,BARAMBAI,3780,3324,7104
KALIMANTAN SELATAN,BARITO KUALA,JEJANGKIT,1443,1577,3020
KALIMANTAN SELATAN,BARITO KUALA,RANTAU BADAUH,3814,3621,7435
KALIMANTAN SELATAN,BARITO KUALA,BELAWANG,3197,3518,6715
KALIMANTAN SELATAN,TAPIN,BUNGUR,3562,2748,6310
KALIMANTAN SELATAN,BARITO KUALA,MEKARSARI,3346,4559,7905
KALIMANTAN SELATAN,BARITO KUALA,CERBON,1974,2622,4596
KALIMANTAN SELATAN,BARITO KUALA,ALALAK,12862,12154,25016
KALIMANTAN SELATAN,TAPIN,TAPIN SELATAN,6637,3289,9926
KALIMANTAN SELATAN,TAPIN,PIANI,1512,1693,3205
KALIMANTAN SELATAN,BARITO KUALA,KURIPAN,1529,1504,3033
KALIMANTAN SELATAN,TAPIN,BINUANG,13102,4788,17890
KALIMANTAN SELATAN,HULU SUNGAI SELATAN,LOKSADO,1037,3080,4117
KALIMANTAN SELATAN,TAPIN,TAPIN UTARA,8151,4685,12836
KALIMANTAN SELATAN,TAPIN,LOKPAIKAT,2795,2538,5333
KALIMANTAN SELATAN,HULU SUNGAI SELATAN,DAHA UTARA,7031,6792,13823
KALIMANTAN SELATAN,HULU SUNGAI SELATAN,DAHA SELATAN,6379,11190,17569
KALIMANTAN SELATAN,HULU SUNGAI SELATAN,KALUMPANG,1843,1363,3206
KALIMANTAN SELATAN,BARITO KUALA,TAMBAN,7260,7606,14866
KALIMANTAN SELATAN,BARITO KUALA,ANJIR PASAR,4752,3874,8626
KALIMANTAN SELATAN,TAPIN,BAKARANGAN,2476,1982,4458
KALIMANTAN SELATAN,HULU SUNGAI TENGAH,BATANG ALAI TIMUR,1434,1765,3199
KALIMANTAN SELATAN,HULU SUNGAI TENGAH,HARUYAN,6318,4763,11081
KALIMANTAN SELATAN,HULU SUNGAI TENGAH,BATANG ALAI SELATAN,8100,4989,13089
KALIMANTAN SELATAN,TAPIN,CANDI LARAS UTARA,3611,4377,7988
KALIMANTAN SELATAN,TAPIN,CANDI LARAS SELATAN,3196,2799,5995
KALIMANTAN SELATAN,TAPIN,TAPIN TENGAH,5711,4398,10109
KALIMANTAN SELATAN,HULU SUNGAI SELATAN,TELAGA LANGSAT,0,0,0
KALIMANTAN SELATAN,TAPIN,SALAM BABARIS,4325,2370,6695
KALIMANTAN SELATAN,HULU SUNGAI SELATAN,ANGKINANG,5313,4034,9347
KALIMANTAN SELATAN,HULU SUNGAI SELATAN,SUNGAI RAYA,4945,3888,8833
KALIMANTAN SELATAN,HULU SUNGAI SELATAN,SIMPUR,4801,2714,7515
KALIMANTAN SELATAN,HULU SUNGAI TENGAH,BATU BENAWA,6293,4516,10809
KALIMANTAN SELATAN,HULU SUNGAI SELATAN,PADANG BATUNG,5604,5159,10763
KALIMANTAN SELATAN,HULU SUNGAI SELATAN,KANDANGAN,13147,9689,22836
KALIMANTAN SELATAN,HULU SUNGAI SELATAN,DAHA BARAT,917,2314,3231
KALIMANTAN SELATAN,HULU SUNGAI UTARA,SUNGAI PANDAN,7707,5087,12794
KALIMANTAN SELATAN,HULU SUNGAI TENGAH,LIMPASU,3305,2570,5875
KALIMANTAN SELATAN,HULU SUNGAI UTARA,DANAU PANGGANG,4883,3812,8695
KALIMANTAN SELATAN,HULU SUNGAI TENGAH,HANTAKAN,2496,3484,5980
KALIMANTAN SELATAN,HULU SUNGAI UTARA,BANJANG,4627,3585,8212
KALIMANTAN SELATAN,HULU SUNGAI TENGAH,BATANG ALAI UTARA,5279,4033,9312
KALIMANTAN SELATAN,HULU SUNGAI TENGAH,LABUAN AMAS UTARA,7728,5283,13011
KALIMANTAN SELATAN,HULU SUNGAI UTARA,AMUNTAI UTARA,6442,3757,10199
KALIMANTAN SELATAN,HULU SUNGAI UTARA,BABIRIK,4556,3736,8292
KALIMANTAN SELATAN,HULU SUNGAI TENGAH,BARABAI,18714,9099,27813
KALIMANTAN SELATAN,HULU SUNGAI TENGAH,LABUAN AMAS SELATAN,8580,5780,14360
KALIMANTAN SELATAN,TABALONG,MUARA HARUS,1756,1352,3108
KALIMANTAN SELATAN,TABALONG,MUARA UYA,5430,6476,11906
KALIMANTAN SELATAN,HULU SUNGAI TENGAH,PANDAWAN,11537,5725,17262
KALIMANTAN SELATAN,HULU SUNGAI UTARA,PAMINGGIR,1837,1549,3386
KALIMANTAN SELATAN,HULU SUNGAI UTARA,HAUR GADING,4157,3434,7591
KALIMANTAN SELATAN,TABALONG,PUGAAN,2637,1011,3648
KALIMANTAN SELATAN,HULU SUNGAI UTARA,AMUNTAI SELATAN,7944,5079,13023
KALIMANTAN SELATAN,TABALONG,UPAU,1544,2309,3853
KALIMANTAN SELATAN,TABALONG,TANTA,5384,4440,9824
KALIMANTAN SELATAN,HULU SUNGAI UTARA,AMUNTAI TENGAH,14729,9945,24674
KALIMANTAN SELATAN,TABALONG,JARO,3190,3559,6749
KALIMANTAN SELATAN,TABALONG,BANUA LAWAS,5834,3174,9008
KALIMANTAN SELATAN,TANAH BUMBU,ANGSANA,0,0,0
KALIMANTAN SELATAN,TABALONG,TANJUNG,11263,6945,18208
KALIMANTAN SELATAN,TANAH BUMBU,KURANJI,0,0,0
KALIMANTAN SELATAN,TABALONG,HARUAI,7152,4678,11830
KALIMANTAN SELATAN,TABALONG,KELUA,8062,3468,11530
KALIMANTAN SELATAN,TABALONG,MURUNG PUDAK,14184,10608,24792
KALIMANTAN SELATAN,HULU SUNGAI UTARA,SUNGAI TABUKAN,3296,3084,6380
KALIMANTAN SELATAN,TANAH BUMBU,SIMPANG EMPAT,0,0,0
KALIMANTAN SELATAN,TABALONG,BINTANG ARA,2405,2383,4788
KALIMANTAN SELATAN,TANAH BUMBU,KUSAN HULU,0,0,0
KALIMANTAN SELATAN,TANAH BUMBU,SATUI,0,0,0
KALIMANTAN SELATAN,TANAH BUMBU,MANTEWE,0,0,0
KALIMANTAN SELATAN,BALANGAN,JUAI,4012,4586,8598
KALIMANTAN SELATAN,TANAH BUMBU,KARANG BINTANG,0,0,0
KALIMANTAN SELATAN,BALANGAN,BATU MANDI,4709,4684,9393
KALIMANTAN SELATAN,KOTA BANJARMASIN,BANJARMASIN SELATAN,33609,38367,71976
KALIMANTAN SELATAN,BALANGAN,HALONG,3664,5516,9180
KALIMANTAN SELATAN,TANAH BUMBU,BATU LICIN,0,0,0
KALIMANTAN SELATAN,KOTA BANJARBARU,CEMPAKA,0,0,0
KALIMANTAN SELATAN,KOTA BANJARMASIN,BANJARMASIN BARAT,33862,35323,69185
KALIMANTAN SELATAN,KOTA BANJARMASIN,BANJARMASIN TIMUR,27192,28785,55977
KALIMANTAN SELATAN,BALANGAN,LAMPIHONG,4063,4784,8847
KALIMANTAN SELATAN,TANAH BUMBU,SUNGAI LOBAN,0,0,0
KALIMANTAN SELATAN,BALANGAN,AWAYAN,3408,3740,7148
KALIMANTAN SELATAN,KOTA BANJARBARU,BANJARBARU SELATAN,0,0,0
KALIMANTAN SELATAN,TANAH BUMBU,KUSAN HILIR,0,0,0
KALIMANTAN SELATAN,KOTA BANJARMASIN,BANJARMASIN UTARA,36898,30095,66993
KALIMANTAN SELATAN,BALANGAN,TEBING TINGGI,790,2515,3305
KALIMANTAN SELATAN,KOTA BANJARMASIN,BANJARMASIN TENGAH,22261,24492,46753
KALIMANTAN SELATAN,KOTA BANJARBARU,BANJARBARU UTARA,0,0,0
KALIMANTAN SELATAN,KOTA BANJARBARU,LANDASAN ULIN,0,0,0
KALIMANTAN SELATAN,BALANGAN,PARINGIN SELATAN,3761,2963,6724
KALIMANTAN SELATAN,BALANGAN,PARINGIN,4899,4127,9026
KALIMANTAN TIMUR,KUTAI KARTANEGARA,MARANG KAYU,4917,8010,12927
KALIMANTAN TIMUR,PASER,BATU SOPANG,3634,5421,9055
KALIMANTAN TIMUR,PASER,BATU ENGAU,2344,4277,6621
KALIMANTAN TIMUR,PASER,MUARA SAMU,1072,1764,2836
KALIMANTAN TIMUR,PASER,TANAH GROGOT,15253,14730,29983
KALIMANTAN TIMUR,PASER,PASIR BALENGKONG,5944,6821,12765
KALIMANTAN TIMUR,KUTAI KARTANEGARA,MUARA MUNTAI,2260,5523,7783
KALIMANTAN TIMUR,PASER,LONG KALI,4104,8227,12331
KALIMANTAN TIMUR,PASER,LONG IKIS,8516,11540,20056
KALIMANTAN TIMUR,PASER,KUARO,6188,7001,13189
KALIMANTAN TIMUR,KUTAI KARTANEGARA,MUARA JAWA,8006,9043,17049
KALIMANTAN SELATAN,KOTA BANJARBARU,LIANG ANGGANG,0,0,0
KALIMANTAN TIMUR,KUTAI KARTANEGARA,SEBULU,4766,13279,18045
KALIMANTAN TIMUR,PASER,MUARA KOMAM,2245,3534,5779
KALIMANTAN TIMUR,KUTAI KARTANEGARA,SAMBOJA,10818,18001,28819
KALIMANTAN TIMUR,KUTAI KARTANEGARA,LOA KULU,8361,13980,22341
KALIMANTAN TIMUR,PASER,TANJUNG HARAPAN,1082,2123,3205
KALIMANTAN TIMUR,KUTAI KARTANEGARA,KOTA BANGUN,5243,11149,16392
KALIMANTAN TIMUR,KUTAI KARTANEGARA,TENGGARONG SEBERANG,12390,20798,33188
KALIMANTAN TIMUR,KUTAI KARTANEGARA,MUARA KAMAN,3958,13989,17947
KALIMANTAN TIMUR,KUTAI KARTANEGARA,KEMBANG JANGGUT,2608,7074,9682
KALIMANTAN TIMUR,KUTAI KARTANEGARA,MUARA BADAK,6634,14631,21265
KALIMANTAN TIMUR,BERAU,BATU PUTIH,0,0,0
KALIMANTAN TIMUR,BERAU,MARATUA,0,0,0
KALIMANTAN TIMUR,KUTAI KARTANEGARA,SANGA SANGA,3581,5117,8698
KALIMANTAN TIMUR,KUTAI KARTANEGARA,TABANG,1037,3669,4706
KALIMANTAN TIMUR,KUTAI KARTANEGARA,KENOHAN,1359,3717,5076
KALIMANTAN TIMUR,BERAU,TANJUNG REDEB,0,0,0
KALIMANTAN TIMUR,KUTAI KARTANEGARA,LOA JANAN,10127,20410,30537
KALIMANTAN TIMUR,BERAU,SEGAH,0,0,0
KALIMANTAN TIMUR,BULUNGAN,SEKATAK,549,3510,4059
KALIMANTAN TIMUR,KUTAI KARTANEGARA,TENGGARONG,23894,26298,50192
KALIMANTAN TIMUR,BERAU,TELUK BAYUR,0,0,0
KALIMANTAN TIMUR,BERAU,BIATAN,0,0,0
KALIMANTAN TIMUR,BERAU,TABALAR,0,0,0
KALIMANTAN TIMUR,KUTAI KARTANEGARA,MUARA WIS,1399,2930,4329
KALIMANTAN TIMUR,KUTAI KARTANEGARA,ANGGANA,6453,9885,16338
KALIMANTAN TIMUR,BULUNGAN,TANJUNG PALAS TIMUR,956,3996,4952
KALIMANTAN TIMUR,BULUNGAN,PESO,557,1486,2043
KALIMANTAN TIMUR,BERAU,KELAY,0,0,0
KALIMANTAN TIMUR,BERAU,SAMBALIUNG,0,0,0
KALIMANTAN TIMUR,BERAU,TALISAYAN,0,0,0
KALIMANTAN TIMUR,BULUNGAN,TANJUNG PALAS,2952,3393,6345
KALIMANTAN TIMUR,NUNUKAN,SEBATIK,0,0,0
KALIMANTAN TIMUR,NUNUKAN,SEBATIK TENGAH,0,0,0
KALIMANTAN TIMUR,BULUNGAN,TANJUNG SELOR,6831,11518,18349
KALIMANTAN TIMUR,BERAU,GUNUNG TABUR,0,0,0
KALIMANTAN TIMUR,NUNUKAN,SEBATIK BARAT,0,0,0
KALIMANTAN TIMUR,NUNUKAN,NUNUKAN SELATAN,0,0,0
KALIMANTAN TIMUR,BERAU,PULAU DERAWAN,0,0,0
KALIMANTAN TIMUR,BULUNGAN,TANJUNG PALAS TENGAH,1199,2318,3517
KALIMANTAN TIMUR,BULUNGAN,PESO ILIR,399,1219,1618
KALIMANTAN TIMUR,BULUNGAN,TANJUNG PALAS UTARA,1943,3129,5072
KALIMANTAN TIMUR,NUNUKAN,SEBATIK TIMUR,0,0,0
KALIMANTAN TIMUR,BULUNGAN,TANJUNG PALAS BARAT,658,1963,2621
KALIMANTAN TIMUR,MALINAU,MALINAU SELATAN HULU,197,883,1080
KALIMANTAN TIMUR,NUNUKAN,SEI MENGGARIS,0,0,0
KALIMANTAN TIMUR,NUNUKAN,NUNUKAN,0,0,0
KALIMANTAN TIMUR,BULUNGAN,BUNYU,1840,3878,5718
KALIMANTAN TIMUR,MALINAU,BAHAU HULU,74,743,817
KALIMANTAN TIMUR,NUNUKAN,TULIN ONSOI,0,0,0
KALIMANTAN TIMUR,NUNUKAN,SEBUKU,0,0,0
KALIMANTAN TIMUR,NUNUKAN,SEBATIK UTARA,0,0,0
KALIMANTAN TIMUR,MALINAU,SUNGAI BOH,183,1140,1323
KALIMANTAN TIMUR,NUNUKAN,LUMBIS,0,0,0
KALIMANTAN TIMUR,NUNUKAN,KRAYAN,0,0,0
KALIMANTAN TIMUR,MALINAU,MALINAU SELATAN HILIR,224,1093,1317
KALIMANTAN TIMUR,NUNUKAN,SEMBAKUNG,0,0,0
KALIMANTAN TIMUR,NUNUKAN,KRAYAN SELATAN,0,0,0
KALIMANTAN TIMUR,NUNUKAN,LUMBIS OGONG,0,0,0
KALIMANTAN TIMUR,MALINAU,KAYAN SELATAN,196,1044,1240
KALIMANTAN TIMUR,KUTAI BARAT,LONG APARI,1436,867,2303
KALIMANTAN TIMUR,KUTAI BARAT,LINGGANG BIGUNG,924,7210,8134
KALIMANTAN TIMUR,MALINAU,MENTARANG,594,2021,2615
KALIMANTAN TIMUR,MALINAU,MENTARANG HULU,137,322,459
KALIMANTAN TIMUR,MALINAU,KAYAN HILIR,291,651,942
KALIMANTAN TIMUR,KUTAI BARAT,SILUQ NGURAI,515,3043,3558
KALIMANTAN TIMUR,MALINAU,PUJUNGAN,242,624,866
KALIMANTAN TIMUR,KUTAI BARAT,BONGAN,1004,4141,5145
KALIMANTAN TIMUR,MALINAU,MALINAU UTARA,1233,3676,4909
KALIMANTAN TIMUR,MALINAU,KAYAN HULU,537,1635,2172
KALIMANTAN TIMUR,MALINAU,MALINAU KOTA,2510,6540,9050
KALIMANTAN TIMUR,KUTAI BARAT,NYUATAN,417,3303,3720
KALIMANTAN TIMUR,KUTAI BARAT,SEKOLAQ DARAT,658,5253,5911
KALIMANTAN TIMUR,KUTAI BARAT,BENTIAN BESAR,175,1640,1815
KALIMANTAN TIMUR,MALINAU,SUNGAI TUBU,53,378,431
KALIMANTAN TIMUR,MALINAU,MALINAU SELATAN,513,2710,3223
KALIMANTAN TIMUR,KUTAI BARAT,PENYINGGAHAN,497,1147,1644
KALIMANTAN TIMUR,MALINAU,MALINAU BARAT,982,3293,4275
KALIMANTAN TIMUR,KUTAI BARAT,LAHAM,185,1021,1206
KALIMANTAN TIMUR,KUTAI BARAT,JEMPANG,1146,4916,6062
KALIMANTAN TIMUR,KUTAI BARAT,MUARA PAHU,1084,3020,4104
KALIMANTAN TIMUR,KUTAI BARAT,MELAK,2271,4324,6595
KALIMANTAN TIMUR,KUTAI BARAT,BARONG TONGKOK,2441,11156,13597
KALIMANTAN TIMUR,KUTAI BARAT,LONG PAHANGAI,1047,1438,2485
KALIMANTAN TIMUR,KUTAI BARAT,TERING,1183,4016,5199
KALIMANTAN TIMUR,KUTAI TIMUR,KARANGAN,1048,3023,4071
KALIMANTAN TIMUR,KUTAI BARAT,MOOK MANAAR BULATN,741,3798,4539
KALIMANTAN TIMUR,KUTAI BARAT,LONG IRAM,947,2687,3634
KALIMANTAN TIMUR,KUTAI BARAT,LONG BAGUN,1507,2183,3690
KALIMANTAN TIMUR,KUTAI TIMUR,KAUBUN,0,0,0
KALIMANTAN TIMUR,KUTAI TIMUR,BATU AMPAR,590,2059,2649
KALIMANTAN TIMUR,KUTAI TIMUR,RANTAU PULUNG,1156,2853,4009
KALIMANTAN TIMUR,KUTAI TIMUR,MUARA ANCALONG,0,0,0
KALIMANTAN TIMUR,KUTAI TIMUR,TELUK PANDAN,1256,4318,5574
KALIMANTAN TIMUR,KUTAI BARAT,MUARA LAWA,714,3098,3812
KALIMANTAN TIMUR,KUTAI TIMUR,KOMBENG,1868,6182,8050
KALIMANTAN TIMUR,KUTAI BARAT,LONG HUBUNG,1346,2712,4058
KALIMANTAN TIMUR,KUTAI TIMUR,SANGKULIRANG,0,0,0
KALIMANTAN TIMUR,KUTAI TIMUR,BUSANG,0,0,0
KALIMANTAN TIMUR,KUTAI TIMUR,BENGALON,4468,10412,14880
KALIMANTAN TIMUR,KUTAI TIMUR,SANGATTA SELATAN,0,0,0
KALIMANTAN TIMUR,KUTAI BARAT,DAMAI,923,4652,5575
KALIMANTAN TIMUR,KUTAI TIMUR,KALIORANG,0,0,0
KALIMANTAN TIMUR,KUTAI TIMUR,SANDARAN,0,0,0
KALIMANTAN TIMUR,KUTAI TIMUR,TELEN,1259,3747,5006
KALIMANTAN TIMUR,KUTAI TIMUR,SANGATTA UTARA,18238,25507,43745
KALIMANTAN TIMUR,PENAJAM PASER UTARA,SEPAKU,0,0,0
KALIMANTAN TIMUR,TANA TIDUNG,SESAYAP HILIR,0,0,0
KALIMANTAN TIMUR,KUTAI TIMUR,MUARA WAHAU,0,0,0
KALIMANTAN TIMUR,KOTA BALIKPAPAN,BALIKPAPAN TIMUR,13322,19054,32376
KALIMANTAN TIMUR,TANA TIDUNG,SESAYAP,0,0,0
KALIMANTAN TIMUR,KOTA SAMARINDA,PALARAN,10153,16772,26925
KALIMANTAN TIMUR,KUTAI TIMUR,LONG MESANGAT,0,0,0
KALIMANTAN TIMUR,KUTAI TIMUR,MUARA BENGKAL,0,0,0
KALIMANTAN TIMUR,TANA TIDUNG,BETAYAU,0,0,0
KALIMANTAN TIMUR,PENAJAM PASER UTARA,PENAJAM,14285,18947,33232
KALIMANTAN TIMUR,KOTA BALIKPAPAN,BALIKPAPAN SELATAN,24352,34000,58352
KALIMANTAN TIMUR,TANA TIDUNG,TANA LIA,0,0,0
KALIMANTAN TIMUR,KOTA SAMARINDA,SAMARINDA UTARA,18311,27368,45679
KALIMANTAN TIMUR,KOTA SAMARINDA,SAMARINDA ILIR,14711,20159,34870
KALIMANTAN TIMUR,PENAJAM PASER UTARA,BABULU,6886,8711,15597
KALIMANTAN TIMUR,KOTA TARAKAN,TARAKAN BARAT,0,0,0
KALIMANTAN TIMUR,KOTA BALIKPAPAN,BALIKPAPAN TENGAH,20727,33164,53891
KALIMANTAN TIMUR,PENAJAM PASER UTARA,WARU,3107,5074,8181
KALIMANTAN TIMUR,KOTA SAMARINDA,LOA JANAN ILIR,10831,15602,26433
KALIMANTAN TIMUR,KOTA BALIKPAPAN,BALIKPAPAN UTARA,27254,39487,66741
KALIMANTAN TIMUR,KOTA SAMARINDA,SAMBUTAN,10158,12544,22702
KALIMANTAN TIMUR,KOTA SAMARINDA,SUNGAI PINANG,18281,30327,48608
KALIMANTAN TIMUR,KOTA BALIKPAPAN,BALIKPAPAN BARAT,19297,25656,44953
KALIMANTAN TIMUR,KOTA SAMARINDA,SAMARINDA ULU,29889,35084,64973
KALIMANTAN TIMUR,KOTA BONTANG,BONTANG BARAT,5605,8615,14220
KALIMANTAN TIMUR,KOTA SAMARINDA,SAMARINDA KOTA,6906,11141,18047
KALIMANTAN TIMUR,KOTA BALIKPAPAN,BALIKPAPAN KOTA,18121,25741,43862
SULAWESI UTARA,BOLAANG MONGONDOW,PASSI TIMUR,3640,2829,6469
SULAWESI UTARA,BOLAANG MONGONDOW,BOLAANG TIMUR,4188,1535,5723
KALIMANTAN TIMUR,KOTA SAMARINDA,SAMARINDA SEBERANG,11054,15859,26913
SULAWESI UTARA,BOLAANG MONGONDOW,SANG TOMBOLANG,3113,2170,5283
KALIMANTAN TIMUR,KOTA SAMARINDA,SUNGAI KUNJANG,25022,31464,56486
SULAWESI UTARA,BOLAANG MONGONDOW,POIGAR,5678,4073,9751
SULAWESI UTARA,BOLAANG MONGONDOW,DUMOGA,3961,3455,7416
SULAWESI UTARA,BOLAANG MONGONDOW,BOLAANG,6054,2695,8749
KALIMANTAN TIMUR,KOTA TARAKAN,TARAKAN TENGAH,0,0,0
SULAWESI UTARA,BOLAANG MONGONDOW,BILALANG,2263,531,2794
KALIMANTAN TIMUR,KOTA BONTANG,BONTANG UTARA,14615,21761,36376
SULAWESI UTARA,BOLAANG MONGONDOW,LOLAK,7309,6815,14124
KALIMANTAN TIMUR,KOTA TARAKAN,TARAKAN TIMUR,0,0,0
KALIMANTAN TIMUR,KOTA TARAKAN,TARAKAN UTARA,0,0,0
SULAWESI UTARA,BOLAANG MONGONDOW,DUMOGA TENGAH,3068,2680,5748
SULAWESI UTARA,BOLAANG MONGONDOW,DUMOGA UTARA,4491,3112,7603
SULAWESI UTARA,MINAHASA,TOMBARIRI,5013,5281,10294
SULAWESI UTARA,BOLAANG MONGONDOW,PASSI BARAT,6907,1547,8454
SULAWESI UTARA,BOLAANG MONGONDOW,LOLAYAN,8916,3691,12607
SULAWESI UTARA,BOLAANG MONGONDOW,DUMOGA BARAT,5346,2746,8092
KALIMANTAN TIMUR,KOTA BONTANG,BONTANG SELATAN,10537,21736,32273
SULAWESI UTARA,BOLAANG MONGONDOW,DUMOGA TIMUR,5470,5135,10605
SULAWESI UTARA,MINAHASA,TONDANO SELATAN,4410,5863,10273
SULAWESI UTARA,MINAHASA,TOMBULU,3466,6265,9731
SULAWESI UTARA,MINAHASA,TONDANO TIMUR,3905,4837,8742
SULAWESI UTARA,MINAHASA,TONDANO UTARA,3608,3168,6776
SULAWESI UTARA,MINAHASA,MANDOLANG,4809,6399,11208
SULAWESI UTARA,MINAHASA,TOMBARIRI TIMUR,2649,3012,5661
SULAWESI UTARA,MINAHASA,LANGOWAN SELATAN,2492,2614,5106
SULAWESI UTARA,MINAHASA,KAWANGKOAN UTARA,1769,3780,5549
SULAWESI UTARA,MINAHASA,ERIS,2804,3664,6468
SULAWESI UTARA,MINAHASA,KAKAS BARAT,2291,3708,5999
SULAWESI UTARA,MINAHASA,TONDANO BARAT,5290,5546,10836
SULAWESI UTARA,MINAHASA,LANGOWAN BARAT,4557,5724,10281
SULAWESI UTARA,BOLAANG MONGONDOW,DUMOGA TENGGARA,2872,1356,4228
SULAWESI UTARA,MINAHASA,TOMPASO,1501,3459,4960
SULAWESI UTARA,MINAHASA,KAWANGKOAN BARAT,2303,3453,5756
SULAWESI UTARA,KEPULAUAN SANGIHE,TAHUNA TIMUR,3401,3754,7155
SULAWESI UTARA,MINAHASA,LANGOWAN UTARA,2214,3310,5524
SULAWESI UTARA,MINAHASA,KAWANGKOAN,2307,4212,6519
SULAWESI UTARA,MINAHASA,SONDER,4325,7545,11870
SULAWESI UTARA,MINAHASA,PINELENG,7784,8964,16748
SULAWESI UTARA,KEPULAUAN SANGIHE,TABUKAN SELATAN,1177,2319,3496
SULAWESI UTARA,MINAHASA,KOMBI,2854,4066,6920
SULAWESI UTARA,KEPULAUAN SANGIHE,KENDAHE,2113,1868,3981
SULAWESI UTARA,MINAHASA,REMBOKEN,2764,4355,7119
SULAWESI UTARA,KEPULAUAN SANGIHE,TABUKAN SELATAN TENGGARA,188,1131,1319
SULAWESI UTARA,KEPULAUAN SANGIHE,TAHUNA BARAT,1011,2532,3543
SULAWESI UTARA,MINAHASA,LEMBEAN TIMUR,2283,2891,5174
SULAWESI UTARA,MINAHASA,TOMPASO BARAT,2511,3020,5531
SULAWESI UTARA,MINAHASA,KAKAS,3378,4131,7509
SULAWESI UTARA,KEPULAUAN SANGIHE,TATOARENG,941,1454,2395
SULAWESI UTARA,KEPULAUAN SANGIHE,KEPULAUAN MARORE,307,423,730
SULAWESI UTARA,KEPULAUAN TALAUD,BEO SELATAN,383,1807,2190
SULAWESI UTARA,KEPULAUAN SANGIHE,TABUKAN SELATAN TENGAH,389,1182,1571
SULAWESI UTARA,KEPULAUAN TALAUD,PULUTAN,230,1158,1388
SULAWESI UTARA,KEPULAUAN TALAUD,MIANGAS,346,131,477
SULAWESI UTARA,MINAHASA,LANGOWAN TIMUR,4131,3882,8013
SULAWESI UTARA,KEPULAUAN SANGIHE,MANGANITU SELATAN,1603,4340,5943
SULAWESI UTARA,KEPULAUAN TALAUD,LIRUNG,1118,2571,3689
SULAWESI UTARA,KEPULAUAN TALAUD,MORONGE,372,2030,2402
SULAWESI UTARA,KEPULAUAN SANGIHE,NUSA TABUKAN,1252,526,1778
SULAWESI UTARA,KEPULAUAN SANGIHE,TABUKAN UTARA,6068,5400,11468
SULAWESI UTARA,KEPULAUAN SANGIHE,TAHUNA,3446,5335,8781
SULAWESI UTARA,KEPULAUAN TALAUD,GEMEH,651,2480,3131
SULAWESI UTARA,KEPULAUAN SANGIHE,MANGANITU,1989,6634,8623
SULAWESI UTARA,KEPULAUAN TALAUD,SALIBABU,490,3054,3544
SULAWESI UTARA,KEPULAUAN TALAUD,KALONGAN,475,1498,1973
SULAWESI UTARA,KEPULAUAN SANGIHE,TABUKAN TENGAH,1961,4347,6308
SULAWESI UTARA,KEPULAUAN TALAUD,ESSANG SELATAN,412,1505,1917
SULAWESI UTARA,KEPULAUAN TALAUD,ESSANG,677,1274,1951
SULAWESI UTARA,KEPULAUAN TALAUD,DAMAU,684,2089,2773
SULAWESI UTARA,KEPULAUAN TALAUD,BEO UTARA,406,1911,2317
SULAWESI UTARA,KEPULAUAN SANGIHE,TAMAKO,2372,5660,8032
SULAWESI UTARA,MINAHASA SELATAN,TARERAN,3388,4581,7969
SULAWESI UTARA,KEPULAUAN TALAUD,KABARUAN,1036,2326,3362
SULAWESI UTARA,MINAHASA SELATAN,MODOINDING,2776,4283,7059
SULAWESI UTARA,KEPULAUAN TALAUD,MELONGUANE TIMUR,220,1721,1941
SULAWESI UTARA,KEPULAUAN TALAUD,MELONGUANE,1202,4950,6152
SULAWESI UTARA,MINAHASA SELATAN,MAESAAN,2394,3572,5966
SULAWESI UTARA,MINAHASA SELATAN,AMURANG,4344,4914,9258
SULAWESI UTARA,MINAHASA SELATAN,RANOYAPO,3011,4201,7212
SULAWESI UTARA,MINAHASA SELATAN,TUMPAAN,4318,5141,9459
SULAWESI UTARA,MINAHASA SELATAN,TATAPAAN,2598,3157,5755
SULAWESI UTARA,KEPULAUAN TALAUD,BEO,911,2199,3110
SULAWESI UTARA,MINAHASA SELATAN,MOTOLING TIMUR,1469,4055,5524
SULAWESI UTARA,KEPULAUAN TALAUD,RAINIS,912,2564,3476
SULAWESI UTARA,KEPULAUAN TALAUD,NANUSA,461,1759,2220
SULAWESI UTARA,MINAHASA SELATAN,MOTOLING BARAT,1890,2978,4868
SULAWESI UTARA,MINAHASA SELATAN,AMURANG BARAT,3898,5413,9311
SULAWESI UTARA,MINAHASA SELATAN,SULUUN TARERAN,2407,2442,4849
SULAWESI UTARA,MINAHASA UTARA,TALAWAAN,5732,5356,11088
SULAWESI UTARA,MINAHASA SELATAN,AMURANG TIMUR,3774,3937,7711
SULAWESI UTARA,MINAHASA SELATAN,SINONSAYANG,4754,4450,9204
SULAWESI UTARA,MINAHASA UTARA,AIRMADIDI,7598,7397,14995
SULAWESI UTARA,MINAHASA SELATAN,KUMELEMBUAI,1645,2712,4357
SULAWESI UTARA,MINAHASA SELATAN,TENGA,5314,5611,10925
SULAWESI UTARA,MINAHASA SELATAN,TOMPASO BARU,3422,3503,6925
SULAWESI UTARA,MINAHASA UTARA,LIKUPANG TIMUR,4026,7160,11186
SULAWESI UTARA,MINAHASA UTARA,DIMEMBE,8125,6157,14282
SULAWESI UTARA,MINAHASA TENGGARA,RATAHAN,3677,4341,8018
SULAWESI UTARA,MINAHASA UTARA,KAUDITAN,7207,7276,14483
SULAWESI UTARA,MINAHASA TENGGARA,TOMBATU UTARA,2404,2469,4873
SULAWESI UTARA,MINAHASA TENGGARA,PASAN,1834,2815,4649
SULAWESI UTARA,MINAHASA UTARA,KEMA,4541,3985,8526
SULAWESI UTARA,MINAHASA UTARA,LIKUPANG BARAT,4195,6208,10403
SULAWESI UTARA,MINAHASA SELATAN,MOTOLING,2204,2558,4762
SULAWESI UTARA,MINAHASA UTARA,LIKUPANG SELATAN,1975,1280,3255
SULAWESI UTARA,MINAHASA UTARA,KALAWAT,6755,9630,16385
SULAWESI UTARA,BOLAANG MONGONDOW UTARA,BOLANGITANG TIMUR,3927,2998,6925
SULAWESI UTARA,MINAHASA UTARA,WORI,5206,6171,11377
SULAWESI UTARA,BOLAANG MONGONDOW UTARA,PINOGALUMAN,3215,2675,5890
SULAWESI UTARA,MINAHASA TENGGARA,PUSOMAEN,3375,2007,5382
SULAWESI UTARA,BOLAANG MONGONDOW TIMUR,NUANGAN,5129,2603,7732
SULAWESI UTARA,MINAHASA TENGGARA,TOULUAAN,1914,1972,3886
SULAWESI UTARA,MINAHASA TENGGARA,TOMBATU,2757,2446,5203
SULAWESI UTARA,BOLAANG MONGONDOW TIMUR,MODAYAG BARAT,3671,1475,5146
SULAWESI UTARA,MINAHASA TENGGARA,RATAHAN TIMUR,2093,1957,4050
SULAWESI UTARA,BOLAANG MONGONDOW TIMUR,MODAYAG,6265,4451,10716
SULAWESI UTARA,MINAHASA TENGGARA,BELANG,5547,3529,9076
SULAWESI UTARA,BOLAANG MONGONDOW UTARA,SANGKUB,2426,2806,5232
SULAWESI UTARA,BOLAANG MONGONDOW TIMUR,KOTABUNAN,4148,2233,6381
SULAWESI UTARA,MINAHASA TENGGARA,TOMBATU TIMUR,2330,3434,5764
SULAWESI UTARA,BOLAANG MONGONDOW UTARA,BOLANGITANG BARAT,4352,3261,7613
SULAWESI UTARA,MINAHASA TENGGARA,SILIAN RAYA,1609,1737,3346
SULAWESI UTARA,BOLAANG MONGONDOW SELATAN,PINOLOSIAN TENGAH,1977,983,2960
SULAWESI UTARA,BOLAANG MONGONDOW UTARA,BINTAUNA,4309,3285,7594
SULAWESI UTARA,MINAHASA TENGGARA,RATATOTOK,3762,3725,7487
SULAWESI UTARA,MINAHASA TENGGARA,TOULUAAN SELATAN,1568,1005,2573
SULAWESI UTARA,KOTA MANADO,BUNAKEN KEPULAUAN,1232,2454,3686
SULAWESI UTARA,BOLAANG MONGONDOW SELATAN,POSIGADAN,5509,4442,9951
SULAWESI UTARA,BOLAANG MONGONDOW UTARA,KAIDIPANG,3943,2987,6930
SULAWESI UTARA,BOLAANG MONGONDOW TIMUR,TUTUYAN,3710,3102,6812
SULAWESI UTARA,KOTA MANADO,TIKALA,6045,9586,15631
SULAWESI UTARA,KOTA MANADO,WENANG,8481,10733,19214
SULAWESI UTARA,BOLAANG MONGONDOW SELATAN,BOLAANG UKI,7350,4511,11861
SULAWESI UTARA,KOTA BITUNG,LEMBEH SELATAN,1874,3465,5339
SULAWESI UTARA,BOLAANG MONGONDOW SELATAN,PINOLOSIAN TIMUR,1804,2110,3914
SULAWESI UTARA,BOLAANG MONGONDOW SELATAN,PINOLOSIAN,2984,2449,5433
SULAWESI UTARA,KOTA MANADO,PAAL DUA,8885,14326,23211
SULAWESI UTARA,KOTA BITUNG,MATUARI,6693,8791,15484
SULAWESI UTARA,KOTA MANADO,TUMINITING,11647,15979,27626
SULAWESI UTARA,KOTA MANADO,WANEA,13200,17937,31137
SULAWESI UTARA,KOTA TOMOHON,TOMOHON SELATAN,6415,7323,13738
SULAWESI UTARA,KOTA MANADO,BUNAKEN,4428,6979,11407
SULAWESI UTARA,KOTA BITUNG,MADIDIR,6453,10788,17241
SULAWESI UTARA,KOTA MANADO,SINGKIL,10854,14405,25259
SULAWESI UTARA,KOTA MANADO,MALALAYANG,13513,19726,33239
SULAWESI UTARA,KOTA BITUNG,MAESA,7912,10676,18588
SULAWESI UTARA,KOTA BITUNG,RANOWULU,3990,5826,9816
SULAWESI UTARA,KOTA TOMOHON,TOMOHON TENGAH,5233,6321,11554
SULAWESI UTARA,KOTA MANADO,SARIO,5209,6556,11765
SULAWESI UTARA,KOTA MANADO,MAPANGET,10914,15891,26805
SULAWESI UTARA,KOTA BITUNG,LEMBEH UTARA,1601,3613,5214
SULAWESI TENGAH,BANGGAI,BATUI,3211,5383,8594
SULAWESI UTARA,KOTA BITUNG,GIRIAN,7739,7894,15633
SULAWESI UTARA,KOTA KOTAMOBAGU,KOTAMOBAGU SELATAN,11344,3986,15330
SULAWESI TENGAH,BANGGAI,SIMPANG RAYA,2113,5189,7302
SULAWESI UTARA,KOTA KOTAMOBAGU,KOTAMOBAGU UTARA,6292,1642,7934
SULAWESI UTARA,KOTA KOTAMOBAGU,KOTAMOBAGU TIMUR,10392,4909,15301
SULAWESI UTARA,KOTA BITUNG,AERTEMBAGA,5372,9769,15141
SULAWESI TENGAH,BANGGAI,BALANTAK SELATAN,927,1666,2593
SULAWESI TENGAH,BANGGAI,TOILI BARAT,3782,8036,11818
SULAWESI TENGAH,BANGGAI,LUWUK TIMUR,2897,3074,5971
SULAWESI UTARA,KOTA KOTAMOBAGU,KOTAMOBAGU BARAT,12375,7822,20197
SULAWESI UTARA,KOTA TOMOHON,TOMOHON BARAT,4416,5000,9416
SULAWESI TENGAH,BANGGAI,BATUI SELATAN,2206,5029,7235
SULAWESI UTARA,KOTA TOMOHON,TOMOHON TIMUR,2929,3626,6555
SULAWESI TENGAH,BANGGAI,LUWUK UTARA,4198,4145,8343
SULAWESI TENGAH,BANGGAI,LOBU,831,1140,1971
SULAWESI UTARA,KOTA TOMOHON,TOMOHON UTARA,7144,9131,16275
SULAWESI TENGAH,BANGGAI,BUALEMO,4768,4657,9425
SULAWESI TENGAH,BANGGAI,BALANTAK UTARA,977,1198,2175
SULAWESI TENGAH,BANGGAI,LUWUK SELATAN,6049,4642,10691
SULAWESI TENGAH,BANGGAI,MANTOH,1062,2456,3518
SULAWESI TENGAH,POSO,LORE TIMUR,1027,1880,2907
SULAWESI TENGAH,BANGGAI,MOILONG,4040,5870,9910
SULAWESI TENGAH,POSO,PAMONA TENGGARA,1739,2196,3935
SULAWESI TENGAH,BANGGAI,BALANTAK,994,1976,2970
SULAWESI TENGAH,POSO,POSO KOTA,5639,4119,9758
SULAWESI TENGAH,BANGGAI,TOILI,6297,11298,17595
SULAWESI TENGAH,BANGGAI,NAMBO,2615,2102,4717
SULAWESI TENGAH,BANGGAI,LUWUK,8336,8283,16619
SULAWESI TENGAH,BANGGAI,KINTOM,2851,2988,5839
SULAWESI TENGAH,BANGGAI,MASAMA,2108,4426,6534
SULAWESI TENGAH,BANGGAI,NUHON,3357,5721,9078
SULAWESI TENGAH,POSO,LORE UTARA,2918,3114,6032
SULAWESI TENGAH,BANGGAI,BUNTA,3780,5760,9540
SULAWESI TENGAH,BANGGAI,LAMALA,1348,2169,3517
SULAWESI TENGAH,POSO,POSO PESISIR UTARA,3212,4812,8024
SULAWESI TENGAH,POSO,LORE PIORE,1005,991,1996
SULAWESI TENGAH,POSO,LAGE,4840,5829,10669
SULAWESI TENGAH,BANGGAI,PAGIMANA,6135,6068,12203
SULAWESI TENGAH,POSO,POSO KOTA UTARA,3460,2365,5825
SULAWESI TENGAH,POSO,POSO KOTA SELATAN,2442,2337,4779
SULAWESI TENGAH,POSO,POSO PESISIR,4934,4908,9842
SULAWESI TENGAH,POSO,POSO PESISIR SELATAN,2954,2473,5427
SULAWESI TENGAH,POSO,LORE BARAT,861,914,1775
SULAWESI TENGAH,POSO,PAMONA UTARA,2309,5575,7884
SULAWESI TENGAH,POSO,PAMONA BARAT,1656,3432,5088
SULAWESI TENGAH,POSO,PAMONA PUSELEMBA,3703,7022,10725
SULAWESI TENGAH,POSO,PAMONA TIMUR,2504,3762,6266
SULAWESI TENGAH,POSO,LORE TENGAH,1442,1001,2443
SULAWESI TENGAH,DONGGALA,RIO PAKAVA,3096,6738,9834
SULAWESI TENGAH,DONGGALA,SIRENJA,3594,6270,9864
SULAWESI TENGAH,DONGGALA,SINDUE TOBATA,1468,2834,4302
SULAWESI TENGAH,POSO,LORE SELATAN,1903,1630,3533
SULAWESI TENGAH,DONGGALA,SOJOL UTARA,892,3644,4536
SULAWESI TENGAH,DONGGALA,SOJOL,2447,8855,11302
SULAWESI TENGAH,DONGGALA,BALAESANG,4402,6222,10624
SULAWESI TENGAH,DONGGALA,BANAWA TENGAH,3514,1943,5457
SULAWESI TENGAH,POSO,PAMONA SELATAN,4603,5603,10206
SULAWESI TENGAH,TOLITOLI,LAMPASIO,1585,4508,6093
SULAWESI TENGAH,TOLITOLI,DAMPAL SELATAN,1504,9285,10789
SULAWESI TENGAH,DONGGALA,BANAWA,8770,7968,16738
SULAWESI TENGAH,DONGGALA,PANEMBANI,1966,1644,3610
SULAWESI TENGAH,DONGGALA,BANAWA SELATAN,4895,6430,11325
SULAWESI TENGAH,DONGGALA,SINDUE TOMBUSABORA,2319,2904,5223
SULAWESI TENGAH,DONGGALA,BALAESANG TANJUNG,2057,3228,5285
SULAWESI TENGAH,TOLITOLI,DAKO PEMEAN,1933,2672,4605
SULAWESI TENGAH,DONGGALA,TANANTOVEA,4413,4116,8529
SULAWESI TENGAH,TOLITOLI,DONDO,3103,7446,10549
SULAWESI TENGAH,DONGGALA,DOMPELAS SOJOL,5332,9500,14832
SULAWESI TENGAH,TOLITOLI,DAMPAL UTARA,2217,3988,6205
SULAWESI TENGAH,DONGGALA,LABUAN,3625,3340,6965
SULAWESI TENGAH,DONGGALA,SINDUE,6339,3985,10324
SULAWESI TENGAH,BUOL,BIAU,6794,6129,12923
SULAWESI TENGAH,BUOL,BUKAL,2734,4507,7241
SULAWESI TENGAH,MOROWALI,MORIS ATAS,0,0,0
SULAWESI TENGAH,BUOL,BOKAT,3384,3448,6832
SULAWESI TENGAH,TOLITOLI,GALANG,5591,10835,16426
SULAWESI TENGAH,BUOL,KARAMAT,2088,2366,4454
SULAWESI TENGAH,BUOL,BUNOBOGU,2210,2292,4502
SULAWESI TENGAH,TOLITOLI,BAOLAN,13482,16963,30445
SULAWESI TENGAH,MOROWALI,BUNGKU TIMUR,0,0,0
SULAWESI TENGAH,TOLITOLI,OGODEIDE,1859,4234,6093
SULAWESI TENGAH,MOROWALI,LEMBO RAYA,0,0,0
SULAWESI TENGAH,BUOL,PALELEH,3232,2863,6095
SULAWESI TENGAH,TOLITOLI,BASIDONDO,1293,3714,5007
SULAWESI TENGAH,BUOL,LAKEA,1987,2815,4802
SULAWESI TENGAH,MOROWALI,SOYO JAYA,0,0,0
SULAWESI TENGAH,BUOL,TILOAN,2198,2887,5085
SULAWESI TENGAH,MOROWALI,PETASIA TIMUR,0,0,0
SULAWESI TENGAH,MOROWALI,LEMBO,0,0,0
SULAWESI TENGAH,MOROWALI,MENUI KEPULAUAN,0,0,0
SULAWESI TENGAH,BUOL,MOMUNU,3509,3807,7316
SULAWESI TENGAH,MOROWALI,PETASIA,0,0,0
SULAWESI TENGAH,MOROWALI,BUNGKU PESISIR,0,0,0
SULAWESI TENGAH,BUOL,PALELEH BARAT,1414,1613,3027
SULAWESI TENGAH,BUOL,GADUNG,2652,2612,5264
SULAWESI TENGAH,MOROWALI,WITA PONDA,0,0,0
SULAWESI TENGAH,MOROWALI,MAMOSALATO,0,0,0
SULAWESI TENGAH,MOROWALI,BUNGKU TENGAH,0,0,0
SULAWESI TENGAH,BANGGAI KEPULAUAN,TOTIKUM SELATAN,0,0,0
SULAWESI TENGAH,MOROWALI,MORI UTARA,0,0,0
SULAWESI TENGAH,BANGGAI KEPULAUAN,BANGGAI TENGAH,0,0,0
SULAWESI TENGAH,MOROWALI,BAHODOPI,0,0,0
SULAWESI TENGAH,MOROWALI,BUNGKU SELATAN,0,0,0
SULAWESI TENGAH,BANGGAI KEPULAUAN,TINANGKUNG SELATAN,0,0,0
SULAWESI TENGAH,BANGGAI KEPULAUAN,PELING TENGAH,0,0,0
SULAWESI TENGAH,MOROWALI,BUMI RAYA,0,0,0
SULAWESI TENGAH,MOROWALI,BUNGKU BARAT,0,0,0
SULAWESI TENGAH,BANGGAI KEPULAUAN,BANGKURUNG,0,0,0
SULAWESI TENGAH,MOROWALI,BUNGKU UTARA,0,0,0
SULAWESI TENGAH,BANGGAI KEPULAUAN,TOTIKUM,0,0,0
SULAWESI TENGAH,BANGGAI KEPULAUAN,BULAGI,0,0,0
SULAWESI TENGAH,BANGGAI KEPULAUAN,BANGGAI,0,0,0
SULAWESI TENGAH,MOROWALI,PETASIA BARAT,0,0,0
SULAWESI TENGAH,BANGGAI KEPULAUAN,BUKO,0,0,0
SULAWESI TENGAH,BANGGAI KEPULAUAN,BANGGAI UTARA,0,0,0
SULAWESI TENGAH,BANGGAI KEPULAUAN,BANGGAI SELATAN,0,0,0
SULAWESI TENGAH,BANGGAI KEPULAUAN,BUKO SELATAN,0,0,0
SULAWESI TENGAH,BANGGAI KEPULAUAN,LABOBO,0,0,0
SULAWESI TENGAH,BANGGAI KEPULAUAN,BOKAN KEPULAUAN,0,0,0
SULAWESI TENGAH,BANGGAI KEPULAUAN,BULAGI UTARA,0,0,0
SULAWESI TENGAH,PARIGI MOUTONG,PARIGI,5326,8578,13904
SULAWESI TENGAH,PARIGI MOUTONG,MEPANGA,6782,7486,14268
SULAWESI TENGAH,BANGGAI KEPULAUAN,BULAGI SELATAN,0,0,0
SULAWESI TENGAH,PARIGI MOUTONG,BALINGGI,4046,5640,9686
SULAWESI TENGAH,PARIGI MOUTONG,BOLANO,4159,4182,8341
SULAWESI TENGAH,BANGGAI KEPULAUAN,LIANG,0,0,0
SULAWESI TENGAH,PARIGI MOUTONG,MOUTONG,4963,5606,10569
SULAWESI TENGAH,PARIGI MOUTONG,AMPIBABO,5360,5245,10605
SULAWESI TENGAH,PARIGI MOUTONG,PARIGI BARAT,1979,1950,3929
SULAWESI TENGAH,PARIGI MOUTONG,PARIGI UTARA,2071,1137,3208
SULAWESI TENGAH,PARIGI MOUTONG,PARIGI SELATAN,3900,7377,11277
SULAWESI TENGAH,PARIGI MOUTONG,TORIBULU,2986,5023,8009
SULAWESI TENGAH,PARIGI MOUTONG,SINIU,2721,2241,4962
SULAWESI TENGAH,PARIGI MOUTONG,PARIGI TENGAH,2295,2003,4298
SULAWESI TENGAH,PARIGI MOUTONG,KASIMBAR,4154,6826,10980
SULAWESI TENGAH,BANGGAI KEPULAUAN,TINANGKUNG UTARA,0,0,0
SULAWESI TENGAH,BANGGAI KEPULAUAN,TINANGKUNG,0,0,0
SULAWESI TENGAH,PARIGI MOUTONG,PALASA,4965,6917,11882
SULAWESI TENGAH,PARIGI MOUTONG,TOMINI,4855,3806,8661
SULAWESI TENGAH,PARIGI MOUTONG,SAUSU,4229,6868,11097
SULAWESI TENGAH,PARIGI MOUTONG,TORUE,3278,6913,10191
SULAWESI TENGAH,PARIGI MOUTONG,TINOMBO SELATAN,5464,6925,12389
SULAWESI TENGAH,PARIGI MOUTONG,TAOPA,3065,3621,6686
SULAWESI TENGAH,PARIGI MOUTONG,ONGKA MALINO,4692,5307,9999
SULAWESI TENGAH,SIGI,DOLO SELATAN,5592,1939,7531
SULAWESI TENGAH,PARIGI MOUTONG,TINOMBO,7819,8262,16081
SULAWESI TENGAH,SIGI,KULAWI SELATAN,1922,2758,4680
SULAWESI TENGAH,SIGI,DOLO,8345,3524,11869
SULAWESI TENGAH,SIGI,GUMBASA,3969,2836,6805
SULAWESI TENGAH,KOTA PALU,PALU TIMUR,12434,11883,24317
SULAWESI TENGAH,KOTA PALU,PALU BARAT,11274,13643,24917
SULAWESI TENGAH,PARIGI MOUTONG,BOLANO LAMBUNU,4409,6417,10826
SULAWESI TENGAH,SIGI,PALOLO,6774,8908,15682
SULAWESI TENGAH,SIGI,KINOVARO,4045,2029,6074
SULAWESI TENGAH,KOTA PALU,PALU SELATAN,16249,16945,33194
SULAWESI TENGAH,SIGI,MARAWOLA BARAT,1710,2688,4398
SULAWESI TENGAH,SIGI,TANAMBULAVA,2875,1710,4585
SULAWESI TENGAH,SIGI,DOLO BARAT,5141,2050,7191
SULAWESI TENGAH,SIGI,MARAWOLA,8318,3991,12309
SULAWESI TENGAH,SIGI,PIPIKORO,2480,2625,5105
SULAWESI TENGAH,KOTA PALU,PALU UTARA,5622,5009,10631
SULAWESI TENGAH,SIGI,SIGI BIROMARU,15899,8366,24265
SULAWESI SELATAN,KEPULAUAN SELAYAR,PASILAMBENA,1884,1536,3420
SULAWESI TENGAH,SIGI,LINDU,1171,1620,2791
SULAWESI TENGAH,SIGI,NOKILALAKI,1285,1535,2820
SULAWESI SELATAN,KEPULAUAN SELAYAR,PASIMASUNGGU TIMUR,1672,1854,3526
SULAWESI SELATAN,KEPULAUAN SELAYAR,PASIMASUNGGU,1962,1822,3784
SULAWESI TENGAH,KOTA PALU,TAWAELI,5714,5013,10727
SULAWESI SELATAN,BULUKUMBA,UJUNGLOE,5202,14366,19568
SULAWESI SELATAN,KEPULAUAN SELAYAR,TAKA BONERATE,3095,2617,5712
SULAWESI TENGAH,SIGI,KULAWI,4279,3984,8263
SULAWESI SELATAN,KEPULAUAN SELAYAR,BONTOMATENE,2857,4583,7440
SULAWESI SELATAN,KEPULAUAN SELAYAR,BONTOSIKUYU,2825,5228,8053
SULAWESI SELATAN,BULUKUMBA,GANTARANG,11986,24716,36702
SULAWESI TENGAH,KOTA PALU,MANTIKULORE,17397,14280,31677
SULAWESI SELATAN,KEPULAUAN SELAYAR,BENTENG,3631,6539,10170
SULAWESI SELATAN,KEPULAUAN SELAYAR,PASIMARANNU,2434,2195,4629
SULAWESI SELATAN,BULUKUMBA,UJUNG BULU,7224,15716,22940
SULAWESI TENGAH,KOTA PALU,ULUJADI,9504,5899,15403
SULAWESI TENGAH,KOTA PALU,TATANGA,12550,9089,21639
SULAWESI SELATAN,BANTAENG,BISSAPPU,6908,9192,16100
SULAWESI SELATAN,BULUKUMBA,BONTO TIRO,2837,9824,12661
SULAWESI SELATAN,KEPULAUAN SELAYAR,BONTOMANAI,2655,4820,7475
SULAWESI SELATAN,KEPULAUAN SELAYAR,BUKI,1647,2092,3739
SULAWESI SELATAN,BULUKUMBA,BULUKUMPA,6264,20696,26960
SULAWESI SELATAN,BANTAENG,SINOA,2876,3228,6104
SULAWESI SELATAN,KEPULAUAN SELAYAR,BONTOHARU,2678,4257,6935
SULAWESI SELATAN,BULUKUMBA,KINDANG,4160,10722,14882
SULAWESI SELATAN,BULUKUMBA,HERLANG,2889,9719,12608
SULAWESI SELATAN,BANTAENG,ULUERE,1946,3413,5359
SULAWESI SELATAN,JENEPONTO,BONTORAMBA,8075,8828,16903
SULAWESI SELATAN,BULUKUMBA,BONTO BAHARI,2094,9419,11513
SULAWESI SELATAN,BULUKUMBA,KAJANG,5785,16607,22392
SULAWESI SELATAN,JENEPONTO,BATANG,6721,2840,9561
SULAWESI SELATAN,BULUKUMBA,RILAUALE,4529,15787,20316
SULAWESI SELATAN,JENEPONTO,RUMBIA,4503,8295,12798
SULAWESI SELATAN,BANTAENG,GANTARANG KEKE,2392,5280,7672
SULAWESI SELATAN,JENEPONTO,BINAMU,14087,11962,26049
SULAWESI SELATAN,JENEPONTO,TAROWANG,6200,5059,11259
SULAWESI SELATAN,BANTAENG,BANTAENG,8860,9834,18694
SULAWESI SELATAN,JENEPONTO,TURATEA,7698,6708,14406
SULAWESI SELATAN,BANTAENG,EREMERASA,3516,4623,8139
SULAWESI SELATAN,BANTAENG,PAJUKUKANG,6618,6401,13019
SULAWESI SELATAN,TAKALAR,GALESONG SELATAN,4320,9026,13346
SULAWESI SELATAN,BANTAENG,TOMPO BULU,3287,7684,10971
SULAWESI SELATAN,JENEPONTO,BANGKALA,10648,16105,26753
SULAWESI SELATAN,JENEPONTO,ARUNGKEKE,6794,2857,9651
SULAWESI SELATAN,TAKALAR,MANGARABOMBANG,6477,12530,19007
SULAWESI SELATAN,GOWA,BONTONOMPO SELATAN,6763,10815,17578
SULAWESI SELATAN,TAKALAR,POLOMBANGKENG UTARA,11400,15637,27037
SULAWESI SELATAN,JENEPONTO,KELARA,7132,4960,12092
SULAWESI SELATAN,TAKALAR,MAPPAKASUNGGU,1840,6141,7981
SULAWESI SELATAN,JENEPONTO,BANGKALA BARAT,4761,7620,12381
SULAWESI SELATAN,TAKALAR,POLOMBANGKENG SELATAN,5404,10273,15677
SULAWESI SELATAN,TAKALAR,SANROBONE,2328,4896,7224
SULAWESI SELATAN,GOWA,BIRINGBULU,7248,12643,19891
SULAWESI SELATAN,GOWA,BONTOLEMPANGANG,2717,5819,8536
SULAWESI SELATAN,JENEPONTO,TAMALATEA,9203,9797,19000
SULAWESI SELATAN,TAKALAR,GALESONG,5914,13578,19492
SULAWESI SELATAN,GOWA,BONTONOMPO,11232,13790,25022
SULAWESI SELATAN,GOWA,BUNGAYA,2469,6283,8752
SULAWESI SELATAN,TAKALAR,PATTALLASSANG,7362,11921,19283
SULAWESI SELATAN,GOWA,BONTOMARANNU,6480,10945,17425
SULAWESI SELATAN,GOWA,BAJENG BARAT,4873,9911,14784
SULAWESI SELATAN,GOWA,MANUJU,3165,5147,8312
SULAWESI SELATAN,GOWA,TOMBOLOPAO,4535,9677,14212
SULAWESI SELATAN,TAKALAR,GALESONG UTARA,6253,14474,20727
SULAWESI SELATAN,GOWA,PALANGGA,19477,35741,55218
SULAWESI SELATAN,GOWA,PATTALASANG,3730,9667,13397
SULAWESI SELATAN,GOWA,TOMPOBULLU,5216,11485,16701
SULAWESI SELATAN,GOWA,BAROMBONG,6855,13887,20742
SULAWESI SELATAN,GOWA,PARIGI,2045,5618,7663
SULAWESI SELATAN,SINJAI,SINJAI UTARA,8055,13050,21105
SULAWESI SELATAN,SINJAI,BULUPODDO,3230,5534,8764
SULAWESI SELATAN,GOWA,BAJENG,14734,21661,36395
SULAWESI SELATAN,GOWA,SOMBA UPU,23272,42938,66210
SULAWESI SELATAN,SINJAI,SINJAI BARAT,4560,6997,11557
SULAWESI SELATAN,GOWA,PARANGLOE,2983,6524,9507
SULAWESI SELATAN,SINJAI,SINJAI  SELATAN,6443,12670,19113
SULAWESI SELATAN,SINJAI,SINJAI TENGAH,4967,8662,13629
SULAWESI SELATAN,SINJAI,SINJAI BORONG,3019,4694,7713
SULAWESI SELATAN,BONE,TANETE RIATTANG TIMUR,2321,18770,21091
SULAWESI SELATAN,BONE,BONTOCANI,1630,6827,8457
SULAWESI SELATAN,BONE,TELLULIMPOE,1033,7185,8218
SULAWESI SELATAN,GOWA,TINGGIMONCONG,3829,9074,12903
SULAWESI SELATAN,SINJAI,SINJAI TIMUR,4904,9715,14619
SULAWESI SELATAN,SINJAI,PULAU SEMBILAN,948,2321,3269
SULAWESI SELATAN,BONE,TANETE RIATTANG BARAT,3384,18438,21822
SULAWESI SELATAN,SINJAI,TELLU LIMPOE,5916,10632,16548
SULAWESI SELATAN,BONE,AJANGALE,1722,13045,14767
SULAWESI SELATAN,BONE,DUA BOCCOE,2011,14928,16939
SULAWESI SELATAN,BONE,CENRANA,939,12692,13631
SULAWESI SELATAN,BONE,SALOMEKKO,1598,5623,7221
SULAWESI SELATAN,BONE,MARE,2586,10283,12869
SULAWESI SELATAN,BONE,BENGO,1468,12699,14167
SULAWESI SELATAN,BONE,AWANGPONE,1104,15895,16999
SULAWESI SELATAN,BONE,PALAKKA,1891,10641,12532
SULAWESI SELATAN,BONE,TANETE RIATTANG,4234,21627,25861
SULAWESI SELATAN,BONE,BAREBBO,1546,13343,14889
SULAWESI SELATAN,BONE,LAPPARIAJA,1454,12647,14101
SULAWESI SELATAN,BONE,LAMURU,1112,11772,12884
SULAWESI SELATAN,BONE,SIBULUE,1776,15784,17560
SULAWESI SELATAN,BONE,ULAWENG,2733,11948,14681
SULAWESI SELATAN,BONE,TELLU SIATTINGE,2065,19366,21431
SULAWESI SELATAN,BONE,AMALI,1517,10926,12443
SULAWESI SELATAN,MAROS,TANRALILI,5100,6885,11985
SULAWESI SELATAN,MAROS,MALLLAWA,1724,4939,6663
SULAWESI SELATAN,MAROS,LAU,3391,10260,13651
SULAWESI SELATAN,BONE,PATIMPENG,1568,6522,8090
SULAWESI SELATAN,BONE,KAHU,3507,16801,20308
SULAWESI SELATAN,BONE,KAJUARA,4609,12523,17132
SULAWESI SELATAN,BONE,CINA,1861,12503,14364
SULAWESI SELATAN,MAROS,MANDAI,6516,12687,19203
SULAWESI SELATAN,PANGKAJENE DAN KEPULAUAN,LIUKANG TANGAYA,2770,6494,9264
SULAWESI SELATAN,MAROS,CENRANA,1464,5984,7448
SULAWESI SELATAN,MAROS,SIMBANG,4057,7646,11703
SULAWESI SELATAN,BONE,TONRA,1034,5924,6958
SULAWESI SELATAN,BONE,LIBURENG,2307,14427,16734
SULAWESI SELATAN,MAROS,TOMPOBULU,1699,4984,6683
SULAWESI SELATAN,BONE,PONRE,803,6627,7430
SULAWESI SELATAN,MAROS,BONTOA,2691,12089,14780
SULAWESI SELATAN,MAROS,CAMBA,1240,6293,7533
SULAWESI SELATAN,PANGKAJENE DAN KEPULAUAN,LIUKANG TUPABBIRING,1435,7786,9221
SULAWESI SELATAN,MAROS,MONCONG LOE,2903,6345,9248
SULAWESI SELATAN,MAROS,MARUSU,4421,10634,15055
SULAWESI SELATAN,PANGKAJENE DAN KEPULAUAN,MINASA TENE,5843,12337,18180
SULAWESI SELATAN,PANGKAJENE DAN KEPULAUAN,PANGKAJENE,6350,16761,23111
SULAWESI SELATAN,PANGKAJENE DAN KEPULAUAN,LIUKANG TUPABBIRING UTARA,1050,5677,6727
SULAWESI SELATAN,PANGKAJENE DAN KEPULAUAN,BUNGORO,7841,13878,21719
SULAWESI SELATAN,MAROS,BANTIMURUNG,3748,12132,15880
SULAWESI SELATAN,MAROS,MAROS BARU,2764,9847,12611
SULAWESI SELATAN,BARRU,PUJANANTING,1277,4821,6098
SULAWESI SELATAN,PANGKAJENE DAN KEPULAUAN,LIUKANG KALMAS,1804,4528,6332
SULAWESI SELATAN,PANGKAJENE DAN KEPULAUAN,TONDONG TALLASA,1103,4119,5222
SULAWESI SELATAN,PANGKAJENE DAN KEPULAUAN,MARANG,5292,10618,15910
SULAWESI SELATAN,MAROS,TURIKALE,5473,15994,21467
SULAWESI SELATAN,PANGKAJENE DAN KEPULAUAN,MANDALLE,1811,4726,6537
SULAWESI SELATAN,BARRU,TANETE RIAJA,1604,10629,12233
SULAWESI SELATAN,SOPPENG,GANRA,1076,5729,6805
SULAWESI SELATAN,SOPPENG,MARIORIWAWO,3769,20457,24226
SULAWESI SELATAN,PANGKAJENE DAN KEPULAUAN,LABAKKANG,7813,14953,22766
SULAWESI SELATAN,BARRU,BALUSU,1184,9051,10235
SULAWESI SELATAN,WAJO,PENRANG,0,0,0
SULAWESI SELATAN,BARRU,TANETE RILAU,2818,15753,18571
SULAWESI SELATAN,PANGKAJENE DAN KEPULAUAN,SEGERI,1824,8432,10256
SULAWESI SELATAN,BARRU,SOPPENG RIAJA,1715,8056,9771
SULAWESI SELATAN,PANGKAJENE DAN KEPULAUAN,BALOCCI,2532,5889,8421
SULAWESI SELATAN,SOPPENG,LALABATA,4379,21783,26162
SULAWESI SELATAN,WAJO,PITUMPANUA,0,0,0
SULAWESI SELATAN,BARRU,BARRU,3412,18125,21537
SULAWESI SELATAN,SOPPENG,MARIORIAWA,2137,14539,16676
SULAWESI SELATAN,WAJO,TANASITOLO,0,0,0
SULAWESI SELATAN,WAJO,BOLA,0,0,0
SULAWESI SELATAN,BARRU,MALLUSETASI,1780,12656,14436
SULAWESI SELATAN,SOPPENG,LILIRIAJA,2374,12899,15273
SULAWESI SELATAN,SOPPENG,DONRI DONRI,1489,12046,13535
SULAWESI SELATAN,WAJO,MANIANGPAJO,0,0,0
SULAWESI SELATAN,SIDENRENG RAPPANG,PANCA LAUTANG,1099,8889,9988
SULAWESI SELATAN,WAJO,TAKKALALLA,0,0,0
SULAWESI SELATAN,SOPPENG,CITTA,974,3268,4242
SULAWESI SELATAN,SOPPENG,LILIRILAU,3447,18838,22285
SULAWESI SELATAN,WAJO,TEMPE,0,0,0
SULAWESI SELATAN,WAJO,KEERA,0,0,0
SULAWESI SELATAN,WAJO,PAMMANA,0,0,0
SULAWESI SELATAN,WAJO,SABANGPARU,0,0,0
SULAWESI SELATAN,WAJO,GILIRENG,0,0,0
SULAWESI SELATAN,SIDENRENG RAPPANG,KULO,1409,5153,6562
SULAWESI SELATAN,WAJO,MAJAULENG,0,0,0
SULAWESI SELATAN,WAJO,BELAWA,0,0,0
SULAWESI SELATAN,WAJO,SAJOANGING,0,0,0
SULAWESI SELATAN,SIDENRENG RAPPANG,MARITENGNGAE,4629,21492,26121
SULAWESI SELATAN,SIDENRENG RAPPANG,TELLU LIMPOE,3115,10380,13495
SULAWESI SELATAN,PINRANG,PATAMPANUA,4613,11696,16309
SULAWESI SELATAN,PINRANG,MATIRRO SOMPE,2730,11963,14693
SULAWESI SELATAN,SIDENRENG RAPPANG,PITU RIASE,2212,9239,11451
SULAWESI SELATAN,SIDENRENG RAPPANG,PITU RIAWA,2923,11684,14607
SULAWESI SELATAN,PINRANG,TIROANG,0,0,0
SULAWESI SELATAN,SIDENRENG RAPPANG,BARANTI,3131,13517,16648
SULAWESI SELATAN,PINRANG,LEMBANG,0,0,0
SULAWESI SELATAN,SIDENRENG RAPPANG,DUA PITUE,2774,12804,15578
SULAWESI SELATAN,SIDENRENG RAPPANG,PANCA RIJANG,3708,12151,15859
SULAWESI SELATAN,ENREKANG,MAIWA,3733,8964,12697
SULAWESI SELATAN,PINRANG,LANRISANG,1900,8241,10141
SULAWESI SELATAN,SIDENRENG RAPPANG,WATANG PULU,4310,12557,16867
SULAWESI SELATAN,ENREKANG,CENDANA,1891,2737,4628
SULAWESI SELATAN,PINRANG,WATANG SAWITO,6848,19833,26681
SULAWESI SELATAN,PINRANG,BATU LAPPA,1334,3920,5254
SULAWESI SELATAN,ENREKANG,MASALLE,1701,4537,6238
SULAWESI SELATAN,PINRANG,SUPPA,2587,13745,16332
SULAWESI SELATAN,PINRANG,PALETEANG,5193,13124,18317
SULAWESI SELATAN,ENREKANG,BUNGIN,1076,1491,2567
SULAWESI SELATAN,ENREKANG,BAROKO,1914,3501,5415
SULAWESI SELATAN,LUWU,KAMANRE,1429,4346,5775
SULAWESI SELATAN,ENREKANG,CURIO,3004,4628,7632
SULAWESI SELATAN,ENREKANG,ENREKANG,6609,10063,16672
SULAWESI SELATAN,PINRANG,DUAMPANUA,4658,17165,21823
SULAWESI SELATAN,PINRANG,CEMPA,1855,7360,9215
SULAWESI SELATAN,ENREKANG,ALLA,4622,5945,10567
SULAWESI SELATAN,ENREKANG,ANGGERAJA,5083,8077,13160
SULAWESI SELATAN,ENREKANG,BARAKA,5530,5745,11275
SULAWESI SELATAN,LUWU,SULI BARAT,830,4166,4996
SULAWESI SELATAN,PINRANG,MATTIRO BULU,2989,12846,15835
SULAWESI SELATAN,ENREKANG,MALUA,2055,2152,4207
SULAWESI SELATAN,LUWU,BASSE SANGTEMPE,705,3221,3926
SULAWESI SELATAN,LUWU,WALENRANG TIMUR,3142,5348,8490
SULAWESI SELATAN,LUWU,LAROMPONG,2863,8972,11835
SULAWESI SELATAN,LUWU,WALENRANG UTARA,4331,7626,11957
SULAWESI SELATAN,LUWU,LAMASI TIMUR,1935,4226,6161
SULAWESI SELATAN,LUWU,BUA,4287,10712,14999
SULAWESI SELATAN,ENREKANG,BUNTU BATU,2592,4570,7162
SULAWESI SELATAN,LUWU,BELOPA UTARA,2341,5254,7595
SULAWESI SELATAN,LUWU,BUA PONRANG,2733,5233,7966
SULAWESI SELATAN,LUWU,PONRANG,4558,9108,13666
SULAWESI SELATAN,LUWU,LATIMOJONG,957,2190,3147
SULAWESI SELATAN,LUWU,BASSE SANGTEMPE UTARA,807,3394,4201
SULAWESI SELATAN,LUWU,BELOPA,3004,5845,8849
SULAWESI SELATAN,TANA TORAJA,MASANDA,726,1800,2526
SULAWESI SELATAN,LUWU,WALENRANG BARAT,2824,4132,6956
SULAWESI SELATAN,LUWU,SULI,2795,7453,10248
SULAWESI SELATAN,LUWU,BAJO BARAT,1463,3510,4973
SULAWESI SELATAN,LUWU,LAMASI,5601,5629,11230
SULAWESI SELATAN,TANA TORAJA,MAPPAK,749,2338,3087
SULAWESI SELATAN,LUWU,PONRANG SELATAN,3871,10335,14206
SULAWESI SELATAN,LUWU,WALENRANG,4940,8375,13315
SULAWESI SELATAN,TANA TORAJA,SANGALLA UTARA,983,3004,3987
SULAWESI SELATAN,TANA TORAJA,RANTETAYO,1495,4148,5643
SULAWESI SELATAN,TANA TORAJA,SALUPUTI,1072,2673,3745
SULAWESI SELATAN,TANA TORAJA,MAKALE SELATAN,1914,3586,5500
SULAWESI SELATAN,TANA TORAJA,MENGKENDEK,4374,9952,14326
SULAWESI SELATAN,LUWU,BAJO,3901,5518,9419
SULAWESI SELATAN,TANA TORAJA,RANO,995,1648,2643
SULAWESI SELATAN,TANA TORAJA,MAKALE UTARA,1619,4830,6449
SULAWESI SELATAN,LUWU UTARA,MALANGKE,2062,11021,13083
SULAWESI SELATAN,LUWU,LAROMPONG SELATAN,1766,7184,8950
SULAWESI SELATAN,TANA TORAJA,SANGALLA SELATAN,977,2786,3763
SULAWESI SELATAN,TANA TORAJA,MAKALE,5060,11447,16507
SULAWESI SELATAN,TANA TORAJA,MALIMBONG BALEPE,870,2781,3651
SULAWESI SELATAN,TANA TORAJA,REMBON,2599,6051,8650
SULAWESI SELATAN,TANA TORAJA,BITTUANG,1579,4535,6114
SULAWESI SELATAN,LUWU UTARA,MALANGKE BARAT,2418,9047,11465
SULAWESI SELATAN,TANA TORAJA,SIMBUANG,1122,1841,2963
SULAWESI SELATAN,TANA TORAJA,SANGALLA,1041,2542,3583
SULAWESI SELATAN,LUWU UTARA,SABBANG,6339,12082,18421
SULAWESI SELATAN,LUWU UTARA,MAPPEDECENG,3669,8870,12539
SULAWESI SELATAN,LUWU UTARA,BAEBUNTA,7515,15564,23079
SULAWESI SELATAN,LUWU TIMUR,MANGKUTANA,3958,7090,11048
SULAWESI SELATAN,TANA TORAJA,GANDANGBATU SILLANAN,2542,6997,9539
SULAWESI SELATAN,LUWU UTARA,SEKO,3845,3126,6971
SULAWESI SELATAN,LUWU UTARA,SUKAMAJU,10048,12952,23000
SULAWESI SELATAN,TANA TORAJA,BONGGAKARADENG,984,1841,2825
SULAWESI SELATAN,LUWU UTARA,MASAMBA,4654,11692,16346
SULAWESI SELATAN,LUWU TIMUR,TOMONI TIMUR,2417,4740,7157
SULAWESI SELATAN,LUWU UTARA,TANA LILI,4268,7237,11505
SULAWESI SELATAN,TANA TORAJA,KURRA,515,1832,2347
SULAWESI SELATAN,LUWU UTARA,LIMBONG,837,771,1608
SULAWESI SELATAN,LUWU UTARA,RAMPI,468,1018,1486
SULAWESI SELATAN,LUWU UTARA,BONE BONE,4915,8083,12998
SULAWESI SELATAN,LUWU TIMUR,BURAU,4434,10803,15237
SULAWESI SELATAN,LUWU TIMUR,MALILI,5040,11226,16266
SULAWESI SELATAN,TORAJA UTARA,TALLUNGLIPU,2886,6013,8899
SULAWESI SELATAN,LUWU TIMUR,TOWUTI,5412,8778,14190
SULAWESI SELATAN,LUWU TIMUR,WOTU,4691,10094,14785
SULAWESI SELATAN,TORAJA UTARA,RANTEBUA,1891,4844,6735
SULAWESI SELATAN,LUWU TIMUR,NUHA,4373,5487,9860
SULAWESI SELATAN,TORAJA UTARA,NANGGALA,2019,3641,5660
SULAWESI SELATAN,TORAJA UTARA,TONDON,2792,3844,6636
SULAWESI SELATAN,TORAJA UTARA,SOPAI,2535,4009,6544
SULAWESI SELATAN,TORAJA UTARA,RINDINGALLO,952,3099,4051
SULAWESI SELATAN,LUWU TIMUR,ANGKONA,3714,7983,11697
SULAWESI SELATAN,LUWU TIMUR,KALAENA,1809,4287,6096
SULAWESI SELATAN,TORAJA UTARA,RANTEPAO,3787,8020,11807
SULAWESI SELATAN,TORAJA UTARA,KAPALA PITU,795,1823,2618
SULAWESI SELATAN,LUWU TIMUR,TOMONI,4609,7667,12276
SULAWESI SELATAN,TORAJA UTARA,TIKALA,1613,3325,4938
SULAWESI SELATAN,KOTA MAKASSAR,RAPPOCINI,23014,50226,73240
SULAWESI SELATAN,LUWU TIMUR,WASUPONDA,2872,5677,8549
SULAWESI SELATAN,TORAJA UTARA,BUNTU PEPASAN,2170,6947,9117
SULAWESI SELATAN,KOTA MAKASSAR,PANAKUKKANG,18437,45870,64307
SULAWESI SELATAN,TORAJA UTARA,BALUSU,1470,3459,4929
SULAWESI SELATAN,KOTA MAKASSAR,TAMALATE,23292,51303,74595
SULAWESI SELATAN,KOTA MAKASSAR,UJUNG PANDANG,3409,10255,13664
SULAWESI SELATAN,TORAJA UTARA,SESEAN SULOARA,963,2682,3645
SULAWESI SELATAN,KOTA MAKASSAR,BIRINGKANAYA,25507,57225,82732
SULAWESI SELATAN,KOTA MAKASSAR,BONTOALA,5664,20158,25822
SULAWESI SELATAN,TORAJA UTARA,AWAN RANTE KARUA,620,1601,2221
SULAWESI SELATAN,KOTA PARE PARE,BACUKIKI BARAT,5272,15822,21094
SULAWESI SELATAN,TORAJA UTARA,SESEAN,1714,3999,5713
SULAWESI SELATAN,KOTA MAKASSAR,MANGGALA,17896,42748,60644
SULAWESI SELATAN,KOTA PARE PARE,SOREANG,5877,17060,22937
SULAWESI SELATAN,KOTA MAKASSAR,MAKASAR,10666,28272,38938
SULAWESI SELATAN,KOTA PALOPO,TELLUWANUA,2517,3691,6208
SULAWESI SELATAN,KOTA MAKASSAR,TAMALANREA,15215,29906,45121
SULAWESI SELATAN,KOTA MAKASSAR,MARISO,9636,17432,27068
SULAWESI SELATAN,TORAJA UTARA,SANGGALANGI,2051,3824,5875
SULAWESI SELATAN,KOTA MAKASSAR,UJUNG TANAH,5646,17706,23352
SULAWESI SELATAN,KOTA PALOPO,WARA TIMUR,4804,10468,15272
SULAWESI SELATAN,KOTA MAKASSAR,TALLO,16709,45729,62438
SULAWESI SELATAN,KOTA MAKASSAR,WAJO,2845,12745,15590
SULAWESI SELATAN,KOTA PARE PARE,BACUKIKI,2211,6414,8625
SULAWESI SELATAN,KOTA PALOPO,WARA,4667,9394,14061
SULAWESI SELATAN,KOTA PALOPO,MUNGKAJANG,1184,2704,3888
SULAWESI SELATAN,KOTA MAKASSAR,MAMAJANG,8957,17778,26735
SULAWESI TENGGARA,KOLAKA,TANGGETADA,2143,4552,6695
SULAWESI SELATAN,KOTA PALOPO,BARA,4772,7403,12175
SULAWESI TENGGARA,KOLAKA,LAMBANDIA,2298,11517,13815
SULAWESI SELATAN,KOTA PARE PARE,UJUNG,4720,11915,16635
SULAWESI TENGGARA,KOLAKA,TINONDO,1534,1954,3488
SULAWESI TENGGARA,KOLAKA,WUNDULAKO,6069,3864,9933
SULAWESI TENGGARA,KOLAKA,LALOLAE,976,723,1699
SULAWESI SELATAN,KOTA PALOPO,WARA SELATAN,1634,3401,5035
SULAWESI TENGGARA,KOLAKA,TOARI,1858,2553,4411
SULAWESI TENGGARA,KOLAKA,POMALAA,5687,7541,13228
SULAWESI SELATAN,KOTA PALOPO,WARA BARAT,1870,3155,5025
SULAWESI SELATAN,KOTA PALOPO,SENDANA,1057,1987,3044
SULAWESI SELATAN,KOTA PALOPO,WARA UTARA,3184,6299,9483
SULAWESI TENGGARA,KOLAKA,LOEA,1352,2115,3467
SULAWESI TENGGARA,KOLAKA,MOWEWE,2756,1322,4078
SULAWESI TENGGARA,KOLAKA,TIRAWUTA,3289,3320,6609
SULAWESI TENGGARA,KONAWE,ANGGABERI,2966,997,3963
SULAWESI TENGGARA,KOLAKA,LATAMBAGA,5256,7933,13189
SULAWESI TENGGARA,KOLAKA,SAMATURU,3515,6943,10458
SULAWESI TENGGARA,KOLAKA,KOLAKA,9152,8372,17524
SULAWESI TENGGARA,KONAWE,LAMBUYA,2059,1421,3480
SULAWESI TENGGARA,KOLAKA,WATUBANGGA,2195,5230,7425
SULAWESI TENGGARA,KOLAKA,ULUIWOI,2552,1296,3848
SULAWESI TENGGARA,KOLAKA,POLINGGONA,935,1821,2756
SULAWESI TENGGARA,KONAWE,MELUHU,1340,1460,2800
SULAWESI TENGGARA,KOLAKA,LADONGI,4375,8020,12395
SULAWESI TENGGARA,KONAWE,BONDOALA,3001,1547,4548
SULAWESI TENGGARA,KOLAKA,WOLO,4288,7258,11546
SULAWESI TENGGARA,KONAWE,ROUTA,277,1540,1817
SULAWESI TENGGARA,KONAWE,KAPOIALA,1301,1072,2373
SULAWESI TENGGARA,KOLAKA,BAULA,2665,2427,5092
SULAWESI TENGGARA,KONAWE,BESULUTU,2131,1615,3746
SULAWESI TENGGARA,KONAWE,WAWONII TIMUR LAUT,1155,795,1950
SULAWESI TENGGARA,KONAWE,ASINUA,629,775,1404
SULAWESI TENGGARA,KONAWE,LALONGGASUMEETO,1823,945,2768
SULAWESI TENGGARA,KONAWE,UEPAI,3743,2935,6678
SULAWESI TENGGARA,KONAWE,WAWOTOBI,6238,4360,10598
SULAWESI TENGGARA,KONAWE,WONGGEDUKU,7032,4378,11410
SULAWESI TENGGARA,KONAWE,WAWONII TENGAH,558,913,1471
SULAWESI TENGGARA,KONAWE,KONAWE,2855,1439,4294
SULAWESI TENGGARA,KONAWE,ABUKI,3698,4018,7716
SULAWESI TENGGARA,KONAWE,WAWONII TENGGARA,1987,1312,3299
SULAWESI TENGGARA,KONAWE,AMONGGEDO,2861,2967,5828
SULAWESI TENGGARA,KONAWE,PONDIDAHA,3623,2123,5746
SULAWESI TENGGARA,KONAWE,WAWONII BARAT,1576,1681,3257
SULAWESI TENGGARA,KONAWE,PURIALA,2830,1408,4238
SULAWESI TENGGARA,KONAWE,WAWONII UTARA,1356,1513,2869
SULAWESI TENGGARA,MUNA,KABAWO,2869,1901,4770
SULAWESI TENGGARA,KONAWE,SAMPARA,5154,1800,6954
SULAWESI TENGGARA,KONAWE,UNAAHA,6490,5220,11710
SULAWESI TENGGARA,MUNA,KONTU KOWUNA,1139,585,1724
SULAWESI TENGGARA,MUNA,BONE,1622,804,2426
SULAWESI TENGGARA,MUNA,MAROBO,1023,1534,2557
SULAWESI TENGGARA,MUNA,PASIR PUTIH,1124,740,1864
SULAWESI TENGGARA,MUNA,TONGKUNO SELATAN,930,1335,2265
SULAWESI TENGGARA,KONAWE,WAWONII SELATAN,1483,841,2324
SULAWESI TENGGARA,MUNA,WA DAGA,1303,911,2214
SULAWESI TENGGARA,KONAWE,TONGAUNA,4971,3946,8917
SULAWESI TENGGARA,KONAWE,WAWONII TIMUR,1215,598,1813
SULAWESI TENGGARA,KONAWE,SOROPIA,2641,1853,4494
SULAWESI TENGGARA,KONAWE,ONEMBUTE,1772,1676,3448
SULAWESI TENGGARA,MUNA,TIWORO SELATAN,969,1331,2300
SULAWESI TENGGARA,MUNA,SEWERGADI,62,79,141
SULAWESI TENGGARA,MUNA,MAGINTI,1826,1688,3514
SULAWESI TENGGARA,KONAWE,LATOMA,735,390,1125
SULAWESI TENGGARA,MUNA,TONGKUNO,3262,2121,5383
SULAWESI TENGGARA,MUNA,PARIGI,2490,1710,4200
SULAWESI TENGGARA,MUNA,KUSAMBI,2535,1919,4454
SULAWESI TENGGARA,MUNA,TIWORO TENGAH,1528,1710,3238
SULAWESI TENGGARA,MUNA,NAPABALANO,2730,1598,4328
SULAWESI TENGGARA,MUNA,BARANGKA,1690,965,2655
SULAWESI TENGGARA,MUNA,LAWA,1866,1299,3165
SULAWESI TENGGARA,MUNA,LASALEPA,2950,1581,4531
SULAWESI TENGGARA,MUNA,TIWORO KEPULAUAN,1810,1257,3067
SULAWESI TENGGARA,MUNA,BATALAIWARU,3129,1865,4994
SULAWESI TENGGARA,MUNA,WATOPUTE,2870,2208,5078
SULAWESI TENGGARA,MUNA,DURUKA,3004,2103,5107
SULAWESI TENGGARA,MUNA,BATUKARA,478,575,1053
SULAWESI TENGGARA,MUNA,MALIGANO,1200,1156,2356
SULAWESI TENGGARA,MUNA,KABANGKA,2146,2348,4494
SULAWESI TENGGARA,BUTON,MAWASANGKA TENGAH,2077,1871,3948
SULAWESI TENGGARA,MUNA,PASI KOLAGA,1069,579,1648
SULAWESI TENGGARA,MUNA,TOWEA,1382,730,2112
SULAWESI TENGGARA,MUNA,NAPANO KUSAMBI,1056,847,1903
SULAWESI TENGGARA,BUTON,LAPANDEWA,1560,1671,3231
SULAWESI TENGGARA,BUTON,LASALIMU,1716,3419,5135
SULAWESI TENGGARA,MUNA,LOHIA,3458,2102,5560
SULAWESI TENGGARA,BUTON,LAKUDO,5643,4534,10177
SULAWESI TENGGARA,MUNA,KATOBU,8082,4828,12910
SULAWESI TENGGARA,BUTON,MAWASANGKA TIMUR,1540,875,2415
SULAWESI TENGGARA,BUTON,WABULA,951,1722,2673
SULAWESI TENGGARA,BUTON,SANGIA WAMBULU,2598,892,3490
SULAWESI TENGGARA,BUTON,MAWASANGKA,4526,5360,9886
SULAWESI TENGGARA,MUNA,TIWORO UTARA,1313,1135,2448
SULAWESI TENGGARA,MUNA,KONTUNAGA,1919,1290,3209
SULAWESI TENGGARA,MUNA,WAKORUMBA SELATAN,1091,658,1749
SULAWESI TENGGARA,BUTON,BATU ATAS,676,2216,2892
SULAWESI TENGGARA,BUTON,SIOMPU,1511,2503,4014
SULAWESI TENGGARA,BUTON,SAMPOLAWA,2916,6423,9339
SULAWESI TENGGARA,KONAWE SELATAN,BENUA,1198,3498,4696
SULAWESI TENGGARA,BUTON,SIOMPU BARAT,1925,1034,2959
SULAWESI TENGGARA,BUTON,LASALIMU SELATAN,2498,2962,5460
SULAWESI TENGGARA,BUTON,TELAGA RAYA,1120,2896,4016
SULAWESI TENGGARA,KONAWE SELATAN,TINANGGEA,4743,6038,10781
SULAWESI TENGGARA,BUTON,PASARWAJO,5645,12815,18460
SULAWESI TENGGARA,BUTON,WOLOWA,755,1667,2422
SULAWESI TENGGARA,BUTON,KAPONTORI,3403,3607,7010
SULAWESI TENGGARA,BUTON,KADATUA,2112,1476,3588
SULAWESI TENGGARA,KONAWE SELATAN,MOWILA,2428,4203,6631
SULAWESI TENGGARA,KONAWE SELATAN,BAITO,1667,1989,3656
SULAWESI TENGGARA,BUTON,G U,7341,2910,10251
SULAWESI TENGGARA,BUTON,SIOTAPINA,1709,3989,5698
SULAWESI TENGGARA,BUTON,BATAUGA,2571,4325,6896
SULAWESI TENGGARA,KONAWE SELATAN,KONDA,4943,4268,9211
SULAWESI TENGGARA,KONAWE SELATAN,LAONTI,2815,1852,4667
SULAWESI TENGGARA,KONAWE SELATAN,BUKE,2594,4560,7154
SULAWESI TENGGARA,KONAWE SELATAN,ANDOOLO,4009,3923,7932
SULAWESI TENGGARA,KONAWE SELATAN,MORAMO UTARA,1773,2109,3882
SULAWESI TENGGARA,KONAWE SELATAN,LANDONO,3175,3524,6699
SULAWESI TENGGARA,KONAWE SELATAN,LAINEA,2054,2446,4500
SULAWESI TENGGARA,KONAWE SELATAN,LAEYA,4958,4171,9129
SULAWESI TENGGARA,KONAWE SELATAN,PALANGGA SELATAN,1331,1839,3170
SULAWESI TENGGARA,KONAWE SELATAN,WOLASI,1347,1237,2584
SULAWESI TENGGARA,KONAWE SELATAN,BASALA,677,3619,4296
SULAWESI TENGGARA,KONAWE SELATAN,MORAMO,3681,3629,7310
SULAWESI TENGGARA,KONAWE SELATAN,LALEMBUU,2506,6209,8715
SULAWESI TENGGARA,KONAWE SELATAN,ANGATA,3468,3687,7155
SULAWESI TENGGARA,KONAWE SELATAN,PALANGGA,3677,2642,6319
SULAWESI TENGGARA,BOMBANA,KABAENA TENGAH,1074,617,1691
SULAWESI TENGGARA,BOMBANA,TONTONUNU,689,1808,2497
SULAWESI TENGGARA,BOMBANA,RUMBIA,1925,2635,4560
SULAWESI TENGGARA,BOMBANA,POLEANG TENGGARA,514,1190,1704
SULAWESI TENGGARA,KONAWE SELATAN,RANOMEETO BARAT,2191,1468,3659
SULAWESI TENGGARA,BOMBANA,KABAENA SELATAN,1084,552,1636
SULAWESI TENGGARA,BOMBANA,KABAENA BARAT,1236,2082,3318
SULAWESI TENGGARA,KONAWE SELATAN,RANOMEETO,4481,3136,7617
SULAWESI TENGGARA,BOMBANA,POLEANG SELATAN,576,2478,3054
SULAWESI TENGGARA,BOMBANA,POLEANG,2231,4996,7227
SULAWESI TENGGARA,BOMBANA,KABAENA UTARA,760,938,1698
SULAWESI TENGGARA,KONAWE SELATAN,KOLONO,3025,4104,7129
SULAWESI TENGGARA,BOMBANA,LANTARI JAYA,1696,2223,3919
SULAWESI TENGGARA,BOMBANA,MATA OLEO,1537,1406,2943
SULAWESI TENGGARA,BOMBANA,MATA USU,282,551,833
SULAWESI TENGGARA,BOMBANA,POLEANG UTARA,0,0,0
SULAWESI TENGGARA,BOMBANA,KABAENA TIMUR,1180,1821,3001
SULAWESI TENGGARA,BOMBANA,POLEANG BARAT,1927,3664,5591
SULAWESI TENGGARA,BOMBANA,POLEANG TENGAH,458,1351,1809
SULAWESI TENGGARA,KOLAKA UTARA,LASUSUA,3020,8644,11664
SULAWESI TENGGARA,BOMBANA,RUMBIA TENGAH,1006,1806,2812
SULAWESI TENGGARA,WAKATOBI,WANGI WANGI SELATAN,4273,7920,12193
SULAWESI TENGGARA,KOLAKA UTARA,POREHU,931,2339,3270
SULAWESI TENGGARA,WAKATOBI,KALEDUPA SELATAN,897,2502,3399
SULAWESI TENGGARA,WAKATOBI,BINONGKO,1252,2407,3659
SULAWESI TENGGARA,BOMBANA,RAROWATU,1281,1257,2538
SULAWESI TENGGARA,KOLAKA UTARA,WATUNOHU,499,3560,4059
SULAWESI TENGGARA,BOMBANA,POLEANG TIMUR,1125,3385,4510
SULAWESI TENGGARA,BOMBANA,KABAENA,868,595,1463
SULAWESI TENGGARA,WAKATOBI,TOMIA TIMUR,816,3422,4238
SULAWESI TENGGARA,KOLAKA UTARA,LAMBAI,590,2670,3260
SULAWESI TENGGARA,WAKATOBI,TOMIA,1099,2588,3687
SULAWESI TENGGARA,BOMBANA,RAROWATU UTARA,1389,2080,3469
SULAWESI TENGGARA,KOLAKA UTARA,NGAPA,1919,9334,11253
SULAWESI TENGGARA,KOLAKA UTARA,PAKUE,1124,3784,4908
SULAWESI TENGGARA,KOLAKA UTARA,PAKUE UTARA,927,3044,3971
SULAWESI TENGGARA,KOLAKA UTARA,TOLALA,271,1212,1483
SULAWESI TENGGARA,KONAWE UTARA,SAWA,981,1382,2363
SULAWESI TENGGARA,WAKATOBI,KALEDUPA,1618,3381,4999
SULAWESI TENGGARA,KOLAKA UTARA,KODEOHA,1023,4434,5457
SULAWESI TENGGARA,KONAWE UTARA,ASERA,1910,1849,3759
SULAWESI TENGGARA,KOLAKA UTARA,TIWU,540,1909,2449
SULAWESI TENGGARA,KONAWE UTARA,ANDOWIA,1320,1884,3204
SULAWESI TENGGARA,KONAWE UTARA,MOLAWE,1110,1803,2913
SULAWESI TENGGARA,KOLAKA UTARA,RANTE ANGIN,653,2181,2834
SULAWESI TENGGARA,KOLAKA UTARA,KATOI,711,2519,3230
SULAWESI TENGGARA,WAKATOBI,TOGO BINONGKO,726,1428,2154
SULAWESI TENGGARA,KOLAKA UTARA,BATU PUTIH,1260,3012,4272
SULAWESI TENGGARA,BUTON UTARA,KULISUSU UTARA,1765,2416,4181
SULAWESI TENGGARA,KOLAKA UTARA,PAKUE TENGAH,895,3104,3999
SULAWESI TENGGARA,KONAWE UTARA,WIWIRANO,1771,2888,4659
SULAWESI TENGGARA,KONAWE UTARA,LANGGIKIMA,901,1578,2479
SULAWESI TENGGARA,KONAWE UTARA,OHEO,1325,1200,2525
SULAWESI TENGGARA,KOLAKA UTARA,WAWO,1031,2282,3313
SULAWESI TENGGARA,BUTON UTARA,KULISUSU,4343,6871,11214
SULAWESI TENGGARA,KOTA KENDARI,POASIA,6554,7268,13822
SULAWESI TENGGARA,BUTON UTARA,WAKORUMBA UTARA,1459,1575,3034
SULAWESI TENGGARA,BUTON UTARA,KAMBOWA,994,2062,3056
SULAWESI TENGGARA,KONAWE UTARA,LEMBO,1399,1208,2607
SULAWESI TENGGARA,KOTA KENDARI,MANDONGA,8626,10097,18723
SULAWESI TENGGARA,KOTA KENDARI,ABELI,5658,6465,12123
SULAWESI TENGGARA,KONAWE UTARA,LASOLO,2852,3388,6240
SULAWESI TENGGARA,KOTA BAU BAU,SORA WALIO,1509,1645,3154
SULAWESI TENGGARA,KOTA KENDARI,KADIA,9703,10143,19846
SULAWESI TENGGARA,KOTA KENDARI,PUUWATU,8297,8003,16300
SULAWESI TENGGARA,BUTON UTARA,BONEGUNU,1307,2386,3693
SULAWESI TENGGARA,BUTON UTARA,KULISUSU BARAT,1140,1829,2969
SULAWESI TENGGARA,KOTA KENDARI,KAMBU,6205,6121,12326
SULAWESI TENGGARA,KOTA BAU BAU,MURHUM,3968,5653,9621
SULAWESI TENGGARA,KOTA BAU BAU,BATUPOARO,4798,8032,12830
SULAWESI TENGGARA,KONAWE UTARA,MOTUI,676,1098,1774
SULAWESI TENGGARA,KOTA KENDARI,KENDARI,6397,7410,13807
SULAWESI TENGGARA,KOTA KENDARI,KENDARI BARAT,9274,12711,21985
GORONTALO,GORONTALO,BILUHU,2848,1735,4583
GORONTALO,GORONTALO,ASPARAGA,4625,2337,6962
GORONTALO,GORONTALO,TABONGO,7036,2526,9562
SULAWESI TENGGARA,KOTA BAU BAU,KOKALUKUNA,3464,4453,7917
GORONTALO,GORONTALO,TILANGO,5072,2470,7542
GORONTALO,GORONTALO,TALAGA JAYA,3584,2442,6026
GORONTALO,GORONTALO,LIMBOTO,18154,7695,25849
SULAWESI TENGGARA,KOTA KENDARI,BARUGA,4871,5547,10418
SULAWESI TENGGARA,KOTA BAU BAU,BETOAMBARI,3826,3905,7731
SULAWESI TENGGARA,KOTA BAU BAU,WOLIO,8115,9768,17883
GORONTALO,GORONTALO,TELAGA,7012,4863,11875
GORONTALO,GORONTALO,TOLANGOHULA,7907,4655,12562
GORONTALO,GORONTALO,BOLIYOHUTO,5201,4600,9801
GORONTALO,GORONTALO,TELAGA BIRU,9991,5176,15167
GORONTALO,GORONTALO,BATUDAA PANTAI,4207,1771,5978
GORONTALO,GORONTALO,MOOTILANGO,6837,3359,10196
GORONTALO,BOALEMO,BOTUMOITO,4685,3330,8015
GORONTALO,BOALEMO,PAGUYAMAN PANTAI,2423,2005,4428
SULAWESI TENGGARA,KOTA BAU BAU,BUNGI,1468,2253,3721
GORONTALO,GORONTALO,DUNGALIYO,6484,2888,9372
GORONTALO,GORONTALO,TIBAWA,14506,6567,21073
GORONTALO,GORONTALO,BILATO,3187,2006,5193
GORONTALO,GORONTALO,LIMBOTO BARAT,10107,3890,13997
GORONTALO,GORONTALO,PULUBALA,9765,3247,13012
GORONTALO,BONE BOLANGO,TAPA,3039,1168,4207
GORONTALO,BONE BOLANGO,BULANGO SELATAN,3866,2137,6003
GORONTALO,GORONTALO,BATUDAA,5747,2107,7854
GORONTALO,BOALEMO,TILAMUTA,8771,6857,15628
GORONTALO,BONE BOLANGO,SUWAWA SELATAN,1479,1349,2828
GORONTALO,BOALEMO,WONOSARI,8151,7155,15306
GORONTALO,GORONTALO,BONGOMEME,7864,2855,10719
GORONTALO,BONE BOLANGO,SUWAWA TIMUR,1662,1279,2941
GORONTALO,BOALEMO,PAGUYAMAN,10782,6992,17774
GORONTALO,BOALEMO,MANANGGU,3588,3009,6597
GORONTALO,BONE BOLANGO,BULAWA,2047,685,2732
GORONTALO,BOALEMO,DULUPI,4729,3831,8560
GORONTALO,BONE BOLANGO,SUWAWA,4027,2585,6612
GORONTALO,BONE BOLANGO,BONE RAYA,2360,1251,3611
GORONTALO,BONE BOLANGO,KABILA BONE,3510,2244,5754
GORONTALO,BONE BOLANGO,BOTUPINGGE,2444,1136,3580
GORONTALO,BONE BOLANGO,SUWAWA TENGAH,2045,1332,3377
GORONTALO,BONE BOLANGO,BULANGO ULU,1510,592,2102
GORONTALO,BONE BOLANGO,BONE,3266,1763,5029
GORONTALO,BONE BOLANGO,BULANGO TIMUR,2222,977,3199
GORONTALO,BONE BOLANGO,TILONGKABILA,6466,3674,10140
GORONTALO,PAHUWATO,PATILANGGIO,3043,1744,4787
GORONTALO,BONE BOLANGO,KABILA,7763,4896,12659
GORONTALO,BONE BOLANGO,PINOGU,685,397,1082
GORONTALO,PAHUWATO,POPAYATO BARAT,1448,1895,3343
GORONTALO,PAHUWATO,POPAYATO,3062,2237,5299
GORONTALO,PAHUWATO,POPAYATO TIMUR,2253,2060,4313
GORONTALO,BONE BOLANGO,BULANGO UTARA,2877,1386,4263
GORONTALO,BONE BOLANGO,BONEPANTAI,3727,1823,5550
GORONTALO,PAHUWATO,BUNTULIA,2705,3056,5761
GORONTALO,PAHUWATO,RANDANGAN,4290,4193,8483
GORONTALO,PAHUWATO,DENGILO,1928,1176,3104
GORONTALO,GORONTALO UTARA,SUMALATA,3578,2145,5723
GORONTALO,GORONTALO UTARA,ATINGGOLA,3974,2150,6124
GORONTALO,PAHUWATO,DUHIADAA,3139,2648,5787
GORONTALO,PAHUWATO,TALUDITI,2192,2057,4249
GORONTALO,PAHUWATO,WANGGARASI,1226,1326,2552
GORONTALO,GORONTALO UTARA,BIAU,1488,1291,2779
GORONTALO,PAHUWATO,PAGUAT,5011,3582,8593
GORONTALO,PAHUWATO,LEMITO,3154,2089,5243
GORONTALO,GORONTALO UTARA,TOMOLITO,3290,1301,4591
GORONTALO,GORONTALO UTARA,MONANO,2260,1335,3595
GORONTALO,KOTA GORONTALO,KOTA UTARA,6437,3536,9973
GORONTALO,GORONTALO UTARA,TOLINGGULA,3435,1484,4919
GORONTALO,PAHUWATO,MARISA,4492,4063,8555
SULAWESI BARAT,MAMUJU UTARA,SARJO,997,2237,3234
GORONTALO,GORONTALO UTARA,PONELO KEPULAUAN,1711,393,2104
GORONTALO,KOTA GORONTALO,KOTA TENGAH,8447,5045,13492
GORONTALO,KOTA GORONTALO,KOTA TIMUR,9066,4758,13824
GORONTALO,KOTA GORONTALO,DUMBO RAYA,5948,3991,9939
GORONTALO,GORONTALO UTARA,ANGGREK,5536,2475,8011
GORONTALO,GORONTALO UTARA,GENTUMA RAYA,3223,1648,4871
GORONTALO,GORONTALO UTARA,KWANDANG,9413,4548,13961
GORONTALO,KOTA GORONTALO,HULONTHALANGI,5707,3461,9168
SULAWESI BARAT,MAMUJU UTARA,DURIPOKU,607,1802,2409
GORONTALO,KOTA GORONTALO,SIPATANA,5745,3746,9491
SULAWESI BARAT,MAMUJU UTARA,SARUDU,1541,5106,6647
SULAWESI BARAT,MAMUJU UTARA,TIKKE RAYA,1753,5009,6762
GORONTALO,GORONTALO UTARA,SUMALATA TIMUR,2361,1391,3752
GORONTALO,KOTA GORONTALO,KOTA BARAT,7928,3996,11924
SULAWESI BARAT,MAMUJU UTARA,PASANGKAYU,2828,8261,11089
GORONTALO,KOTA GORONTALO,DUNGINGI,6624,5148,11772
GORONTALO,KOTA GORONTALO,KOTA SELATAN,6363,4487,10850
SULAWESI BARAT,MAMUJU UTARA,PEDONGGA,1280,2178,3458
SULAWESI BARAT,MAMUJU UTARA,BAMBAIRA,1083,2774,3857
SULAWESI BARAT,MAMUJU UTARA,DAPURANG,674,5534,6208
SULAWESI BARAT,MAMUJU,PAPALANG,0,0,0
SULAWESI BARAT,MAMUJU,MAMUJU,0,0,0
SULAWESI BARAT,MAMUJU UTARA,BAMBALAMOTU,2610,5562,8172
SULAWESI BARAT,MAMUJU,KAROSSA,0,0,0
SULAWESI BARAT,MAMUJU UTARA,BARAS,1772,6083,7855
SULAWESI BARAT,MAMUJU,TAPALANG BARAT,0,0,0
SULAWESI BARAT,MAMUJU UTARA,BULU TABA,1138,3789,4927
SULAWESI BARAT,MAMUJU,TOBADAK,0,0,0
SULAWESI BARAT,MAMUJU,BONEHAU,0,0,0
SULAWESI BARAT,MAMUJU,PANGALE,0,0,0
SULAWESI BARAT,MAMUJU,KALUMPANG,0,0,0
SULAWESI BARAT,MAMUJU UTARA,LARIANG,626,2498,3124
SULAWESI BARAT,MAMUJU,TAPALANG,0,0,0
SULAWESI BARAT,MAMUJU,SIMBORO DAN KEPULAUAN,0,0,0
SULAWESI BARAT,MAMASA,TAWALIAN,880,2856,3736
SULAWESI BARAT,MAMASA,MESSAWA,513,3246,3759
SULAWESI BARAT,MAMUJU,TOPOYO,0,0,0
SULAWESI BARAT,MAMUJU,KALUKKU,0,0,0
SULAWESI BARAT,MAMUJU,TOMMO,0,0,0
SULAWESI BARAT,MAMASA,BAMBANG,1516,6431,7947
SULAWESI BARAT,MAMASA,SUMARORONG,1287,4341,5628
SULAWESI BARAT,MAMUJU,SAMPAGA,0,0,0
SULAWESI BARAT,MAMASA,RANTEBULAHAN TIMUR,625,3544,4169
SULAWESI BARAT,MAMASA,ARALLE,1561,3706,5267
SULAWESI BARAT,POLEWALI MANDAR,ALLU,2547,3695,6242
SULAWESI BARAT,MAMASA,MAMBI,2024,4690,6714
SULAWESI BARAT,MAMASA,TABULAHAN,1439,6337,7776
SULAWESI BARAT,MAMASA,BALLA,547,3476,4023
SULAWESI BARAT,MAMASA,SESENAPADANG,690,3257,3947
SULAWESI BARAT,MAMASA,TANDUK KALUA,1107,3168,4275
SULAWESI BARAT,POLEWALI MANDAR,LIMBORO,3732,5292,9024
SULAWESI BARAT,MAMASA,BUNTUMALANGKA,2397,2876,5273
SULAWESI BARAT,MAMASA,NOSU,552,2539,3091
SULAWESI BARAT,POLEWALI MANDAR,MATAKALI,3423,7550,10973
SULAWESI BARAT,MAMASA,MEHALAAN,809,2069,2878
SULAWESI BARAT,POLEWALI MANDAR,MATANGNGA,1040,1425,2465
SULAWESI BARAT,MAMASA,TABANG,729,1788,2517
SULAWESI BARAT,POLEWALI MANDAR,BINUANG,3789,11784,15573
SULAWESI BARAT,POLEWALI MANDAR,ANREAPI,1398,3518,4916
SULAWESI BARAT,MAMASA,MAMASA,1756,9079,10835
SULAWESI BARAT,POLEWALI MANDAR,TINAMBUNG,3624,8106,11730
SULAWESI BARAT,MAMASA,PANA,1278,4253,5531
SULAWESI BARAT,POLEWALI MANDAR,BALANIPA,3782,8701,12483
SULAWESI BARAT,MAJENE,SENDANA,2895,8480,11375
SULAWESI BARAT,POLEWALI MANDAR,CAMPALAGIAN,8922,16828,25750
SULAWESI BARAT,POLEWALI MANDAR,TUTAR,2839,6572,9411
SULAWESI BARAT,POLEWALI MANDAR,WONOMULYO,10196,15291,25487
SULAWESI BARAT,POLEWALI MANDAR,MAPILLI,4620,9179,13799
SULAWESI BARAT,POLEWALI MANDAR,TAPANGO,3682,7334,11016
SULAWESI BARAT,MAJENE,PAMBOANG,2158,9094,11252
SULAWESI BARAT,POLEWALI MANDAR,LUYO,4264,8575,12839
SULAWESI BARAT,MAJENE,ULUMUNDA,900,3560,4460
SULAWESI BARAT,MAJENE,BANGGAE,5096,15333,20429
MALUKU,MALUKU TENGAH,TELUK ELPAPUTIH,0,0,0
SULAWESI BARAT,POLEWALI MANDAR,BULO,1512,4050,5562
SULAWESI BARAT,POLEWALI MANDAR,POLEWALI,8007,18529,26536
MALUKU,MALUKU TENGAH,LEIHITU,0,0,0
SULAWESI BARAT,MAJENE,TUBO SENDANA,1160,3598,4758
MALUKU,MALUKU TENGAH,SERAM UTARA TIMUR SETI,0,0,0
MALUKU,MALUKU TENGAH,NUSA LAUT,0,0,0
MALUKU,MALUKU TENGAH,SAPARUA,0,0,0
SULAWESI BARAT,MAJENE,MALUNDA,1787,6936,8723
MALUKU,MALUKU TENGAH,SERAM UTARA TIMUR KOBI,0,0,0
MALUKU,MALUKU TENGGARA,KEI KECIL,5888,14111,19999
MALUKU,MALUKU TENGAH,KOTA MASOHI,0,0,0
SULAWESI BARAT,MAJENE,TAMMERODO SENDANA,1240,4649,5889
MALUKU,MALUKU TENGAH,SALAHUTU,0,0,0
MALUKU,MALUKU TENGAH,AMAHAI,0,0,0
MALUKU,MALUKU TENGGARA,KEI BESAR UTARA TIMUR,2388,3067,5455
SULAWESI BARAT,MAJENE,BANGGAE TIMUR,3935,11203,15138
MALUKU,MALUKU TENGAH,SERAM UTARA,0,0,0
MALUKU,MALUKU TENGAH,TELUTIH,0,0,0
MALUKU,MALUKU TENGAH,BANDA,0,0,0
MALUKU,MALUKU TENGAH,LEIHITU BARAT,0,0,0
MALUKU,MALUKU TENGAH,SERAM UTARA BARAT,0,0,0
MALUKU,MALUKU TENGGARA BARAT,KORMOMOLIN,0,0,0
MALUKU,MALUKU TENGAH,SAPARUA TIMUR,0,0,0
MALUKU,MALUKU TENGGARA BARAT,WER MAKTIAN,0,0,0
MALUKU,MALUKU TENGGARA,KEI KECIL TIMUR,3354,3245,6599
MALUKU,MALUKU TENGGARA BARAT,YARU,0,0,0
MALUKU,MALUKU TENGAH,PULAU HARUKU,0,0,0
MALUKU,BURU,NAMLEA,13529,4749,18278
MALUKU,MALUKU TENGGARA BARAT,TANIMBAR UTARA,0,0,0
MALUKU,MALUKU TENGGARA,KEI BESAR,3483,8115,11598
MALUKU,MALUKU TENGGARA BARAT,WER TAMRIAN,0,0,0
MALUKU,MALUKU TENGAH,TEHORU,0,0,0
MALUKU,MALUKU TENGAH,TEON NILA SERUA,0,0,0
MALUKU,MALUKU TENGGARA BARAT,SELARU,0,0,0
MALUKU,MALUKU TENGGARA BARAT,TANIMBAR SELATAN,0,0,0
MALUKU,MALUKU TENGGARA BARAT,MOLU MARU,0,0,0
MALUKU,MALUKU TENGGARA BARAT,WUAR LABOBAR,0,0,0
MALUKU,MALUKU TENGGARA BARAT,NIRUNMAS,0,0,0
MALUKU,MALUKU TENGGARA,KEI BESAR SELATAN,2491,2436,4927
MALUKU,MALUKU TENGGARA,KEI KECIL BARAT,340,2955,3295
MALUKU,BURU,LOLONG GUBA,3867,2147,6014
MALUKU,SERAM BAGIAN TIMUR,SIRITAUN WIDA TIMUR,0,0,0
MALUKU,BURU,FENA LEISELA,0,0,0
MALUKU,SERAM BAGIAN TIMUR,TEOR,0,0,0
MALUKU,BURU,BATABUAL,2898,2078,4976
MALUKU,BURU,WAPLAU,3621,2139,5760
MALUKU,BURU,TELUK KAIELY,1790,617,2407
MALUKU,BURU,AIR BUAYA,3310,2654,5964
MALUKU,SERAM BAGIAN TIMUR,TUTUK TOLU,0,0,0
MALUKU,SERAM BAGIAN TIMUR,PULAU GORONG,0,0,0
MALUKU,BURU,WAEAPO,3994,2496,6490
MALUKU,SERAM BAGIAN TIMUR,KIAN DARAT,0,0,0
MALUKU,SERAM BAGIAN TIMUR,GOROM TIMUR,0,0,0
MALUKU,BURU,WAELATA,3958,2549,6507
MALUKU,BURU,LILIALY,3961,1376,5337
MALUKU,SERAM BAGIAN TIMUR,BULA,0,0,0
MALUKU,SERAM BAGIAN BARAT,KEPULAUAN MANIPA,3365,1261,4626
MALUKU,SERAM BAGIAN TIMUR,WAKATE,0,0,0
MALUKU,SERAM BAGIAN TIMUR,PULAU PANJANG,0,0,0
MALUKU,SERAM BAGIAN TIMUR,BULA BARAT,0,0,0
MALUKU,KEPULAUAN ARU,ARU UTARA TIMUR BATULEY,1112,1117,2229
MALUKU,SERAM BAGIAN TIMUR,KILMURY,0,0,0
MALUKU,SERAM BAGIAN TIMUR,SIWALALAT,0,0,0
MALUKU,SERAM BAGIAN TIMUR,SERAM TIMUR,0,0,0
MALUKU,SERAM BAGIAN BARAT,KAIRATU BARAT,0,0,0
MALUKU,SERAM BAGIAN BARAT,TANIWEL TIMUR,1231,1830,3061
MALUKU,SERAM BAGIAN BARAT,ELPAPUTIH,605,1607,2212
MALUKU,KEPULAUAN ARU,ARU TENGAH TIMUR,630,1622,2252
MALUKU,SERAM BAGIAN BARAT,AMALATU,5061,3497,8558
MALUKU,SERAM BAGIAN TIMUR,TELUK WARU,0,0,0
MALUKU,SERAM BAGIAN BARAT,SERAM BARAT,0,0,0
MALUKU,SERAM BAGIAN TIMUR,WERINAMA,0,0,0
MALUKU,SERAM BAGIAN BARAT,KAIRATU,208,208,416
MALUKU,KEPULAUAN ARU,ARU SELATAN UTARA,593,1478,2071
MALUKU,KEPULAUAN ARU,ARU TENGAH,1244,4924,6168
MALUKU,MALUKU BARAT DAYA,WETAR,1628,2919,4547
MALUKU,SERAM BAGIAN BARAT,TANIWEL,3237,3580,6817
MALUKU,KEPULAUAN ARU,ARU UTARA,982,1936,2918
MALUKU,SERAM BAGIAN BARAT,INAMOSOL,0,0,0
MALUKU,SERAM BAGIAN BARAT,HUAMUAL,0,0,0
MALUKU,SERAM BAGIAN BARAT,HUAMUAL BELAKANG,8647,5142,13789
MALUKU,MALUKU BARAT DAYA,MOA LAKOR,1369,4168,5537
MALUKU,BURU SELATAN,AMBALAU,0,0,0
MALUKU,KEPULAUAN ARU,ARU SELATAN TIMUR,698,1376,2074
MALUKU,KEPULAUAN ARU,ARU TENGAH SELATAN,1040,1647,2687
MALUKU,MALUKU BARAT DAYA,DAMER,738,1964,2702
MALUKU,KOTA AMBON,BAGUALA,8360,18007,26367
MALUKU,MALUKU BARAT DAYA,MNDONA HIERA,430,2366,2796
MALUKU,MALUKU BARAT DAYA,PULAU LETI,1399,2543,3942
MALUKU,BURU SELATAN,NAMROLE,0,0,0
MALUKU,KEPULAUAN ARU,ARU SELATAN,764,2512,3276
MALUKU,BURU SELATAN,LEKSULA,0,0,0
MALUKU,KOTA TUAL,KUR SELATAN,0,0,0
MALUKU,KOTA AMBON,TELUK AMBON,9972,10667,20639
MALUKU,BURU SELATAN,FENA FAFAN,0,0,0
MALUKU,KOTA TUAL,TAYANDO TAM,0,0,0
MALUKU,BURU SELATAN,WAESAMA,0,0,0
MALUKU,BURU SELATAN,KEPALA MADAN,0,0,0
MALUKU,KOTA AMBON,NUSANIWE,15705,32910,48615
MALUKU,KOTA AMBON,LEITIMUR SELATAN,622,4502,5124
MALUKU UTARA,HALMAHERA BARAT,IBU,3183,2284,5467
MALUKU,KOTA AMBON,SIRIMAU,41477,34658,76135
MALUKU,KOTA TUAL,PULAU DULLAH SELATAN,0,0,0
MALUKU UTARA,HALMAHERA BARAT,IBU SELATAN,2519,3094,5613
MALUKU UTARA,HALMAHERA TENGAH,WEDA SELATAN,1230,1594,2824
MALUKU UTARA,HALMAHERA TENGAH,PATANI UTARA,3074,3098,6172
MALUKU UTARA,HALMAHERA BARAT,JAILOLO,8332,6946,15278
MALUKU UTARA,HALMAHERA BARAT,JAILOLO TIMUR,0,0,0
MALUKU UTARA,HALMAHERA TENGAH,WEDA TENGAH,985,1028,2013
MALUKU,KOTA TUAL,PULAU DULLAH UTARA,0,0,0
MALUKU UTARA,HALMAHERA BARAT,JAILOLO SELATAN,4184,3408,7592
MALUKU UTARA,HALMAHERA BARAT,SAHU TIMUR,1501,3227,4728
MALUKU UTARA,HALMAHERA BARAT,SAHU,2319,3286,5605
MALUKU UTARA,HALMAHERA BARAT,LOLODA,2455,3894,6349
MALUKU UTARA,HALMAHERA UTARA,GALELA,3018,741,3759
MALUKU UTARA,HALMAHERA UTARA,GALELA UTARA,0,0,0
MALUKU UTARA,HALMAHERA UTARA,KAO BARAT,1287,3220,4507
MALUKU UTARA,HALMAHERA UTARA,TOBELO TENGAH,0,0,0
MALUKU UTARA,HALMAHERA TENGAH,WEDA,1581,1949,3530
MALUKU UTARA,HALMAHERA BARAT,IBU UTARA,1816,2651,4467
MALUKU UTARA,HALMAHERA TENGAH,PATANI BARAT,1163,1006,2169
MALUKU UTARA,HALMAHERA TENGAH,PATANI,1260,834,2094
MALUKU UTARA,HALMAHERA UTARA,TOBELO TIMUR,0,0,0
MALUKU UTARA,HALMAHERA UTARA,KAO,0,0,0
MALUKU UTARA,HALMAHERA UTARA,MALIFUT,0,0,0
MALUKU UTARA,HALMAHERA UTARA,TOBELO BARAT,0,0,0
MALUKU UTARA,HALMAHERA UTARA,LOLODA UTARA,2460,3241,5701
MALUKU UTARA,HALMAHERA SELATAN,PULAU MAKIAN,4944,3019,7963
MALUKU UTARA,HALMAHERA TENGAH,PULAU GEBE,1510,1291,2801
MALUKU UTARA,HALMAHERA UTARA,TOBELO SELATAN,0,0,0
MALUKU UTARA,HALMAHERA UTARA,TOBELO,4846,7549,12395
MALUKU UTARA,HALMAHERA TENGAH,WEDA UTARA,1704,2341,4045
MALUKU UTARA,HALMAHERA UTARA,KAO TELUK,2113,1408,3521
MALUKU UTARA,HALMAHERA SELATAN,BACAN TIMUR TENGAH,2572,1502,4074
MALUKU UTARA,HALMAHERA SELATAN,GANE BARAT SELATAN,0,0,0
MALUKU UTARA,HALMAHERA UTARA,GALELA SELATAN,3011,1278,4289
MALUKU UTARA,HALMAHERA SELATAN,BACAN TIMUR SELATAN,1834,1245,3079
MALUKU UTARA,HALMAHERA UTARA,GALELA BARAT,2797,2132,4929
MALUKU UTARA,HALMAHERA UTARA,LOLODA KEPULAUAN,1922,1435,3357
MALUKU UTARA,HALMAHERA UTARA,KAO UTARA,0,0,0
MALUKU UTARA,HALMAHERA SELATAN,GANE TIMUR,2097,2460,4557
MALUKU UTARA,HALMAHERA SELATAN,MANDIOLI SELATAN,1612,1124,2736
MALUKU UTARA,HALMAHERA SELATAN,KEPULAUAN BOTANGLOMANG,2122,1619,3741
MALUKU UTARA,HALMAHERA UTARA,TOBELO UTARA,0,0,0
MALUKU UTARA,HALMAHERA SELATAN,KEPULAUAN JORONGA,1981,1021,3002
MALUKU UTARA,HALMAHERA SELATAN,OBI TIMUR,0,0,0
MALUKU UTARA,HALMAHERA SELATAN,KASIRUTA TIMUR,1045,1073,2118
MALUKU UTARA,HALMAHERA SELATAN,OBI SELATAN,0,0,0
MALUKU UTARA,HALMAHERA SELATAN,BACAN BARAT,1603,804,2407
MALUKU UTARA,HALMAHERA SELATAN,KAYOA,3094,1459,4553
MALUKU UTARA,HALMAHERA SELATAN,MANDIOLI UTARA,0,0,0
MALUKU UTARA,HALMAHERA SELATAN,BACAN SELATAN,0,0,0
MALUKU UTARA,HALMAHERA SELATAN,GANE BARAT UTARA,2295,948,3243
MALUKU UTARA,HALMAHERA SELATAN,GANE TIMUR TENGAH,0,0,0
MALUKU UTARA,HALMAHERA SELATAN,BACAN TIMUR,0,0,0
MALUKU UTARA,HALMAHERA SELATAN,OBI,3631,3040,6671
MALUKU UTARA,HALMAHERA SELATAN,GANE BARAT,0,0,0
MALUKU UTARA,HALMAHERA SELATAN,GANE TIMUR SELATAN,0,0,0
MALUKU UTARA,HALMAHERA SELATAN,OBI BARAT,0,0,0
MALUKU UTARA,HALMAHERA SELATAN,BACAN,4538,3794,8332
MALUKU UTARA,KEPULAUAN SULA,TALIABU BARAT LAUT,0,0,0
MALUKU UTARA,HALMAHERA SELATAN,KASIRUTA BARAT,0,0,0
MALUKU UTARA,KEPULAUAN SULA,MANGOLI UTARA,0,0,0
MALUKU UTARA,HALMAHERA SELATAN,BACAN BARAT UTARA,0,0,0
MALUKU UTARA,HALMAHERA SELATAN,MAKIAN BARAT,1925,405,2330
MALUKU UTARA,KEPULAUAN SULA,TALIABU SELATAN,0,0,0
MALUKU UTARA,KEPULAUAN SULA,SULABESI TIMUR,0,0,0
MALUKU UTARA,KEPULAUAN SULA,MANGOLI UTARA TIMUR,0,0,0
MALUKU UTARA,HALMAHERA SELATAN,KAYOA UTARA,1172,648,1820
MALUKU UTARA,KEPULAUAN SULA,MANGOLI TENGAH,0,0,0
MALUKU UTARA,KEPULAUAN SULA,MANGOLI TIMUR,0,0,0
MALUKU UTARA,HALMAHERA SELATAN,KAYOA SELATAN,1711,1448,3159
MALUKU UTARA,HALMAHERA SELATAN,KAYOA BARAT,1667,689,2356
MALUKU UTARA,HALMAHERA SELATAN,OBI UTARA,0,0,0
MALUKU UTARA,KEPULAUAN SULA,TALIABU BARAT,0,0,0
MALUKU UTARA,KEPULAUAN SULA,SULABESI BARAT,0,0,0
MALUKU UTARA,KEPULAUAN SULA,SANANA,0,0,0
MALUKU UTARA,KEPULAUAN SULA,MANGOLI SELATAN,0,0,0
MALUKU UTARA,KEPULAUAN SULA,TALIABU UTARA,0,0,0
MALUKU UTARA,KEPULAUAN SULA,SANANA UTARA,0,0,0
MALUKU UTARA,KEPULAUAN SULA,SULABESI TENGAH,0,0,0
MALUKU UTARA,HALMAHERA TIMUR,MABA UTARA,0,0,0
MALUKU UTARA,HALMAHERA TIMUR,WASILE,2742,2096,4838
MALUKU UTARA,HALMAHERA TIMUR,MABA SELATAN,1693,1633,3326
MALUKU UTARA,HALMAHERA TIMUR,WASILE UTARA,0,0,0
MALUKU UTARA,HALMAHERA TIMUR,WASILE TENGAH,0,0,0
MALUKU UTARA,KEPULAUAN SULA,TALIABU TIMUR SELATAN,0,0,0
MALUKU UTARA,PULAU MOROTAI,MOROTAI UTARA,0,0,0
MALUKU UTARA,KEPULAUAN SULA,MANGOLI BARAT,0,0,0
MALUKU UTARA,PULAU MOROTAI,MOROTAI JAYA,0,0,0
MALUKU UTARA,KEPULAUAN SULA,SULABESI SELATAN,0,0,0
MALUKU UTARA,KOTA TERNATE,KOTA TERNATE UTARA,14462,6523,20985
MALUKU UTARA,HALMAHERA TIMUR,MABA,0,0,0
MALUKU UTARA,HALMAHERA TIMUR,WASILE TIMUR,3120,1620,4740
MALUKU UTARA,KOTA TERNATE,KOTA TERNATE TENGAH,14474,8731,23205
MALUKU UTARA,PULAU MOROTAI,MOROTAI TIMUR,0,0,0
MALUKU UTARA,KOTA TIDORE KEPULAUAN,OBA UTARA,3989,3526,7515
MALUKU UTARA,KOTA TIDORE KEPULAUAN,OBA UTARA,3989,3526,7515
MALUKU UTARA,KEPULAUAN SULA,LEDE,0,0,0
MALUKU UTARA,KOTA TIDORE KEPULAUAN,OBA UTARA,3989,3526,7515
MALUKU UTARA,KEPULAUAN SULA,LEDE,0,0,0
MALUKU UTARA,KOTA TERNATE,PULAU TERNATE,5363,2923,8286
MALUKU UTARA,KOTA TERNATE,KOTA TERNATE SELATAN,16263,9880,26143
MALUKU UTARA,HALMAHERA TIMUR,KOTA MABA,3253,2481,5734
MALUKU UTARA,HALMAHERA TIMUR,MABA TENGAH,0,0,0
MALUKU UTARA,PULAU MOROTAI,MOROTAI SELATAN,0,0,0
MALUKU UTARA,KOTA TIDORE KEPULAUAN,TIDORE UTARA,4878,4178,9056
MALUKU UTARA,KOTA TERNATE,PULAU BATANG DUA,513,856,1369
MALUKU UTARA,KOTA TIDORE KEPULAUAN,TIDORE,4815,4765,9580
MALUKU UTARA,KOTA TIDORE KEPULAUAN,OBA,3709,2789,6498
MALUKU UTARA,PULAU MOROTAI,MOROTAI SELATAN BARAT,0,0,0
MALUKU UTARA,HALMAHERA TIMUR,WASILE SELATAN,0,0,0
PAPUA,MERAUKE,MALIND,0,0,0
PAPUA,MERAUKE,WAAN,0,0,0
PAPUA,MERAUKE,KURIK,0,0,0
MALUKU UTARA,KOTA TERNATE,PULAU HIRI,1533,460,1993
PAPUA,MERAUKE,NGGUTI,0,0,0
PAPUA,MERAUKE,MERAUKE,0,0,0
MALUKU UTARA,KOTA TERNATE,PULAU MOTI,1435,740,2175
PAPUA,MERAUKE,ELIKOBAL,0,0,0
MALUKU UTARA,KOTA TIDORE KEPULAUAN,TIDORE SELATAN,4054,3388,7442
PAPUA,MERAUKE,ILWAYAB,0,0,0
PAPUA,MERAUKE,KAPTEL,0,0,0
PAPUA,MERAUKE,TABONJI,0,0,0
PAPUA,MERAUKE,TUBANG,0,0,0
MALUKU UTARA,KOTA TIDORE KEPULAUAN,OBA TENGAH,2248,2017,4265
PAPUA,MERAUKE,ANIMHA,0,0,0
MALUKU UTARA,KOTA TIDORE KEPULAUAN,OBA SELATAN,1489,1272,2761
MALUKU UTARA,KOTA TIDORE KEPULAUAN,TIDORE TIMUR,2489,1905,4394
PAPUA,MERAUKE,NAUKENJERAI,0,0,0
PAPUA,JAYAWIJAYA,PISUGI,0,0,0
PAPUA,MERAUKE,SEMANGGA,0,0,0
PAPUA,JAYAWIJAYA,MOLAGALOME,0,0,0
PAPUA,JAYAWIJAYA,USILIMO,0,0,0
PAPUA,MERAUKE,ULILIN,0,0,0
PAPUA,MERAUKE,MUTING,0,0,0
PAPUA,MERAUKE,SOTA,0,0,0
PAPUA,JAYAWIJAYA,SIEPKOSI,0,0,0
PAPUA,MERAUKE,KIMAAM,0,0,0
PAPUA,MERAUKE,JAGEBOB,0,0,0
PAPUA,JAYAWIJAYA,SILO KARNO DOGA,0,0,0
PAPUA,MERAUKE,TANAH MIRING,0,0,0
PAPUA,JAYAWIJAYA,BIPIRI,0,0,0
PAPUA,JAYAWIJAYA,WADANGKU,0,0,0
PAPUA,MERAUKE,OKABA,0,0,0
PAPUA,JAYAWIJAYA,MAIMA,0,0,0
PAPUA,JAYAWIJAYA,ASOTIPO,0,0,0
PAPUA,JAYAWIJAYA,WELESI,0,0,0
PAPUA,JAYAWIJAYA,WAMENA,0,0,0
PAPUA,JAYAWIJAYA,WALELAGAMA,0,0,0
PAPUA,JAYAWIJAYA,PELEBAGA,0,0,0
PAPUA,JAYAWIJAYA,BUGI,0,0,0
PAPUA,JAYAWIJAYA,TAGIME,0,0,0
PAPUA,JAYAWIJAYA,KORAGI,0,0,0
PAPUA,JAYAWIJAYA,LIBAREK,0,0,0
PAPUA,JAYAWIJAYA,WITA WAYA,0,0,0
PAPUA,JAYAWIJAYA,ITLAY HISAGE,0,0,0
PAPUA,JAYAWIJAYA,HUBIKIAK,0,0,0
PAPUA,JAYAWIJAYA,WOUMA,0,0,0
PAPUA,JAYAWIJAYA,ASOLOKOBAL,0,0,0
PAPUA,JAYAWIJAYA,WALAIK,0,0,0
PAPUA,JAYAWIJAYA,PIRAMID,0,0,0
PAPUA,JAYAWIJAYA,TAGINERI,0,0,0
PAPUA,JAYAWIJAYA,MUSATFAK,0,0,0
PAPUA,JAYAWIJAYA,IBELE,0,0,0
PAPUA,JAYAWIJAYA,WOLO,0,0,0
PAPUA,JAYAWIJAYA,TRIKORA,0,0,0
PAPUA,JAYAWIJAYA,KURULU,0,0,0
PAPUA,JAYAWIJAYA,MULIAMA,0,0,0
PAPUA,JAYAWIJAYA,NAPUA,0,0,0
PAPUA,JAYAWIJAYA,TAELAREK,0,0,0
PAPUA,JAYAWIJAYA,BOLAKME,0,0,0
PAPUA,JAYAPURA,RAVENI RARA,134,1652,1786
PAPUA,JAYAPURA,SENTANI,18424,24796,43220
PAPUA,JAYAPURA,KAUREH,2068,4892,6960
PAPUA,JAYAWIJAYA,HUBIKOSI,0,0,0
PAPUA,JAYAPURA,EBUNGFA,320,1383,1703
PAPUA,JAYAPURA,DEMTA,308,1488,1796
PAPUA,JAYAPURA,UNURUM GUAY,250,1137,1387
PAPUA,JAYAWIJAYA,YALENGGA,0,0,0
PAPUA,JAYAPURA,KEMTUK GRESI,301,2260,2561
PAPUA,JAYAPURA,NAMBLUONG,952,1142,2094
PAPUA,JAYAWIJAYA,ASOLOGAIMA,0,0,0
PAPUA,JAYAPURA,AIRU,216,861,1077
PAPUA,JAYAPURA,WAIBU,2437,5828,8265
PAPUA,JAYAPURA,SENTANI TIMUR,950,3343,4293
PAPUA,JAYAPURA,YAPSI,1907,1188,3095
PAPUA,JAYAWIJAYA,WESAPUT,0,0,0
PAPUA,JAYAWIJAYA,WAME,0,0,0
PAPUA,NABIRE,WAPOGA,0,0,0
PAPUA,JAYAPURA,GRESI  SELATAN,25,676,701
PAPUA,JAYAPURA,KEMTUK,472,2063,2535
PAPUA,NABIRE,MOORA,0,0,0
PAPUA,JAYAWIJAYA,POPUGOBA,0,0,0
PAPUA,JAYAPURA,YOKARI,161,1260,1421
PAPUA,NABIRE,NABIRE,0,0,0
PAPUA,JAYAPURA,NIMBORAN,470,2553,3023
PAPUA,NABIRE,SIRIWO,0,0,0
PAPUA,KEPULAUAN YAPEN,PULAU KURUDU,0,0,0
PAPUA,NABIRE,DIPA,0,0,0
PAPUA,NABIRE,NABIRE BARAT,0,0,0
PAPUA,JAYAPURA,NIMBOKRANG,2555,1419,3974
PAPUA,NABIRE,YAUR,0,0,0
PAPUA,NABIRE,UWAPA,0,0,0
PAPUA,NABIRE,WANGGAR,0,0,0
PAPUA,NABIRE,TELUK KIMI,0,0,0
PAPUA,JAYAPURA,DEPAPRE,489,1968,2457
PAPUA,NABIRE,MAKIMI,0,0,0
PAPUA,JAYAPURA,SENTANI BARAT,637,1431,2068
PAPUA,KEPULAUAN YAPEN,YAPEN SELATAN,0,0,0
PAPUA,NABIRE,MENOU,0,0,0
PAPUA,NABIRE,YARO,0,0,0
PAPUA,NABIRE,TELUK UMAR,0,0,0
PAPUA,KEPULAUAN YAPEN,PULAU YERUI,0,0,0
PAPUA,KEPULAUAN YAPEN,YAPEN TIMUR,0,0,0
PAPUA,NABIRE,NAPAN,0,0,0
PAPUA,KEPULAUAN YAPEN,ANGKAISERA,0,0,0
PAPUA,KEPULAUAN YAPEN,WINDESI,0,0,0
PAPUA,KEPULAUAN YAPEN,POOM,0,0,0
PAPUA,KEPULAUAN YAPEN,YAPEN UTARA,0,0,0
PAPUA,BIAK NUMFOR,POIRU,54,850,904
PAPUA,KEPULAUAN YAPEN,KOSIWO,0,0,0
PAPUA,BIAK NUMFOR,BIAK KOTA,3216,12715,15931
PAPUA,KEPULAUAN YAPEN,TELUK AMPIMOI,0,0,0
PAPUA,KEPULAUAN YAPEN,KEPULAUAN AMBAI,0,0,0
PAPUA,KEPULAUAN YAPEN,RAIMBAWI,0,0,0
PAPUA,BIAK NUMFOR,SAMOFA,3126,7954,11080
PAPUA,KEPULAUAN YAPEN,WONAWA,0,0,0
PAPUA,BIAK NUMFOR,BRUYADORI,65,710,775
PAPUA,BIAK NUMFOR,YAWOSI,67,974,1041
PAPUA,BIAK NUMFOR,AIMANDO PADAIDO,121,1123,1244
PAPUA,BIAK NUMFOR,ORIDEK,0,0,0
PAPUA,BIAK NUMFOR,ORKERI,91,671,762
PAPUA,BIAK NUMFOR,ANDEY,117,1091,1208
PAPUA,KEPULAUAN YAPEN,YAPEN BARAT,0,0,0
PAPUA,PUNCAK JAYA,MEWOLUK,905,12044,12949
PAPUA,BIAK NUMFOR,NUMFOR BARAT,85,914,999
PAPUA,BIAK NUMFOR,SWANDIWE,364,1898,2262
PAPUA,BIAK NUMFOR,YENDIDORI,397,3296,3693
PAPUA,BIAK NUMFOR,NUMFOR TIMUR,124,776,900
PAPUA,PANIAI,PANIAI TIMUR,0,0,0
PAPUA,BIAK NUMFOR,WARSA,192,2143,2335
PAPUA,PUNCAK JAYA,YAMO,0,0,0
PAPUA,PUNCAK JAYA,TORERE,3000,3807,6807
PAPUA,PANIAI,SIRIWO,0,0,0
PAPUA,PUNCAK JAYA,FAWI,1971,3239,5210
PAPUA,BIAK NUMFOR,PADAIDO,156,882,1038
PAPUA,BIAK NUMFOR,BIAK UTARA,490,2938,3428
PAPUA,PUNCAK JAYA,JIGONIKME,0,0,0
PAPUA,PUNCAK JAYA,ILU,0,0,0
PAPUA,BIAK NUMFOR,BIAK BARAT,219,2481,2700
PAPUA,PANIAI,AGISIGA,0,0,0
PAPUA,BIAK NUMFOR,BONDIFUAR,22,315,337
PAPUA,BIAK NUMFOR,BIAK TIMUR,256,3336,3592
PAPUA,PANIAI,KAPIRAYA,0,0,0
PAPUA,PUNCAK JAYA,MULIA,0,0,0
PAPUA,PANIAI,DUMADAMA,0,0,0
PAPUA,PANIAI,HITADIPA,0,0,0
PAPUA,PUNCAK JAYA,TINGGINAMBUT,2120,26686,28806
PAPUA,PANIAI,TIGI,0,0,0
PAPUA,PANIAI,BOWOBADO,0,0,0
PAPUA,PANIAI,ARADIDE,0,0,0
PAPUA,PANIAI,BIBIDA,0,0,0
PAPUA,PANIAI,KEBO,0,0,0
PAPUA,PANIAI,TIGI BARAT,0,0,0
PAPUA,PANIAI,EKADIDE,0,0,0
PAPUA,PANIAI,WANDAI,0,0,0
PAPUA,MIMIKA,MIMIKA BARU,0,0,0
PAPUA,PANIAI,PANIAI BARAT,0,0,0
PAPUA,PANIAI,BOGABAIDA,0,0,0
PAPUA,MIMIKA,JITA,0,0,0
PAPUA,PANIAI,HOMEO,0,0,0
PAPUA,PANIAI,TIGI TIMUR,0,0,0
PAPUA,PANIAI,YATAMO,0,0,0
PAPUA,PANIAI,BIANDOGA,0,0,0
PAPUA,MIMIKA,MIMIKA TIMUR TENGAH,0,0,0
PAPUA,SARMI,SARMI SELATAN,0,0,0
PAPUA,MIMIKA,MIMIKA BARAT,0,0,0
PAPUA,PANIAI,SUGAPA,0,0,0
PAPUA,MIMIKA,MIMIKA TIMUR JAUH,0,0,0
PAPUA,MIMIKA,KUALA KENCANA,0,0,0
PAPUA,MIMIKA,MIMIKA BARAT JAUH,0,0,0
PAPUA,SARMI,SARMI TIMUR,0,0,0
PAPUA,SARMI,SARMI,0,0,0
PAPUA,MIMIKA,TEMBAGAPURA,0,0,0
PAPUA,MIMIKA,MIMIKA TIMUR,0,0,0
PAPUA,SARMI,PANTAI BARAT,0,0,0
PAPUA,MIMIKA,JILA,0,0,0
PAPUA,KEEROM,ARSO,0,0,0
PAPUA,MIMIKA,MIMIKA BARAT TENGAH,0,0,0
PAPUA,KEEROM,WARIS,0,0,0
PAPUA,MIMIKA,AGIMUGA,0,0,0
PAPUA,KEEROM,TOWE,0,0,0
PAPUA,KEEROM,SENGGI,0,0,0
PAPUA,SARMI,TOR ATAS,0,0,0
PAPUA,SARMI,BONGGO,0,0,0
PAPUA,SARMI,PANTAI TIMUR BAGIAN BARAT,0,0,0
PAPUA,SARMI,APAWER HULU,0,0,0
PAPUA,SARMI,BONGGO TIMUR,0,0,0
PAPUA,SARMI,PANTAI TIMUR,0,0,0
PAPUA,PEGUNUNGAN BINTANG,OKLIP,0,1386,1386
PAPUA,PEGUNUNGAN BINTANG,OKSAMOL,192,1866,2058
PAPUA,PEGUNUNGAN BINTANG,BATANI,0,3639,3639
PAPUA,KEEROM,SKANTO,0,0,0
PAPUA,PEGUNUNGAN BINTANG,WEIME,0,4199,4199
PAPUA,KEEROM,WEB,0,0,0
PAPUA,PEGUNUNGAN BINTANG,TARUP,0,1663,1663
PAPUA,KEEROM,ARSO TIMUR,0,0,0
PAPUA,PEGUNUNGAN BINTANG,JETFA,0,2431,2431
PAPUA,PEGUNUNGAN BINTANG,OKHIKA,62,1340,1402
PAPUA,PEGUNUNGAN BINTANG,OKSIBIL,295,4759,5054
PAPUA,PEGUNUNGAN BINTANG,OKBEMTAU,0,2791,2791
PAPUA,PEGUNUNGAN BINTANG,BATOM,545,2064,2609
PAPUA,PEGUNUNGAN BINTANG,KIWIROK,120,2124,2244
PAPUA,PEGUNUNGAN BINTANG,OKSEBANG,0,1799,1799
PAPUA,PEGUNUNGAN BINTANG,MURKIM,0,1015,1015
PAPUA,PEGUNUNGAN BINTANG,BORME,24,5319,5343
PAPUA,PEGUNUNGAN BINTANG,MOFINOP,15,1158,1173
PAPUA,PEGUNUNGAN BINTANG,PAMEK,66,2900,2966
PAPUA,PEGUNUNGAN BINTANG,IWUR,320,3000,3320
PAPUA,PEGUNUNGAN BINTANG,PEPERA,44,1480,1524
PAPUA,PEGUNUNGAN BINTANG,OKBAB,1152,3146,4298
PAPUA,PEGUNUNGAN BINTANG,KALOMDOL,61,1450,1511
PAPUA,PEGUNUNGAN BINTANG,BIME,1000,4866,5866
PAPUA,PEGUNUNGAN BINTANG,OK AOM,0,1223,1223
PAPUA,PEGUNUNGAN BINTANG,OKBAPE,10,1325,1335
PAPUA,PEGUNUNGAN BINTANG,TEIRAPLU,0,1934,1934
PAPUA,PEGUNUNGAN BINTANG,OKBIBAB,28,2124,2152
PAPUA,PEGUNUNGAN BINTANG,AWINBON,0,1526,1526
PAPUA,PEGUNUNGAN BINTANG,EIPUMEK,504,4866,5370
PAPUA,PEGUNUNGAN BINTANG,SERAMBAKON,11,2227,2238
PAPUA,YAHUKIMO,ENDOMEN,0,0,0
PAPUA,PEGUNUNGAN BINTANG,KAWOR,0,2662,2662
PAPUA,YAHUKIMO,PULDAMA,0,0,0
PAPUA,PEGUNUNGAN BINTANG,ALEMSOM,0,3021,3021
PAPUA,PEGUNUNGAN BINTANG,OKSOP,337,2675,3012
PAPUA,PEGUNUNGAN BINTANG,ABOY,285,1658,1943
PAPUA,PEGUNUNGAN BINTANG,KIWIROK TIMUR,127,2010,2137
PAPUA,YAHUKIMO,LOLAT,0,3545,3545
PAPUA,YAHUKIMO,TALAMBO,0,4491,4491
PAPUA,YAHUKIMO,LANGDA,0,0,0
PAPUA,YAHUKIMO,HOLUON,0,2994,2994
PAPUA,YAHUKIMO,SUMO,0,0,0
PAPUA,YAHUKIMO,SOLOIKMA,0,0,0
PAPUA,PEGUNUNGAN BINTANG,NONGME,307,2500,2807
PAPUA,YAHUKIMO,YOGOSEM,0,0,0
PAPUA,YAHUKIMO,UBALIHI,0,5695,5695
PAPUA,YAHUKIMO,HILIPUK,0,0,0
PAPUA,YAHUKIMO,BOMELA,0,0,0
PAPUA,YAHUKIMO,SELA,0,0,0
PAPUA,YAHUKIMO,DIRWEMNA,0,0,0
PAPUA,YAHUKIMO,KONA,0,0,0
PAPUA,YAHUKIMO,AMUMA,0,5899,5899
PAPUA,YAHUKIMO,SOBAHAM,0,0,0
PAPUA,YAHUKIMO,KAYO,0,0,0
PAPUA,YAHUKIMO,KORUPUN,0,0,0
PAPUA,YAHUKIMO,KWIKMA,0,0,0
PAPUA,YAHUKIMO,DURAM,0,0,0
PAPUA,YAHUKIMO,OBIO,0,0,0
PAPUA,YAHUKIMO,SUNTAMON,0,0,0
PAPUA,YAHUKIMO,SEREDELA,0,0,0
PAPUA,YAHUKIMO,KABIANGGAMA,0,0,0
PAPUA,YAHUKIMO,SILIMO,0,0,0
PAPUA,YAHUKIMO,KWELEMDUA,0,0,0
PAPUA,YAHUKIMO,WUSAMA,0,0,0
PAPUA,YAHUKIMO,WALMA,0,4763,4763
PAPUA,YAHUKIMO,HEREAPINI,0,5540,5540
PAPUA,YAHUKIMO,YAHULIAMBUT,3703,0,3703
PAPUA,YAHUKIMO,UBAHAK,0,9375,9375
PAPUA,YAHUKIMO,KOSAREK,0,0,0
PAPUA,YAHUKIMO,SURU SURU,0,0,0
PAPUA,YAHUKIMO,PRONGGOLI,0,5924,5924
PAPUA,YAHUKIMO,NALCA,0,0,0
PAPUA,YAHUKIMO,ANGGRUK,0,0,0
PAPUA,YAHUKIMO,NIPSAN,0,4015,4015
PAPUA,YAHUKIMO,SAMENAGE,0,0,0
PAPUA,TOLIKARA,YUNERI,0,0,0
PAPUA,YAHUKIMO,DEKAI,0,0,0
PAPUA,TOLIKARA,TAGINERI,0,0,0
PAPUA,YAHUKIMO,UKHA,0,0,0
PAPUA,YAHUKIMO,MUSAIK,0,0,0
PAPUA,YAHUKIMO,NINIA,0,0,0
PAPUA,YAHUKIMO,PANGGEMA,0,5877,5877
PAPUA,YAHUKIMO,HOGIO,2698,0,2698
PAPUA,YAHUKIMO,PASEMA,5475,0,5475
PAPUA,TOLIKARA,AIRGARAM,0,0,0
PAPUA,YAHUKIMO,KURIMA,0,0,0
PAPUA,TOLIKARA,YUKO,0,0,0
PAPUA,TOLIKARA,DOW,0,0,0
PAPUA,YAHUKIMO,WERIMA,0,5797,5797
PAPUA,YAHUKIMO,TANGMA,0,0,0
PAPUA,TOLIKARA,TELENGGEME,0,0,0
PAPUA,YAHUKIMO,SOBA,0,3812,3812
PAPUA,TOLIKARA,EGIAM,0,0,0
PAPUA,TOLIKARA,TAGIME,0,0,0
PAPUA,TOLIKARA,BIUK,0,0,0
PAPUA,TOLIKARA,KAMBONERI,0,0,0
PAPUA,TOLIKARA,GIKA,0,0,0
PAPUA,YAHUKIMO,MUGI,0,5239,5239
PAPUA,TOLIKARA,POGANERI,0,0,0
PAPUA,TOLIKARA,WAKUWO,0,0,0
PAPUA,TOLIKARA,WINA,0,0,0
PAPUA,TOLIKARA,DANIME,0,0,0
PAPUA,TOLIKARA,WENAM,0,0,0
PAPUA,TOLIKARA,AWEKU,0,0,0
PAPUA,TOLIKARA,UMAGI,0,0,0
PAPUA,TOLIKARA,WUGI,0,0,0
PAPUA,TOLIKARA,KAI,0,0,0
PAPUA,TOLIKARA,KANGGIME,0,0,0
PAPUA,TOLIKARA,GOYAGE,0,0,0
PAPUA,TOLIKARA,BOKONDINI,0,0,0
PAPUA,TOLIKARA,NELAWI,0,0,0
PAPUA,TOLIKARA,GEYA,0,0,0
PAPUA,TOLIKARA,LI ANOGOMMA,0,0,0
PAPUA,TOLIKARA,GUNDAGI,0,0,0
PAPUA,TOLIKARA,NABUNAGE,0,0,0
PAPUA,TOLIKARA,ANAWI,0,0,0
PAPUA,TOLIKARA,PANAGA,0,0,0
PAPUA,TOLIKARA,BOGONUK,0,0,0
PAPUA,TOLIKARA,GILUBANDU,0,0,0
PAPUA,TOLIKARA,WONIKI,0,0,0
PAPUA,TOLIKARA,DUNDU,0,0,0
PAPUA,TOLIKARA,KUBU,0,0,0
PAPUA,TOLIKARA,KEMBU,0,0,0
PAPUA,TOLIKARA,NUNGGAWI,0,0,0
PAPUA,TOLIKARA,BOKONERI,0,0,0
PAPUA,TOLIKARA,WUNIM,0,0,0
PAPUA,TOLIKARA,NUMBA,0,0,0
PAPUA,TOLIKARA,KARUBAGA,0,0,0
PAPUA,WAROPEN,UREI FAISEI,980,4873,5853
PAPUA,WAROPEN,MASIREI,99,1208,1307
PAPUA,BOVEN DIGOEL,FIRIWAGE,36,599,635
PAPUA,TOLIKARA,BEWANI,0,0,0
PAPUA,TOLIKARA,TIMORI,0,0,0
PAPUA,WAROPEN,RISEI SAYATI,139,934,1073
PAPUA,WAROPEN,DEMBA,151,1963,2114
PAPUA,TOLIKARA,KUARI,0,0,0
PAPUA,BOVEN DIGOEL,MANGGELUM,93,431,524
PAPUA,BOVEN DIGOEL,MANDOBO,1209,3928,5137
PAPUA,BOVEN DIGOEL,AMBATKWI,56,434,490
PAPUA,WAROPEN,OUDATE,94,2497,2591
PAPUA,WAROPEN,WAPOGA,312,1315,1627
PAPUA,BOVEN DIGOEL,SUBUR,39,842,881
PAPUA,BOVEN DIGOEL,INIYANDIT,100,284,384
PAPUA,BOVEN DIGOEL,JAIR,3760,7009,10769
PAPUA,WAROPEN,INGGERUS,281,924,1205
PAPUA,BOVEN DIGOEL,NINATI,2,291,293
PAPUA,BOVEN DIGOEL,FOFI,95,1157,1252
PAPUA,BOVEN DIGOEL,ARIMOP,86,1035,1121
PAPUA,BOVEN DIGOEL,SESNUK,55,142,197
PAPUA,WAROPEN,KIRIHI,552,2147,2699
PAPUA,WAROPEN,WAROPEN BAWAH,625,2441,3066
PAPUA,BOVEN DIGOEL,KI,47,527,574
PAPUA,BOVEN DIGOEL,KOMBAY,45,830,875
PAPUA,BOVEN DIGOEL,YANIRUMA,527,504,1031
PAPUA,BOVEN DIGOEL,KAWAGIT,63,493,556
PAPUA,BOVEN DIGOEL,KOMBUT,22,435,457
PAPUA,BOVEN DIGOEL,WAROPKO,141,649,790
PAPUA,BOVEN DIGOEL,KOUH,62,382,444
PAPUA,BOVEN DIGOEL,BOMAKIA,387,895,1282
PAPUA,MAPPI,ASSUE,571,3626,4197
PAPUA,MAPPI,YAKOMI,160,776,936
PAPUA,BOVEN DIGOEL,MINDIPTANA,192,1455,1647
PAPUA,MAPPI,PASSUE BAWAH,823,903,1726
PAPUA,MAPPI,KAIBAR,242,768,1010
PAPUA,ASMAT,KOLF BRAZA,0,0,0
PAPUA,MAPPI,EDERA,658,2032,2690
PAPUA,MAPPI,VENAHA,157,1032,1189
PAPUA,MAPPI,OBAA,2159,9062,11221
PAPUA,MAPPI,SYAHCAME,133,1244,1377
PAPUA,ASMAT,AGATS,0,0,0
PAPUA,MAPPI,PASSUE,235,2238,2473
PAPUA,ASMAT,KOPAY,0,0,0
PAPUA,ASMAT,SIRETS,0,0,0
PAPUA,MAPPI,HAJU,423,4907,5330
PAPUA,MAPPI,MINYAMUR,942,1653,2595
PAPUA,ASMAT,DER KOUMUR,0,0,0
PAPUA,MAPPI,BAMGI,102,1048,1150
PAPUA,ASMAT,AYIP,0,0,0
PAPUA,ASMAT,FAYIT,0,0,0
PAPUA,ASMAT,PULAU TIGA,0,0,0
PAPUA,MAPPI,TI  ZAIN,688,2195,2883
PAPUA,SUPIORI,SUPIORI UTARA,0,0,0
PAPUA,ASMAT,JETSY,0,0,0
PAPUA,SUPIORI,SUPIORI SELATAN,0,0,0
PAPUA,ASMAT,JOERAT,0,0,0
PAPUA,MAPPI,NAMBIOMAN BAPAI,397,2588,2985
PAPUA,SUPIORI,SUPIORI TIMUR,0,0,0
PAPUA,ASMAT,UNIR SIRAU,0,0,0
PAPUA,MAMBERAMO RAYA,RUFAER,0,0,0
PAPUA,MAMBERAMO RAYA,MAMBERAMO TENGAH TIMUR,0,0,0
PAPUA,ASMAT,SAWA ERMA,0,0,0
PAPUA,MAMBERAMO RAYA,MAMBERAMO TENGAH,0,0,0
PAPUA,ASMAT,BETCBAMU,0,0,0
PAPUA,ASMAT,AKAT,0,0,0
PAPUA,MAMBERAMO RAYA,MAMBERAMO HULU,0,0,0
PAPUA,MAMBERAMO TENGAH,KOBAGMA,0,0,0
PAPUA,ASMAT,SAFAN,0,0,0
PAPUA,MAMBERAMO RAYA,WAROPEN ATAS,0,0,0
PAPUA,ASMAT,SUATOR,0,0,0
PAPUA,MAMBERAMO TENGAH,ILUGWA,0,0,0
PAPUA,ASMAT,PANTAI KASUARI,0,0,0
PAPUA,YALIMO,BENAWA,1310,9418,10728
PAPUA,ASMAT,ATSJ,0,0,0
PAPUA,LANNY JAYA,TIOM,0,0,0
PAPUA,YALIMO,ELELIM,2919,6693,9612
PAPUA,SUPIORI,KEPULAUAN ARURI,0,0,0
PAPUA,YALIMO,APALAPSILI,3152,7427,10579
PAPUA,LANNY JAYA,MELAGINERI,0,0,0
PAPUA,SUPIORI,SUPIORI BARAT,0,0,0
PAPUA,MAMBERAMO RAYA,SAWAI,0,0,0
PAPUA,MAMBERAMO TENGAH,KELILA,0,0,0
PAPUA,MAMBERAMO TENGAH,MEGAMBILIS,0,0,0
PAPUA,MAMBERAMO RAYA,BENUKI,0,0,0
PAPUA,NDUGA,KENYAM,0,0,0
PAPUA,YALIMO,ABENAHO,9895,12612,22507
PAPUA,LANNY JAYA,KUYAWAGE,0,0,0
PAPUA,MAMBERAMO TENGAH,ERAGAYAM,0,0,0
PAPUA,MAMBERAMO RAYA,MAMBERAMO HILIR,0,0,0
PAPUA,LANNY JAYA,DIMBA,0,0,0
PAPUA,LANNY JAYA,MAKKI,0,0,0
PAPUA,NDUGA,MBULMU YALMA,0,0,0
PAPUA,NDUGA,DAL,0,0,0
PAPUA,YALIMO,WELAREK,536,13900,14436
PAPUA,LANNY JAYA,POGA,0,0,0
PAPUA,NDUGA,KORA,0,0,0
PAPUA,LANNY JAYA,PIRIME,0,0,0
PAPUA,NDUGA,NIRKURI,0,0,0
PAPUA,LANNY JAYA,TIOMNERI,0,0,0
PAPUA,LANNY JAYA,GAMELIA,0,0,0
PAPUA,LANNY JAYA,BALINGGA,0,0,0
PAPUA,NDUGA,YAL,0,0,0
PAPUA,NDUGA,INIYE,0,0,0
PAPUA,NDUGA,WOSAK,0,0,0
PAPUA,NDUGA,MAM,0,0,0
PAPUA,NDUGA,WUSI,0,0,0
PAPUA,NDUGA,INIKGAL,0,0,0
PAPUA,NDUGA,MBUA TENGAH,0,0,0
PAPUA,NDUGA,KOROPTAK,0,0,0
PAPUA,NDUGA,WUTPAGA,0,0,0
PAPUA,NDUGA,NENGGEAGIN,0,0,0
PAPUA,NDUGA,PASIR PUTIH,0,0,0
PAPUA,NDUGA,YIGI,0,0,0
PAPUA,NDUGA,EMBETPEN,0,0,0
PAPUA,NDUGA,PIJA,0,0,0
PAPUA,NDUGA,MUGI,0,0,0
PAPUA,NDUGA,KILMID,0,0,0
PAPUA,NDUGA,MOBA,0,0,0
PAPUA,NDUGA,MEBAROK,0,0,0
PAPUA,NDUGA,MBUWA,0,0,0
PAPUA,NDUGA,GEAREK,0,0,0
PAPUA,PUNCAK,DOUFO,0,6108,6108
PAPUA,NDUGA,KREPKURI,0,0,0
PAPUA,NDUGA,MAPENDUMA,0,0,0
PAPUA,NDUGA,KEGAYEM,0,0,0
PAPUA,PUNCAK,POGOMA,31,14963,14994
PAPUA,DOGIYAI,MAPIA,0,0,0
PAPUA,DOGIYAI,MAPIA BARAT,0,0,0
PAPUA,DOGIYAI,KAMU,0,0,0
PAPUA,NDUGA,GESELMA,0,0,0
PAPUA,DOGIYAI,PIYAIYE,0,0,0
PAPUA,NDUGA,PARO,0,0,0
PAPUA,NDUGA,YENGGELO,0,0,0
PAPUA,DOGIYAI,DOGIYAI,0,0,0
PAPUA,PUNCAK,WANGBE,0,20021,20021
PAPUA,PUNCAK,ILAGA,3564,27306,30870
PAPUA,PUNCAK,SINAK,0,28061,28061
PAPUA,DOGIYAI,KAMU TIMUR,0,0,0
PAPUA,NDUGA,ALAMA,0,0,0
PAPUA,INTAN JAYA,BIANDOGA,0,0,0
PAPUA,PUNCAK,AGANDUGUME,0,11408,11408
PAPUA,PUNCAK,BEOGA,0,25832,25832
PAPUA,DEIYAI,TIGI,0,0,0
PAPUA,PUNCAK,GOME,4476,15397,19873
PAPUA,DOGIYAI,KAMU UTARA,0,0,0
PAPUA,DOGIYAI,SUKIKAI SELATAN,0,0,0
PAPUA,DOGIYAI,MAPIA TENGAH,0,0,0
PAPUA,DOGIYAI,KAMU SELATAN,0,0,0
PAPUA,INTAN JAYA,AGISIGA,0,0,0
PAPUA,KOTA JAYAPURA,ABEPURA,0,0,0
PAPUA,KOTA JAYAPURA,JAYAPURA SELATAN,0,0,0
PAPUA,DEIYAI,TIGI BARAT,0,0,0
PAPUA BARAT,SORONG,KLASO,30,1338,1368
PAPUA BARAT,SORONG,MARIAT,4378,2826,7204
PAPUA,DEIYAI,KAPIRAYA,0,0,0
PAPUA,INTAN JAYA,HOMEYO,0,0,0
PAPUA,INTAN JAYA,WANDAI,0,0,0
PAPUA,INTAN JAYA,SUGAPA,0,0,0
PAPUA,DEIYAI,TIGI TIMUR,0,0,0
PAPUA BARAT,SORONG,KLABOT,265,2245,2510
PAPUA BARAT,SORONG,SALAWATI SELATAN,424,902,1326
PAPUA BARAT,SORONG,SAYOSA,238,1661,1899
PAPUA BARAT,SORONG,MAYAMUK,4256,2243,6499
PAPUA BARAT,SORONG,KLAWAK,176,2019,2195
PAPUA,INTAN JAYA,HITADIPA,0,0,0
PAPUA,KOTA JAYAPURA,JAYAPURA UTARA,0,0,0
PAPUA BARAT,SORONG,MAUDUS,322,1057,1379
PAPUA BARAT,MANOKWARI,RANSIKI,0,0,0
PAPUA,KOTA JAYAPURA,HERAM,0,0,0
PAPUA,DEIYAI,BOWOBADO,0,0,0
PAPUA BARAT,MANOKWARI,TOHOTA,106,924,1030
PAPUA BARAT,MANOKWARI,NENEY,0,0,0
PAPUA,KOTA JAYAPURA,MUARA TAMI,0,0,0
PAPUA BARAT,SORONG,MOISEGEN,743,829,1572
PAPUA BARAT,MANOKWARI,SIDEY,0,0,0
PAPUA BARAT,MANOKWARI,DATARAN ISIM,114,1834,1948
PAPUA BARAT,SORONG,KLAYILI,53,961,1014
PAPUA BARAT,MANOKWARI,TESTEGA,0,0,0
PAPUA BARAT,SORONG,SALAWATI,4136,1497,5633
PAPUA BARAT,SORONG,MAKBON,61,1315,1376
PAPUA BARAT,MANOKWARI,DIDOHU,0,0,0
PAPUA BARAT,SORONG,SEGUN,286,810,1096
PAPUA BARAT,MANOKWARI,CATUBOUW,705,2073,2778
PAPUA BARAT,SORONG,SEGET,483,1552,2035
PAPUA BARAT,MANOKWARI,MASNI,0,0,0
PAPUA BARAT,SORONG,AIMAS,6833,6967,13800
PAPUA BARAT,MANOKWARI,MEMBEY,0,0,0
PAPUA BARAT,SORONG,KLAMONO,1039,3196,4235
PAPUA BARAT,MANOKWARI,TAIGE,0,2961,2961
PAPUA BARAT,SORONG,BERAUR,584,2096,2680
PAPUA BARAT,MANOKWARI,ANGGI,0,0,0
PAPUA BARAT,MANOKWARI,MANOKWARI UTARA,201,3085,3286
PAPUA BARAT,MANOKWARI,HINK,0,0,0
PAPUA BARAT,FAKFAK,KOKAS,0,0,0
PAPUA BARAT,MANOKWARI,PRAFI,0,0,0
PAPUA BARAT,SORONG SELATAN,TEMINABUAN,0,0,0
PAPUA BARAT,MANOKWARI,TANAH RUBUH,0,0,0
PAPUA BARAT,MANOKWARI,MANOKWARI BARAT,16003,30074,46077
PAPUA BARAT,MANOKWARI,MANOKWARI TIMUR,771,3783,4554
PAPUA BARAT,MANOKWARI,ANGGI GIDA,195,1678,1873
PAPUA BARAT,MANOKWARI,MANOKWARI SELATAN,2796,6371,9167
PAPUA BARAT,MANOKWARI,ORANSBARI,0,0,0
PAPUA BARAT,SORONG SELATAN,KAIS,420,1787,2207
PAPUA BARAT,MANOKWARI,WARMARE,0,0,0
PAPUA BARAT,MANOKWARI,SURUREY,0,0,0
PAPUA BARAT,SORONG SELATAN,SAIFI,83,1514,1597
PAPUA BARAT,SORONG SELATAN,METEMANI,422,1468,1890
PAPUA BARAT,FAKFAK,TELUK PATIPI,0,0,0
PAPUA BARAT,SORONG SELATAN,KONDA,467,888,1355
PAPUA BARAT,SORONG SELATAN,WAYER,393,1077,1470
PAPUA BARAT,MANOKWARI,MINYAMBOUW,0,0,0
PAPUA BARAT,FAKFAK,BOMBERAY,0,0,0
PAPUA BARAT,FAKFAK,KRAMONGMONGGA,0,0,0
PAPUA BARAT,FAKFAK,KARAS,0,0,0
PAPUA BARAT,RAJA AMPAT,SALAWATI BARAT,0,0,0
PAPUA BARAT,SORONG SELATAN,MOSWAREN,760,1183,1943
PAPUA BARAT,RAJA AMPAT,KEPULAUAN SEMBILAN,0,0,0
PAPUA BARAT,SORONG SELATAN,KOKODA UTARA,1014,890,1904
PAPUA BARAT,RAJA AMPAT,WAIGEO UTARA,0,0,0
PAPUA BARAT,SORONG SELATAN,SEREMUK,207,1007,1214
PAPUA BARAT,RAJA AMPAT,SALAWATI TENGAH,0,0,0
PAPUA BARAT,SORONG SELATAN,SAWIAT,386,1979,2365
PAPUA BARAT,SORONG SELATAN,FKOUR,216,466,682
PAPUA BARAT,SORONG SELATAN,KOKODA,1956,3299,5255
PAPUA BARAT,RAJA AMPAT,TIPLOL MAYALIBIT,0,0,0
PAPUA BARAT,RAJA AMPAT,WAIGEO TIMUR,0,0,0
PAPUA BARAT,RAJA AMPAT,KEPULAUAN AYAU,0,0,0
PAPUA BARAT,SORONG SELATAN,INANWATAN,431,1293,1724
PAPUA BARAT,RAJA AMPAT,MISOOL BARAT,0,0,0
PAPUA BARAT,RAJA AMPAT,BATANTA UTARA,0,0,0
PAPUA BARAT,RAJA AMPAT,WAIGEO BARAT KEPULAUAN,0,0,0
PAPUA BARAT,RAJA AMPAT,KOTA WAISAI,0,0,0
PAPUA BARAT,RAJA AMPAT,WAIGEO SELATAN,0,0,0
PAPUA BARAT,RAJA AMPAT,SUPNIN,0,0,0
PAPUA BARAT,RAJA AMPAT,AYAU,0,0,0
PAPUA BARAT,RAJA AMPAT,MEOS MANSAR,0,0,0
PAPUA BARAT,TELUK BINTUNI,KAITARO,66,532,598
PAPUA BARAT,RAJA AMPAT,MISOOL SELATAN,0,0,0
PAPUA BARAT,RAJA AMPAT,WARWARBOMI,0,0,0
PAPUA BARAT,RAJA AMPAT,SALAWATI UTARA,0,0,0
PAPUA BARAT,RAJA AMPAT,WAIGEO BARAT,0,0,0
PAPUA BARAT,RAJA AMPAT,MISOOL TIMUR,0,0,0
PAPUA BARAT,TELUK BINTUNI,AROBA,443,1435,1878
PAPUA BARAT,RAJA AMPAT,BATANTA SELATAN,0,0,0
PAPUA BARAT,TELUK BINTUNI,WERIAGAR,644,701,1345
PAPUA BARAT,TELUK BINTUNI,DATARAN BEIMES,23,958,981
PAPUA BARAT,TELUK BINTUNI,BISCOOP,53,454,507
PAPUA BARAT,RAJA AMPAT,KOFIAU,0,0,0
PAPUA BARAT,TELUK BINTUNI,TOMU,1199,370,1569
PAPUA BARAT,TELUK BINTUNI,KAMUNDAN,305,189,494
PAPUA BARAT,TELUK BINTUNI,BINTUNI,2959,7845,10804
PAPUA BARAT,TELUK BINTUNI,FAFURWAR,6,869,875
PAPUA BARAT,TELUK BINTUNI,MASYETA,136,552,688
PAPUA BARAT,TELUK BINTUNI,SUMURI,1277,3953,5230
PAPUA BARAT,TELUK BINTUNI,KURI,45,698,743
PAPUA BARAT,TELUK BINTUNI,BABO,778,1205,1983
PAPUA BARAT,RAJA AMPAT,TELUK MAYALIBIT,0,0,0
PAPUA BARAT,TELUK BINTUNI,MOSKONA BARAT,5,757,762
PAPUA BARAT,TELUK BINTUNI,ARANDAY,957,377,1334
PAPUA BARAT,TELUK BINTUNI,MOSKONA UTARA,187,1017,1204
PAPUA BARAT,TELUK BINTUNI,TUHIBA,171,703,874
PAPUA BARAT,TELUK BINTUNI,MEYADO,164,557,721
PAPUA BARAT,TELUK WONDAMA,ROSWAR,10,513,523
PAPUA BARAT,TELUK BINTUNI,WAMESA,0,796,796
PAPUA BARAT,TELUK WONDAMA,NIKIWAR,84,471,555
PAPUA BARAT,TELUK BINTUNI,MERDEY,573,391,964
PAPUA BARAT,TELUK WONDAMA,WINDESI,75,835,910
PAPUA BARAT,TELUK WONDAMA,SOUG JAYA,13,438,451
PAPUA BARAT,TELUK BINTUNI,TEMBUNI,223,550,773
PAPUA BARAT,TELUK BINTUNI,MOSKONA SELATAN,154,800,954
PAPUA BARAT,TELUK WONDAMA,WAMESA,25,532,557
PAPUA BARAT,TELUK WONDAMA,RUMBERPON,87,961,1048
PAPUA BARAT,KAIMANA,TELUK ETNA,0,0,0
PAPUA BARAT,TELUK WONDAMA,WASIOR,1816,4941,6757
PAPUA BARAT,TELUK WONDAMA,NAIKERE,14,537,551
PAPUA BARAT,TELUK BINTUNI,MOSKONA TIMUR,706,779,1485
PAPUA BARAT,TELUK WONDAMA,KURI WAMESA,184,892,1076
PAPUA BARAT,KAIMANA,KAMBRAU,0,0,0
PAPUA BARAT,TELUK BINTUNI,MANIMERI,1240,2011,3251
PAPUA BARAT,TELUK WONDAMA,WONDIBOY,243,1085,1328
PAPUA BARAT,TAMBRAUW,MUBRANI,0,0,0
PAPUA BARAT,TELUK WONDAMA,RASIEI,186,1545,1731
PAPUA BARAT,KAIMANA,TELUK ARGUNI BAWAH,0,0,0
PAPUA BARAT,TAMBRAUW,FEF,0,0,0
PAPUA BARAT,TAMBRAUW,ABUN,0,0,0
PAPUA BARAT,TELUK WONDAMA,ROON,187,670,857
PAPUA BARAT,TELUK WONDAMA,TELUK DUAIRI,367,684,1051
PAPUA BARAT,TAMBRAUW,SAUSAPOR,0,0,0
PAPUA BARAT,KAIMANA,TELUK ARGUNI ATAS,0,0,0
PAPUA BARAT,KAIMANA,YAMOR,0,0,0
PAPUA BARAT,TAMBRAUW,SYUJAK,0,0,0
PAPUA BARAT,TAMBRAUW,MORAID,0,0,0
PAPUA BARAT,TAMBRAUW,MIYAH,0,0,0
PAPUA BARAT,TAMBRAUW,YEMBUN,0,0,0
PAPUA BARAT,KAIMANA,BURUWAY,0,0,0
PAPUA BARAT,KAIMANA,KAIMANA,0,0,0
PAPUA BARAT,TAMBRAUW,SENOPI,0,0,0
PAPUA BARAT,MAYBRAT,AYAMARU SELATAN,245,1076,1321
PAPUA BARAT,MAYBRAT,AITINYO RAYA,53,956,1009
PAPUA BARAT,TAMBRAUW,AMBERBAKEN,0,0,0
PAPUA BARAT,MAYBRAT,AYAMARU UTARA TIMUR,276,852,1128
PAPUA BARAT,MAYBRAT,AYAMARU BARAT,70,649,719
PAPUA BARAT,MAYBRAT,AYAMARU TIMUR SELATAN,118,540,658
PAPUA BARAT,TAMBRAUW,KEBAR,0,0,0
PAPUA BARAT,MAYBRAT,MARE SELATAN,698,252,950
PAPUA BARAT,MAYBRAT,AYAMARU TENGAH,269,1149,1418
PAPUA BARAT,MAYBRAT,AITINYO TENGAH,201,804,1005
PAPUA BARAT,MAYBRAT,AIFAT UTARA,761,1273,2034
PAPUA BARAT,MAYBRAT,AYAMARU JAYA,62,1191,1253
PAPUA BARAT,MAYBRAT,AYAMARU SELATAN JAYA,313,649,962
PAPUA BARAT,MAYBRAT,AYAMARU UTARA,778,1449,2227
PAPUA BARAT,TAMBRAUW,KWOOR,0,0,0
PAPUA BARAT,MAYBRAT,AITINYO,195,1649,1844
PAPUA BARAT,MAYBRAT,AIFAT TIMUR JAUH,199,242,441
PAPUA BARAT,MAYBRAT,AITINYO BARAT,306,584,890
PAPUA BARAT,MAYBRAT,AIFAT,1049,1250,2299
PAPUA BARAT,MAYBRAT,AIFAT TIMUR TENGAH,573,441,1014
PAPUA BARAT,MAYBRAT,AIFAT SELATAN,575,796,1371
PAPUA BARAT,MAYBRAT,AYAMARU,124,1717,1841
PAPUA BARAT,MAYBRAT,AYAMARU TIMUR,140,871,1011
PAPUA BARAT,MAYBRAT,AITINYO UTARA,143,933,1076
PAPUA BARAT,MAYBRAT,AIFAT TIMUR,392,353,745
PAPUA BARAT,MAYBRAT,MARE,346,866,1212
PAPUA BARAT,KOTA SORONG,SORONG TIMUR,6841,9561,16402
PAPUA BARAT,KOTA SORONG,SORONG UTARA,0,0,0
PAPUA BARAT,KOTA SORONG,SORONG BARAT,0,0,0
PAPUA BARAT,KOTA SORONG,SORONG,0,0,0
PAPUA BARAT,MAYBRAT,AIFAT TIMUR SELATAN,77,340,417
PAPUA BARAT,KOTA SORONG,SORONG KEPULAUAN,1440,2596,4036
